Id,Label,timeset,username,indegree,outdegree,Degree,weighted indegree,weighted outdegree,Weighted Degree,clustering,eigencentrality,Eccentricity,closnesscentrality,harmonicclosnesscentrality,betweenesscentrality
1,,,tsukianul,0,10,10,0,11,11,0,0,1,1,1,0
2,,,natecurlsquad,4,9,13,6,11,17,0.083333,0.026749,1,1,1,24
3,,,frenchpressplz,3,1,4,3,1,4,0.333333,0.020061,0,0,0,0
4,,,Glossmeraldo,0,1,1,0,1,1,0,0,1,1,1,0
5,,,Eyesonnathan,0,11,11,0,11,11,0,0,2,0.923077,0.958333,0
6,,,judejinjin,2,1,3,2,1,3,0.5,0.013374,0,0,0,0
7,,,terpointoh,4,1,5,4,1,5,0.25,0.124587,0,0,0,0
8,,,sofigurein,16,30,46,18,32,50,0.022727,0.106994,2,0.891892,0.939394,494
9,,,tailandtadashi,2,27,29,2,30,32,0.035714,0.013374,5,0.49359,0.615152,77
10,,,OlympicChenpion,10,23,33,11,24,35,0.032258,0.066871,3,0.733333,0.828283,297
11,,,Honeywater1214,0,23,23,0,23,23,0,0,3,0.84375,0.919753,0
12,,,strawberryhoes,42,2,44,48,5,53,0.024363,0.475446,1,1,1,92
13,,,JohnGot76853756,1,1,2,1,1,2,0,0.006687,0,0,0,0
14,,,chicken20549036,0,21,21,0,24,24,0,0,2,0.956522,0.977273,0
15,,,Valerie07390730,0,7,7,0,7,7,0,0,1,1,1,0
16,,,icy_blue0505,2,19,21,2,19,21,0.05,0.013374,2,0.640625,0.719512,41
17,,,NGU_MnN,0,14,14,0,15,15,0,0,2,0.9375,0.966667,0
18,,,Dennis64403986,0,1,1,0,2,2,0,0,1,1,1,0
19,,,yuzutoaki,0,1,1,0,1,1,0,0,1,1,1,0
20,,,lilacwinoz,1,1,2,1,1,2,0,0.006687,0,0,0,0
21,,,AlumniHopkins,1,1,2,1,1,2,0,0.006687,0,0,0,0
22,,,briarhoes,1,1,2,1,1,2,0,0.006687,0,0,0,0
23,,,Kat_Roaster,1,1,2,1,1,2,0,0.006687,0,0,0,0
24,,,InnovatorBiz,8,1,9,8,1,9,0.125,0.053497,0,0,0,0
25,,,aphmoney,0,2,2,0,2,2,0,0,1,1,1,0
26,,,jakefromAR,0,2,2,0,2,2,0,0,1,1,1,0
27,,,stayhealthy505,0,5,5,0,5,5,0,0,1,1,1,0
28,,,GraceYu0329,0,8,8,0,9,9,0,0,3,0.733333,0.848485,0
29,,,captmorgsas,0,1,1,0,1,1,0,0,1,1,1,0
30,,,Liddell_0124,0,11,11,0,12,12,0,0,2,0.923077,0.958333,0
31,,,DBinSydney,0,1,1,0,1,1,0,0,1,1,1,0
32,,,MSN,22,1,23,25,4,29,0.045455,0.161094,0,0,0,0
33,,,fromisbeom,0,1,1,0,1,1,0,0,1,1,1,0
34,,,MaiiSabai,0,9,9,0,9,9,0,0,1,1,1,0
35,,,ChrisCasquejo,0,1,1,0,1,1,0,0,1,1,1,0
36,,,melissa07111,0,2,2,0,2,2,0,0,2,0.6,0.666667,0
37,,,Juncidis,0,2,2,0,2,2,0,0,3,0.484848,0.53125,0
38,,,xtalayuzu,0,4,4,0,4,4,0,0,1,1,1,0
39,,,Josephc34923938,1,1,2,1,1,2,0,0.006687,0,0,0,0
40,,,tackyandwilson,20,5,25,31,14,45,0.04529,0.210616,2,0.75,0.833333,199
41,,,raspmarytea,0,7,7,0,11,11,0,0,3,0.608696,0.72619,0
42,,,lulumediainc,0,1,1,0,1,1,0,0,3,0.466667,0.52381,0
43,,,chr1ie,1,1,2,1,1,2,0,0.006687,0,0,0,0
44,,,Chaleck,3,1,4,3,1,4,0.333333,0.048015,0,0,0,0
45,,,EeV5IDoLiCxMPr5,0,3,3,0,3,3,0,0,1,1,1,0
46,,,LiraAlaya,8,2,10,8,2,10,0.111111,0.053497,1,1,1,7
47,,,BrianncaTV,74,1,75,120,45,165,0.013514,0.519308,0,0,0,0
48,,,NancyLFulmer1,3,1,4,6,4,10,0.333333,0.020061,0,0,0,0
49,,,vivicardashian,2,1,3,2,1,3,0.5,0.013374,0,0,0,0
50,,,kirakumamaFS,0,2,2,0,2,2,0,0,2,0.75,0.833333,0
51,,,AlbertCamus82,3,1,4,3,1,4,0.333333,0.034038,0,0,0,0
52,,,PYGOSCELIS_SKT,4,12,16,4,12,16,0.071429,0.026749,3,0.666667,0.787037,53
53,,,SC0369,0,7,7,0,7,7,0,0,2,0.888889,0.9375,0
54,,,shiratori5610,0,2,2,0,2,2,0,0,3,0.5,0.583333,0
55,,,1DougSimpson,0,1,1,0,1,1,0,0,1,1,1,0
56,,,yuko_takechan,2,6,8,2,6,8,0.142857,0.028885,1,1,1,30
57,,,carter_embrey,0,1,1,0,1,1,0,0,1,1,1,0
58,,,DaseinNa_,0,1,1,0,1,1,0,0,1,1,1,0
59,,,highpusheen,0,1,1,0,1,1,0,0,1,1,1,0
60,,,wlai,0,1,1,0,1,1,0,0,1,1,1,0
61,,,malami881,0,1,1,0,1,1,0,0,1,1,1,0
62,,,purple_jiujiu,0,1,1,0,1,1,0,0,1,1,1,0
63,,,ShizueNhi,0,1,1,0,1,1,0,0,3,0.466667,0.52381,0
64,,,Rilabu2,0,2,2,0,2,2,0,0,3,0.5,0.583333,0
65,,,42kaiko,0,1,1,0,1,1,0,0,3,0.466667,0.52381,0
66,,,yukikonatsuharu,0,32,32,0,37,37,0,0,3,0.653061,0.744792,0
67,,,kaibernierchen,0,1,1,0,1,1,0,0,2,0.666667,0.75,0
68,,,poppo_skate,0,1,1,0,1,1,0,0,2,0.666667,0.75,0
69,,,shoshpd,1,11,12,1,11,12,0.090909,0.006687,2,0.916667,0.954545,0
70,,,callofthewind,1,6,7,1,6,7,0.166667,0.006687,2,0.857143,0.916667,0
71,,,NativeFlowers,0,2,2,0,2,2,0,0,2,0.75,0.833333,0
72,,,SpillbergS,2,1,3,4,3,7,0.5,0.027351,0,0,0,0
73,,,pearlspins,4,5,9,4,5,9,0.125,0.026749,1,1,1,12
74,,,beva5678,14,1,15,16,3,19,0.071429,0.100608,0,0,0,0
75,,,goggiebooty,0,1,1,0,1,1,0,0,1,1,1,0
76,,,justine_wu,0,2,2,0,2,2,0,0,1,1,1,0
77,,,rondokitty,3,5,8,3,6,9,0.190476,0.020061,1,1,1,6
78,,,vanillasallt,0,1,1,0,1,1,0,0,1,1,1,0
79,,,Jude20410224,1,5,6,1,5,6,0,0.00396,1,1,1,5
80,,,alvaro058,0,1,1,0,1,1,0,0,1,1,1,0
81,,,Pingpu_per,14,2,16,21,8,29,0.066667,0.135551,1,1,1,24
82,,,SkatingSabrina,0,1,1,0,1,1,0,0,2,0.666667,0.75,0
83,,,jlfleite,0,4,4,0,4,4,0,0,4,0.449438,0.497917,0
84,,,hanyusukiii,0,1,1,0,1,1,0,0,2,0.666667,0.75,0
85,,,R_Perokun,0,1,1,0,1,1,0,0,2,0.666667,0.75,0
86,,,LizSzabo,0,1,1,0,2,2,0,0,2,0.666667,0.75,0
87,,,moagether,0,3,3,0,3,3,0,0,2,0.8,0.875,0
88,,,krnl_lf,3,1,4,3,1,4,0.333333,0.020061,0,0,0,0
89,,,Courtneywendel,0,1,1,0,1,1,0,0,1,1,1,0
90,,,Wordsnflowers1,0,1,1,0,1,1,0,0,1,1,1,0
91,,,ifsmagazine,6,1,7,7,2,9,0.166667,0.075065,0,0,0,0
92,,,ThompsonK104,1,1,2,1,1,2,0,0.006687,0,0,0,0
93,,,SeelyeTracy,6,1,7,6,1,7,0.166667,0.040123,0,0,0,0
94,,,yokolog,0,3,3,0,3,3,0,0,2,0.714286,0.8,0
95,,,morinori223,0,31,31,0,33,33,0,0,2,0.860465,0.918919,0
96,,,ranpokey,0,2,2,0,2,2,0,0,1,1,1,0
97,,,Panoramiia,0,3,3,0,3,3,0,0,1,1,1,0
98,,,joloroman,0,3,3,0,7,7,0,0,1,1,1,0
99,,,AAAJ_LA,6,1,7,6,1,7,0.166667,0.06223,0,0,0,0
100,,,s_jimmy_m,0,1,1,0,1,1,0,0,1,1,1,0
101,,,FairuzGhefira,0,1,1,0,1,1,0,0,1,1,1,0
102,,,neirgudetama,4,6,10,5,7,12,0.111111,0.058197,1,1,1,55
103,,,Pandaherbs1,0,1,1,0,1,1,0,0,1,1,1,0
104,,,Bangtan_Army730,0,1,1,0,1,1,0,0,1,1,1,0
105,,,KonnyakuSenshu,0,5,5,0,5,5,0,0,1,1,1,0
106,,,Dean42402953,0,1,1,0,1,1,0,0,1,1,1,0
107,,,aquatw1,0,3,3,0,3,3,0,0,1,1,1,0
108,,,nureizzatyyy,4,1,5,4,1,5,0.25,0.032203,0,0,0,0
109,,,CLBTSARMY1,0,2,2,0,2,2,0,0,2,0.75,0.833333,0
110,,,renge1124,2,10,12,2,10,12,0,0.00792,4,0.615385,0.776042,32
111,,,shirazens,0,1,1,0,1,1,0,0,1,1,1,0
112,,,pannchoaNOT,2,1,3,4,3,7,0.5,0.013374,0,0,0,0
113,,,Melissa53008677,2,1,3,3,2,5,0.5,0.013374,0,0,0,0
114,,,NectarineOne,3,1,4,4,1,5,0.333333,0.020061,0,0,0,0
115,,,fuyumikan2112,0,2,2,0,2,2,0,0,2,0.75,0.833333,0
116,,,youmengying2014,0,36,36,0,40,40,0,0,3,0.676768,0.766169,0
117,,,hztwsx,2,1,3,2,1,3,0.5,0.013374,0,0,0,0
118,,,starrysugi,0,1,1,0,1,1,0,0,1,1,1,0
119,,,adrianna_ind,7,1,8,9,3,12,0.142857,0.081752,0,0,0,0
120,,,ZacharyCosta14,0,1,1,0,1,1,0,0,1,1,1,0
121,,,Zumrezumree,0,1,1,0,1,1,0,0,1,1,1,0
122,,,ZbHIfkhzBqyY14f,0,11,11,0,11,11,0,0,2,0.923077,0.958333,0
123,,,TylerWigington,0,1,1,0,1,1,0,0,1,1,1,0
124,,,malsimons,0,1,1,0,1,1,0,0,1,1,1,0
125,,,nighty_wind,4,1,5,4,1,5,0.25,0.026749,0,0,0,0
126,,,Lxylxatnxght,0,1,1,0,1,1,0,0,1,1,1,0
127,,,gamesmio,0,1,1,0,1,1,0,0,1,1,1,0
128,,,Verbatim411,0,1,1,0,1,1,0,0,1,1,1,0
129,,,Natsky1988,14,1,15,15,2,17,0.071429,0.09362,0,0,0,0
130,,,tlwhite26,0,1,1,0,1,1,0,0,1,1,1,0
131,,,metroheterojerk,0,1,1,0,1,1,0,0,1,1,1,0
132,,,joonsgooz,0,1,1,0,1,1,0,0,1,1,1,0
133,,,Josianelokinha,0,1,1,0,1,1,0,0,1,1,1,0
134,,,UnpaintedMelody,0,1,1,0,1,1,0,0,1,1,1,0
135,,,shankeracom,0,1,1,0,1,1,0,0,1,1,1,0
136,,,gztstatistics,0,1,1,0,1,1,0,0,1,1,1,0
137,,,JesseCoffey15,0,2,2,0,2,2,0,0,1,1,1,0
138,,,mQUsarPX7BbaGsw,0,5,5,0,6,6,0,0,2,0.857143,0.916667,0
139,,,PApynys,0,1,1,0,1,1,0,0,1,1,1,0
140,,,bader_diedrich,0,1,1,0,1,1,0,0,1,1,1,0
141,,,Hypnoru,1,3,4,1,3,4,0.333333,0.006687,1,1,1,0
142,,,shayz0rz,5,5,10,7,7,14,0.111111,0.033436,1,1,1,16
143,,,therealpeterm,3,1,4,5,3,8,0.333333,0.020061,0,0,0,0
144,,,RachaelKriger,0,1,1,0,1,1,0,0,1,1,1,0
145,,,ILSportsNetwork,1,1,2,1,1,2,0,0.006687,0,0,0,0
146,,,klamstrakur,0,1,1,0,1,1,0,0,1,1,1,0
147,,,chaein_n,2,1,3,2,1,3,0.5,0.068498,0,0,0,0
148,,,polarYpolaris,15,22,37,19,27,46,0.027778,0.11079,2,0.956522,0.977273,352
149,,,socialaysm,1,1,2,1,1,2,0,0.006687,0,0,0,0
150,,,embot0,3,1,4,3,1,4,0.333333,0.020061,0,0,0,0
151,,,Cstu05,0,1,1,0,1,1,0,0,1,1,1,0
152,,,nagitsuna__,0,4,4,0,4,4,0,0,1,1,1,0
153,,,KateMcGranagha1,1,1,2,1,1,2,0,0.006687,0,0,0,0
154,,,Manhattan510,5,1,6,6,2,8,0.2,0.03693,0,0,0,0
155,,,fairydyoung,1,2,3,1,2,3,0.5,0.006687,1,1,1,0
156,,,jlpritchard11,0,1,1,0,1,1,0,0,1,1,1,0
157,,,erikuroo_,0,1,1,0,1,1,0,0,1,1,1,0
158,,,Mont_Jiang,26,1,27,34,6,40,0.038462,0.183581,0,0,0,0
159,,,o_hagim,0,20,20,0,20,20,0.002632,0,2,0.7,0.785714,0
160,,,pedal_by_pedal,4,2,6,6,4,10,0.2,0.026749,1,1,1,3
161,,,balletprof,1,1,2,1,1,2,0,0.006687,0,0,0,0
162,,,astroagency,1,1,2,1,1,2,0,0.006687,0,0,0,0
163,,,wm_yin,4,1,5,5,1,6,0.25,0.037231,0,0,0,0
164,,,yunozel,3,2,5,3,3,6,0.25,0.020061,1,1,1,2
165,,,dorothyk98,0,1,1,0,1,1,0,0,1,1,1,0
166,,,iLUVSUZU,0,1,1,0,1,1,0,0,2,0.666667,0.75,0
167,,,fluffylino,0,1,1,0,1,1,0,0,2,0.666667,0.75,0
168,,,m27c47b5b4mgk,0,10,10,0,10,10,0,0,5,0.5,0.588095,0
169,,,mikako20021,0,1,1,0,1,1,0,0,2,0.666667,0.75,0
170,,,klovex12,0,1,1,0,1,1,0,0,2,0.666667,0.75,0
171,,,thelandofall05,2,28,30,2,30,32,0.034483,0.013374,5,0.552632,0.764286,42
172,,,min_yuzugi,0,2,2,0,2,2,0,0,2,0.75,0.833333,0
173,,,karlrohe,2,1,3,2,1,3,0.5,0.013374,0,0,0,0
174,,,77andreea88,0,2,2,0,2,2,0,0,1,1,1,0
175,,,mikutyler,0,11,11,0,11,11,0,0,2,0.923077,0.958333,0
176,,,billshoemaker21,0,1,1,0,1,1,0,0,2,0.666667,0.75,0
177,,,Sharonb57470441,3,1,4,3,1,4,0.333333,0.020061,0,0,0,0
178,,,TaffyTheTrash,0,1,1,0,1,1,0,0,1,1,1,0
179,,,AlexashkaDR,0,1,1,0,1,1,0,0,1,1,1,0
180,,,Miyako_Hirano,3,1,4,3,1,4,0.333333,0.078015,0,0,0,0
181,,,kenwaydeb,0,1,1,0,1,1,0,0,1,1,1,0
182,,,NnImfbyTj3rGR6o,14,7,21,24,16,40,0.05,0.128562,1,1,1,132
183,,,Runonsentenc3,1,1,2,1,1,2,0,0.006687,0,0,0,0
184,,,FourStarWealth,2,1,3,2,1,3,0.5,0.020363,0,0,0,0
185,,,digitalfatemeh,1,1,2,1,1,2,0,0.006687,0,0,0,0
186,,,krs_rmafan,9,1,10,9,1,10,0.111111,0.060184,0,0,0,0
187,,,ang_nb,0,1,1,0,1,1,0,0,1,1,1,0
188,,,vibrantaries,0,2,2,0,2,2,0,0,1,1,1,0
189,,,ShottazMinaj,0,1,1,0,1,1,0,0,1,1,1,0
190,,,blue_tampa,0,1,1,0,1,1,0,0,1,1,1,0
191,,,CCccinnamonroll,0,1,1,0,1,1,0,0,1,1,1,0
192,,,jiminilIegal,0,1,1,0,1,1,0,0,1,1,1,0
193,,,blkhat26,0,1,1,0,1,1,0,0,1,1,1,0
194,,,Fonch2,0,1,1,0,1,1,0,0,1,1,1,0
195,,,brolensky,11,1,12,13,3,16,0.090909,0.084041,0,0,0,0
196,,,propertyofEO,4,1,5,5,2,7,0.25,0.026749,0,0,0,0
197,,,arentuamerican,0,1,1,0,1,1,0,0,1,1,1,0
198,,,BNGTNRKIVEJOON,0,1,1,0,1,1,0,0,1,1,1,0
199,,,pxwhittle,0,1,1,0,1,1,0,0,1,1,1,0
200,,,lakersbunny11,0,4,4,0,4,4,0,0,1,1,1,0
201,,,yuzuzuhuzuzu,0,2,2,0,2,2,0,0,1,1,1,0
202,,,knifeshoeballet,0,2,2,0,2,2,0,0,1,1,1,0
203,,,ginadalfonzo,4,1,5,5,2,7,0.25,0.026749,0,0,0,0
204,,,Vassa97590556,0,2,2,0,2,2,0,0,1,1,1,0
205,,,JuliaKehrli,4,1,5,4,1,5,0.25,0.026749,0,0,0,0
206,,,ayyyyyveslmao,0,1,1,0,1,1,0,0,1,1,1,0
207,,,srworthen,0,2,2,0,2,2,0,0,1,1,1,0
208,,,c3raunophil3,0,1,1,0,1,1,0,0,1,1,1,0
209,,,aprilreads414,0,1,1,0,1,1,0,0,1,1,1,0
210,,,RMinyoonji,6,4,10,9,7,16,0.111111,0.070371,1,1,1,69
211,,,FlambartP,0,3,3,0,4,4,0,0,2,0.8,0.875,0
212,,,heyyoushyjohnny,0,1,1,0,1,1,0,0,2,0.666667,0.75,0
213,,,AmbGemstone,4,1,5,4,1,5,0.25,0.026749,0,0,0,0
214,,,AlatunaSkils,0,1,1,0,1,1,0,0,1,1,1,0
215,,,TinyLe,0,2,2,0,2,2,0,0,1,1,1,0
216,,,cssnei,2,1,3,5,2,7,0.5,0.013374,0,0,0,0
217,,,kiimrodri,1,1,2,1,1,2,0,0.006687,0,0,0,0
218,,,sonevlvt,3,1,4,4,2,6,0.333333,0.020061,0,0,0,0
219,,,ilovemilfymoms,0,1,1,0,1,1,0,0,1,1,1,0
220,,,134340x1230,0,2,2,0,2,2,0,0,1,1,1,0
221,,,kbbang_y,0,28,28,0,33,33,0,0,3,0.813953,0.895238,0
222,,,ashleyehret7,16,1,17,17,2,19,0.0625,0.106994,0,0,0,0
223,,,RPappas333,0,1,1,0,1,1,0,0,1,1,1,0
224,,,princessa_jota,0,1,1,0,1,1,0,0,1,1,1,0
225,,,bridgetany,0,1,1,0,1,1,0,0,1,1,1,0
226,,,patriciacfiske,0,3,3,0,3,3,0,0,2,0.714286,0.8,0
227,,,BriandJustice,0,1,1,0,1,1,0,0,1,1,1,0
228,,,xindoleyokzany,0,5,5,0,5,5,0,0,3,0.7,0.833333,0
229,,,IHZ3jWyGUmlUmeT,0,18,18,0,19,19,0,0,3,0.785714,0.893939,0
230,,,hanyupals,0,3,3,0,3,3,0,0,1,1,1,0
231,,,masqueroarade,0,2,2,0,2,2,0,0,1,1,1,0
232,,,ryotacchii,0,2,2,0,2,2,0,0,1,1,1,0
233,,,LanceV72,0,1,1,0,1,1,0,0,1,1,1,0
234,,,honestlydiamond,3,1,4,4,2,6,0.333333,0.020061,0,0,0,0
235,,,suikafs,0,2,2,0,2,2,0,0,1,1,1,0
236,,,merydncl,11,1,12,12,1,13,0.090909,0.131512,0,0,0,0
237,,,huaIianisms,0,3,3,0,4,4,0,0,3,0.52381,0.606061,0
238,,,dsntedge,3,13,16,4,14,18,0.071429,0.020061,3,0.708333,0.833333,34
239,,,ForeverFanyu,5,4,9,5,4,9,0.125,0.033436,3,0.529412,0.62963,36
240,,,Ru_Kyum,0,1,1,0,1,1,0,0,3,0.466667,0.52381,0
241,,,BringinJackyBak,0,1,1,0,1,1,0,0,3,0.466667,0.52381,0
242,,,daylip6,0,1,1,0,1,1,0,0,3,0.466667,0.52381,0
243,,,satsuki_n_55,0,6,6,0,6,6,0,0,3,0.6,0.722222,0
244,,,pamgriffa,0,1,1,0,1,1,0,0,3,0.466667,0.52381,0
245,,,NithilaMPPeter,1,1,2,1,1,2,0,0.006687,0,0,0,0
246,,,kellyparkwaype,1,1,2,1,1,2,0,0.006687,0,0,0,0
247,,,odan5chu_DOCK,0,1,1,0,1,1,0,0,1,1,1,0
248,,,hkdemonow,0,4,4,0,5,5,0,0,1,1,1,0
249,,,tannieofmordor,22,1,23,22,1,23,0.045455,0.147117,0,0,0,0
250,,,yunamithan,0,30,30,0,30,30,0,0,2,0.894737,0.941176,0
251,,,Yiz_19980502,0,2,2,0,2,2,0,0,1,1,1,0
252,,,NanaS16632252,0,1,1,0,1,1,0,0,1,1,1,0
253,,,Liverpotlian,0,2,2,0,2,2,0,0,1,1,1,0
254,,,beakey3,0,2,2,0,2,2,0,0,1,1,1,0
255,,,mycrystalmemory,0,1,1,0,1,1,0,0,1,1,1,0
256,,,mullberrytree,0,1,1,0,1,1,0,0,1,1,1,0
257,,,ClementineLuvie,0,2,2,0,2,2,0,0,1,1,1,0
258,,,PennyJ24,0,1,1,0,1,1,0,0,1,1,1,0
259,,,elly1982grace,0,1,1,0,1,1,0,0,1,1,1,0
260,,,OdduduaS,0,5,5,0,5,5,0,0,1,1,1,0
261,,,kohaot,0,28,28,0,31,31,0,0,2,0.9375,0.966667,0
262,,,lovelyyyuzu,0,1,1,0,1,1,0,0,1,1,1,0
263,,,podsoskapozova,0,1,1,0,1,1,0,0,1,1,1,0
264,,,leon19660096,0,1,1,0,1,1,0,0,1,1,1,0
265,,,FigureSkateRose,0,1,1,0,1,1,0,0,1,1,1,0
266,,,zcwubbena,0,1,1,0,1,1,0,0,1,1,1,0
267,,,LiveRetiredLive,0,1,1,0,1,1,0,0,1,1,1,0
268,,,chadmhorner,0,1,1,0,1,1,0,0,1,1,1,0
269,,,Hanazaki_B,3,1,4,3,1,4,0.333333,0.075969,0,0,0,0
270,,,_yxxn00,0,4,4,0,4,4,0,0,1,1,1,0
271,,,aboutNathan9905,9,3,12,11,5,16,0.090909,0.099524,1,1,1,34
272,,,HopeLegacy1,0,2,2,0,2,2,0,0,2,0.666667,0.75,0
273,,,BGgourmet,0,3,3,0,3,3,0,0,2,0.714286,0.8,0
274,,,ShekinahEsalo,0,1,1,0,1,1,0,0,2,0.6,0.666667,0
275,,,PJMCHANEL_,0,1,1,0,1,1,0,0,2,0.6,0.666667,0
276,,,Ritti9,0,2,2,0,2,2,0,0,2,0.666667,0.75,0
277,,,RikoLinx81,0,1,1,0,1,1,0,0,1,1,1,0
278,,,LindaLMeilink,3,1,4,3,1,4,0.333333,0.135848,0,0,0,0
279,,,KatsuDauntless,29,2,31,42,4,46,0.033333,0.249835,1,1,1,43
280,,,Lovely_Yoongi93,0,1,1,0,1,1,0,0,1,1,1,0
281,,,jeeneeewoo,5,4,9,6,5,11,0.125,0.033436,1,1,1,12
282,,,semissourian,0,1,1,0,1,1,0,0,2,0.571429,0.625,0
283,,,GreenwichTime,5,1,6,5,1,6,0.2,0.033436,0,0,0,0
284,,,SchmattCheryl,0,1,1,0,1,1,0,0,1,1,1,0
285,,,canalzone721,0,1,1,0,1,1,0,0,1,1,1,0
286,,,RobRe62,0,3,3,0,3,3,0,0,1,1,1,0
287,,,EvelynSpring8,0,1,1,0,1,1,0,0,1,1,1,0
288,,,susankeepitreal,16,1,17,21,6,27,0.0625,0.106994,0,0,0,0
289,,,RealRohitNaseem,0,1,1,0,1,1,0,0,1,1,1,0
290,,,mpcoreno,0,1,1,0,1,1,0,0,1,1,1,0
291,,,lalobernal1,0,1,1,0,1,1,0,0,1,1,1,0
292,,,catdomino,0,3,3,0,3,3,0,0,2,0.571429,0.625,0
293,,,thehawaiiguy,0,1,1,0,1,1,0,0,1,1,1,0
294,,,DJRiter,0,1,1,0,1,1,0,0,1,1,1,0
295,,,jungkookinga,0,2,2,0,2,2,0,0,1,1,1,0
296,,,empresswenjing,0,1,1,0,1,1,0,0,1,1,1,0
297,,,Mel_Storni,0,2,2,0,2,2,0,0,1,1,1,0
298,,,pdpsingha,0,1,1,0,1,1,0,0,2,0.6,0.666667,0
299,,,hunguphere,1,1,2,1,1,2,0,0.006687,0,0,0,0
300,,,Ess_moe,0,1,1,0,1,1,0,0,2,0.571429,0.625,0
301,,,TeresaMWalker,0,1,1,0,1,1,0,0,2,0.571429,0.625,0
302,,,Anasmuhammad_,0,2,2,0,2,2,0,0,2,0.625,0.7,0
303,,,AP,4,1,5,5,2,7,0.25,0.026749,0,0,0,0
304,,,nobodyzIistenin,0,1,1,0,1,1,0,0,1,1,1,0
305,,,J_PNeo,2,1,3,2,1,3,0.5,0.013374,0,0,0,0
306,,,JCon286,0,1,1,0,1,1,0,0,1,1,1,0
307,,,Natefame,1,1,2,1,1,2,0,0.006687,0,0,0,0
308,,,Frankgibsonmad3,5,1,6,5,1,6,0.2,0.033436,0,0,0,0
309,,,iimogasuki,0,10,10,0,10,10,0,0,3,0.714286,0.822222,0
310,,,LUVH0LICS,0,1,1,0,1,1,0,0,1,1,1,0
311,,,yuzurulight,0,1,1,0,1,1,0,0,1,1,1,0
312,,,bgngb,0,1,1,0,1,1,0,0,1,1,1,0
313,,,lawanda50,0,1,1,0,1,1,0,0,1,1,1,0
314,,,rckstrkth,2,1,3,2,1,3,0.5,0.013374,0,0,0,0
315,,,YaBoiAXE,1,1,2,2,2,4,0,0.006687,0,0,0,0
316,,,gotsvnbjyx,0,1,1,0,1,1,0,0,1,1,1,0
317,,,nasko_tenev,2,1,3,2,1,3,0.5,0.013374,0,0,0,0
318,,,nabiya___,0,1,1,0,1,1,0,0,1,1,1,0
319,,,SylviaUnseen,3,1,4,5,3,8,0.333333,0.020061,0,0,0,0
320,,,BUBBLEBETD,0,1,1,0,1,1,0,0,1,1,1,0
321,,,cr0b1n,0,3,3,0,3,3,0,0,3,0.526316,0.566667,0
322,,,insider_ct,4,1,5,5,1,6,0.25,0.026749,0,0,0,0
323,,,4GenSFFanFam,0,1,1,0,1,1,0,0,1,1,1,0
324,,,the50person,0,3,3,0,3,3,0,0,2,0.8,0.875,0
325,,,sportsbaIIfan,3,1,4,3,1,4,0.333333,0.020061,0,0,0,0
326,,,bee68453069,0,4,4,0,4,4,0,0,2,0.75,0.833333,0
327,,,nederlagx,0,1,1,0,1,1,0,0,1,1,1,0
328,,,Nathanatormemez,16,17,33,19,21,40,0.03125,0.106994,2,0.944444,0.970588,255
329,,,LaxBeck,3,1,4,3,1,4,0.333333,0.020061,0,0,0,0
330,,,fernweh_723,0,1,1,0,1,1,0,0,1,1,1,0
331,,,badpersonal1ty,0,1,1,0,1,1,0,0,1,1,1,0
332,,,niba_cos,4,1,5,4,1,5,0.25,0.026749,0,0,0,0
333,,,CeciliaQuick,0,6,6,0,6,6,0,0,1,1,1,0
334,,,Yolii_Yolandaa,0,3,3,0,3,3,0,0,3,0.526316,0.566667,0
335,,,FrancesStockton,0,3,3,0,3,3,0,0,1,1,1,0
336,,,ForbesWomen,3,1,4,3,1,4,0.333333,0.02705,0,0,0,0
337,,,akki0907,0,10,10,0,10,10,0,0,2,0.916667,0.954545,0
338,,,ZhouXizhou,1,1,2,1,1,2,0,0.006687,0,0,0,0
339,,,savestheday91,6,1,7,6,1,7,0.166667,0.103019,0,0,0,0
340,,,EloisaUCV,0,1,1,0,1,1,0,0,1,1,1,0
341,,,meghankelleher3,0,1,1,0,1,1,0,0,1,1,1,0
342,,,andthewaltz,2,3,5,2,3,5,0.25,0.013374,1,1,1,2
343,,,ichig0tchi,0,4,4,0,4,4,0,0,2,0.75,0.833333,0
344,,,robodebeep,0,1,1,0,1,1,0,0,1,1,1,0
345,,,DATH0MIRIAN,1,1,2,1,1,2,0,0.006687,0,0,0,0
346,,,bangpdbot,0,6,6,0,6,6,0,0,2,0.875,0.928571,0
347,,,plant_f00d,5,1,6,5,1,6,0.2,0.033436,0,0,0,0
348,,,h0neyuzu,0,2,2,0,2,2,0,0,2,0.75,0.833333,0
349,,,shldrgang_323,0,1,1,0,1,1,0,0,1,1,1,0
350,,,allblue91608422,0,2,2,0,2,2,0,0,1,1,1,0
351,,,abysmal_squid,0,1,1,0,1,1,0,0,1,1,1,0
352,,,Dictasia,1,1,2,1,1,2,0,0.006687,0,0,0,0
353,,,Piupiupiu22,9,1,10,10,2,12,0.111111,0.06898,0,0,0,0
354,,,aISWJY,0,1,1,0,1,1,0,0,1,1,1,0
355,,,sink_or_swim,0,1,1,0,1,1,0,0,1,1,1,0
356,,,ameliaearheart,0,1,1,0,1,1,0,0,1,1,1,0
357,,,patbingzu,2,19,21,2,21,23,0.05,0.020363,1,1,1,36
358,,,kansaijin_hide,1,1,2,1,1,2,0,0.006687,0,0,0,0
359,,,emilyistootired,1,1,2,1,1,2,0,0.006687,0,0,0,0
360,,,Rickersam3,3,1,4,3,1,4,0.333333,0.020061,0,0,0,0
361,,,pioneerwizard,0,1,1,0,1,1,0,0,1,1,1,0
362,,,rosegoldkpopluv,0,1,1,0,1,1,0,0,1,1,1,0
363,,,Laurasenio,5,1,6,6,1,7,0.2,0.043918,0,0,0,0
364,,,tisiphoness,0,2,2,0,2,2,0,0,4,0.372093,0.432292,0
365,,,Megs_Woodard,0,5,5,0,5,5,0,0,2,0.857143,0.916667,0
366,,,1gTPBRpxxCSqhAR,0,2,2,0,2,2,0,0,1,1,1,0
367,,,moonlightstrife,1,1,2,2,2,4,0,0.006687,0,0,0,0
368,,,FanpagesFB,3,1,4,3,1,4,0.333333,0.020061,0,0,0,0
369,,,xovalentina_,0,1,1,0,1,1,0,0,1,1,1,0
370,,,_peaceminus,0,2,2,0,2,2,0,0,1,1,1,0
371,,,XinyaoW_ut,2,1,3,2,1,3,0.5,0.013374,0,0,0,0
372,,,annoyingisanart,0,6,6,0,6,6,0,0,1,1,1,0
373,,,ManagementStoic,1,1,2,1,1,2,0,0.006687,0,0,0,0
374,,,Wolfgangcapital,2,1,3,2,1,3,0.5,0.013374,0,0,0,0
375,,,Eevake,0,1,1,0,1,1,0,0,1,1,1,0
376,,,ReciteSocial,15,1,16,36,22,58,0.066667,0.16501,0,0,0,0
377,,,magcfrost,0,2,2,0,2,2,0,0,1,1,1,0
378,,,elfchrys,3,1,4,3,1,4,0.333333,0.020061,0,0,0,0
379,,,xiaenana,0,1,1,0,1,1,0,0,1,1,1,0
380,,,schmermund_mary,0,2,2,0,2,2,0,0,1,1,1,0
381,,,umncla,5,1,6,5,1,6,0.2,0.084409,0,0,0,0
382,,,masahi004,12,3,15,12,3,15,0.071429,0.120266,2,0.75,0.833333,141
383,,,Btsarmybakka,0,2,2,0,2,2,0,0,1,1,1,0
384,,,6hBuV3hql19kymu,0,17,17,0,19,19,0.003676,0,3,0.550847,0.617949,0
385,,,adrian74814533,6,1,7,6,1,7,0.166667,0.040123,0,0,0,0
386,,,Net2Ayurveda,0,1,1,0,1,1,0,0,1,1,1,0
387,,,doppioconpanic,0,1,1,0,1,1,0,0,1,1,1,0
388,,,MarieJo45528473,0,3,3,0,3,3,0,0,1,1,1,0
389,,,NathanChinese,4,1,5,4,1,5,0.25,0.082656,0,0,0,0
390,,,Sly_Prefect,0,1,1,0,1,1,0,0,1,1,1,0
391,,,MarupokPagEXO,0,1,1,0,1,1,0,0,1,1,1,0
392,,,Ranagocmen,0,2,2,0,2,2,0,0,1,1,1,0
393,,,phoebz17,0,1,1,0,1,1,0,0,1,1,1,0
394,,,wnszone,0,1,1,0,1,1,0,0,1,1,1,0
395,,,Herda36832930,0,5,5,0,6,6,0,0,1,1,1,0
396,,,zenggen61316621,0,4,4,0,4,4,0,0,2,0.833333,0.9,0
397,,,Jacqueline4Fun,5,1,6,8,4,12,0.2,0.063196,0,0,0,0
398,,,hi5connectgh,16,1,17,21,6,27,0.0625,0.117477,0,0,0,0
399,,,aliseyooo,0,4,4,0,4,4,0,0,1,1,1,0
400,,,mon_arce,0,1,1,0,1,1,0,0,1,1,1,0
401,,,Moewopp,1,1,2,1,1,2,0,0.006687,0,0,0,0
402,,,fmkgs,2,1,3,2,1,3,0.5,0.069282,0,0,0,0
403,,,tcomer4418,1,1,2,1,1,2,0,0.006687,0,0,0,0
404,,,YukiSNYC,2,1,3,2,1,3,0.5,0.013374,0,0,0,0
405,,,c133c_,0,1,1,0,1,1,0,0,1,1,1,0
406,,,Richard80982333,3,1,4,3,1,4,0.333333,0.020061,0,0,0,0
407,,,Dalhacatt,0,2,2,0,2,2,0,0,1,1,1,0
408,,,deduped_nytimes,0,2,2,0,2,2,0,0,3,0.510638,0.534722,0
409,,,nytimes,3,2,5,3,2,5,0.25,0.020061,3,0.5,0.514493,46
410,,,4thGenItBellboy,0,1,1,0,1,1,0,0,4,0.342857,0.364583,0
411,,,luverbin,0,1,1,0,1,1,0,0,4,0.342857,0.364583,0
412,,,HaroldWiggins,3,1,4,3,1,4,0.333333,0.020061,0,0,0,0
413,,,kj_smith,0,1,1,0,1,1,0,0,1,1,1,0
414,,,nerdette,0,1,1,0,1,1,0,0,1,1,1,0
415,,,ThisIs_JML,2,1,3,2,1,3,0.5,0.013374,0,0,0,0
416,,,LetaHong,0,1,1,0,1,1,0,0,1,1,1,0
417,,,JaysonH50782227,0,2,2,0,2,2,0,0,1,1,1,0
418,,,NazBeheshti,6,1,7,6,1,7,0.166667,0.040123,0,0,0,0
419,,,politicogirl770,0,1,1,0,1,1,0,0,1,1,1,0
420,,,spdrvrs2099,0,1,1,0,1,1,0,0,1,1,1,0
421,,,2kENA_,0,1,1,0,1,1,0,0,1,1,1,0
422,,,beibeiyuans,0,1,1,0,1,1,0,0,1,1,1,0
423,,,Dalbich_x,0,3,3,0,3,3,0,0,1,1,1,0
424,,,zoie_bun,1,1,2,1,1,2,0,0.006687,0,0,0,0
425,,,nazgggggghhhh,0,1,1,0,1,1,0,0,2,0.666667,0.75,0
426,,,FreeVipQuote,1,1,2,1,1,2,0,0.006687,0,0,0,0
427,,,SimplyLex494,2,1,3,2,1,3,0.5,0.013374,0,0,0,0
428,,,RonSupportsYou,0,1,1,0,1,1,0,0,1,1,1,0
429,,,AssPiuE,1,1,2,1,1,2,0,0.006687,0,0,0,0
430,,,MariManoogian,0,3,3,0,3,3,0,0,1,1,1,0
431,,,JohnAlanWest65,0,1,1,0,1,1,0,0,1,1,1,0
432,,,notdastfila,3,1,4,4,2,6,0.333333,0.020061,0,0,0,0
433,,,fs_chitchat,0,1,1,0,1,1,0,0,1,1,1,0
434,,,suilee,0,1,1,0,1,1,0,0,1,1,1,0
435,,,FortressFinGp,2,1,3,2,1,3,0.5,0.013374,0,0,0,0
436,,,_itssnicole,0,1,1,0,1,1,0,0,1,1,1,0
437,,,shomaswitch,4,1,5,4,1,5,0.25,0.026749,0,0,0,0
438,,,DedPetal,0,6,6,0,6,6,0,0,1,1,1,0
439,,,ChinaInsiders,0,1,1,0,1,1,0,0,1,1,1,0
440,,,kittyyunn,0,1,1,0,1,1,0,0,1,1,1,0
441,,,worldcupsage,4,1,5,4,1,5,0.25,0.033737,0,0,0,0
442,,,swiftfeatherz,0,1,1,0,1,1,0,0,1,1,1,0
443,,,AmaeHonne,0,1,1,0,1,1,0,0,1,1,1,0
444,,,gisdonewirh2020,2,2,4,2,2,4,0.333333,0.013374,1,1,1,1
445,,,thedbk,2,1,3,4,3,7,0.5,0.013374,0,0,0,0
446,,,honeybeelisaa,0,4,4,0,4,4,0,0,1,1,1,0
447,,,j0ctb,4,1,5,4,1,5,0.25,0.026749,0,0,0,0
448,,,SonalMhrzn,0,1,1,0,1,1,0,0,1,1,1,0
449,,,won0066,0,3,3,0,3,3,0,0,1,1,1,0
450,,,AyakoOikawa,0,1,1,0,1,1,0,0,1,1,1,0
451,,,hammett_nikki96,34,1,35,47,13,60,0.029412,0.232817,0,0,0,0
452,,,PCDKG,0,1,1,0,1,1,0,0,1,1,1,0
453,,,gibbo_bibbo,3,1,4,3,1,4,0.333333,0.020061,0,0,0,0
454,,,Franz96933748,0,1,1,0,1,1,0,0,1,1,1,0
455,,,tmnexclusive,0,2,2,0,2,2,0,0,1,1,1,0
456,,,bitch_picky,1,1,2,1,1,2,0,0.006687,0,0,0,0
457,,,kenz_robertson,1,3,4,1,3,4,0.333333,0.006687,1,1,1,0
458,,,Boi2Hil,20,1,21,27,7,34,0.05,0.140731,0,0,0,0
459,,,tikiya_harsh,0,2,2,0,2,2,0,0,1,1,1,0
460,,,DebBissen,0,1,1,0,1,1,0,0,1,1,1,0
461,,,aslihanyu,0,3,3,0,3,3,0,0,1,1,1,0
462,,,jonghyunstory,1,2,3,1,2,3,0.5,0.006687,1,1,1,0
463,,,xxyxyx04,0,2,2,0,2,2,0,0,1,1,1,0
464,,,jmhamiltonblog,0,1,1,0,1,1,0,0,1,1,1,0
465,,,teerapathy,0,1,1,0,1,1,0,0,1,1,1,0
466,,,M00NFANTASY,0,1,1,0,1,1,0,0,1,1,1,0
467,,,Lindakwert,0,2,2,0,2,2,0,0,1,1,1,0
468,,,MikeParentLEAP,2,1,3,2,1,3,0.5,0.013374,0,0,0,0
469,,,YU61268550,0,1,1,0,1,1,0,0,1,1,1,0
470,,,WZH100,2,1,3,2,1,3,0.5,0.013374,0,0,0,0
471,,,HazeL_Icy__,0,41,41,0,46,46,0,0,2,0.918367,0.955556,0
472,,,YuzuRedCheeks,1,5,6,1,5,6,0.2,0.006687,2,0.833333,0.9,0
473,,,hrtluvs,0,3,3,0,3,3,0,0,1,1,1,0
474,,,fluffyuzuru,0,1,1,0,1,1,0,0,1,1,1,0
475,,,wangxiangayaf,1,7,8,1,7,8,0.142857,0.006687,1,1,1,0
476,,,ShirleyKelly16,0,3,3,0,3,3,0,0,1,1,1,0
477,,,lunartearfleur,0,2,2,0,2,2,0,0,1,1,1,0
478,,,MovieFan513,0,3,3,0,3,3,0,0,1,1,1,0
479,,,skatingtalk,0,1,1,0,1,1,0,0,1,1,1,0
480,,,yoonmin_core,0,2,2,0,2,2,0,0,1,1,1,0
481,,,john_chu,0,6,6,0,6,6,0,0,2,0.875,0.928571,0
482,,,cheungchaukk,0,1,1,0,1,1,0,0,1,1,1,0
483,,,KFardoost,8,1,9,12,5,17,0.125,0.053497,0,0,0,0
484,,,d_bambina,0,2,2,0,2,2,0,0,1,1,1,0
485,,,yeontanfanpage,5,1,6,5,1,6,0.2,0.047413,0,0,0,0
486,,,idkfstan,1,2,3,1,2,3,0.5,0.006687,1,1,1,0
487,,,LestatsSanguis,3,2,5,3,2,5,0.25,0.020061,1,1,1,2
488,,,kostohanyu,0,1,1,0,1,1,0,0,1,1,1,0
489,,,Yuzurihamagic,0,11,11,0,12,12,0,0,1,1,1,0
490,,,es_sportsnews,6,1,7,11,6,17,0.166667,0.040123,0,0,0,0
491,,,NotACat___,2,1,3,2,1,3,0.5,0.013374,0,0,0,0
492,,,shcherbalympics,1,1,2,1,1,2,0,0.006687,0,0,0,0
493,,,brighfy,1,1,2,1,1,2,0,0.006687,0,0,0,0
494,,,username1boom,13,1,14,33,21,54,0.076923,0.090427,0,0,0,0
495,,,henlobea,2,1,3,2,1,3,0.5,0.013374,0,0,0,0
496,,,yexelvinz_,0,2,2,0,2,2,0,0,1,1,1,0
497,,,hiyyihpat,137,1,138,234,90,324,0.007353,1,0,0,0,0
498,,,yunagoat,0,1,1,0,1,1,0,0,1,1,1,0
499,,,btsot7jikook,2,1,3,2,1,3,0.5,0.020363,0,0,0,0
500,,,_TitanJ_,0,2,2,0,2,2,0,0,3,0.545455,0.638889,0
501,,,giftednobu,0,2,2,0,2,2,0,0,1,1,1,0
502,,,Zoe_Emiko,5,1,6,5,1,6,0.2,0.041617,0,0,0,0
503,,,ed_odeven,3,1,4,6,1,7,0,0.01188,1,1,1,3
504,,,yagihexe,0,1,1,0,1,1,0,0,1,1,1,0
505,,,JamesSemaj1220,0,3,3,0,3,3,0,0,1,1,1,0
506,,,nao_ha_otaku,0,3,3,0,3,3,0,0,2,0.8,0.875,0
507,,,medicinehelp,13,1,14,19,7,26,0.076923,0.095114,0,0,0,0
508,,,olyphil,5,4,9,10,8,18,0.125,0.040424,2,0.8,0.875,20
509,,,CIxxx15,0,2,2,0,2,2,0,0,3,0.545455,0.638889,0
510,,,LatestN72062740,22,1,23,26,4,30,0.045455,0.217824,0,0,0,0
511,,,dipriyanka,0,1,1,0,1,1,0,0,1,1,1,0
512,,,MessiahshipJJ,0,1,1,0,1,1,0,0,1,1,1,0
513,,,minheesfreckles,0,1,1,0,1,1,0,0,1,1,1,0
514,,,gigglesam2,0,3,3,0,3,3,0,0,1,1,1,0
515,,,pagesofbellrose,8,2,10,9,3,12,0.111111,0.159347,1,1,1,38
516,,,soobini_is,0,2,2,0,2,2,0,0,1,1,1,0
517,,,tunatsum,0,1,1,0,1,1,0,0,1,1,1,0
518,,,HealySm0ke,0,1,1,0,1,1,0,0,1,1,1,0
519,,,Riuka19,0,1,1,0,1,1,0,0,1,1,1,0
520,,,madeonsivan,0,1,1,0,1,1,0,0,1,1,1,0
521,,,9Zz6uio3W4Xxzry,0,2,2,0,2,2,0,0,1,1,1,0
522,,,rickey3danjuuro,0,1,1,0,1,1,0,0,1,1,1,0
523,,,mel_FnYu,0,1,1,0,1,1,0,0,1,1,1,0
524,,,levisothereye,0,2,2,0,2,2,0,0,2,0.666667,0.75,0
525,,,yazi2k,0,3,3,0,3,3,0,0,1,1,1,0
526,,,BornaPrincess2,0,11,11,0,14,14,0.009091,0,3,0.544304,0.612403,0
527,,,LisaTalmadge,0,2,2,0,2,2,0,0,1,1,1,0
528,,,LizNYC66,0,2,2,0,2,2,0,0,1,1,1,0
529,,,jadesaycould,0,1,1,0,1,1,0,0,1,1,1,0
530,,,nixzuru,0,2,2,0,2,2,0,0,1,1,1,0
531,,,sobehotel,1,1,2,1,1,2,0,0.006687,0,0,0,0
532,,,levi4president,1,1,2,1,1,2,0,0.006687,0,0,0,0
533,,,JoannaCheungC,45,1,46,51,6,57,0.022222,0.30791,0,0,0,0
534,,,haruno25ki,0,6,6,0,6,6,0,0,2,0.875,0.928571,0
535,,,percyj210,0,1,1,0,1,1,0,0,1,1,1,0
536,,,nomunomujoon,0,2,2,0,2,2,0,0,1,1,1,0
537,,,ljohn44,0,1,1,0,1,1,0,0,1,1,1,0
538,,,sportaruce,18,1,19,21,3,24,0.055556,0.130851,0,0,0,0
539,,,joonpavedtheway,0,1,1,0,1,1,0,0,1,1,1,0
540,,,hi_ta1017,1,15,16,1,16,17,0.066667,0.006687,1,1,1,0
541,,,chelseaaposaga,2,2,4,2,2,4,0.333333,0.013374,1,1,1,1
542,,,uchihakwon,0,3,3,0,4,4,0,0,1,1,1,0
543,,,exwifenews,4,1,5,4,1,5,0.25,0.026749,0,0,0,0
544,,,Iunapia,0,1,1,0,1,1,0,0,1,1,1,0
545,,,Pau51766200,0,1,1,0,1,1,0,0,1,1,1,0
546,,,softchoiwol,3,1,4,3,1,4,0.333333,0.020061,0,0,0,0
547,,,doissegund2Fev,0,1,1,0,1,1,0,0,1,1,1,0
548,,,kam3266,0,1,1,0,1,1,0,0,1,1,1,0
549,,,Madame9Roux,4,1,5,4,1,5,0.25,0.026749,0,0,0,0
550,,,shinwoness,0,3,3,0,3,3,0,0,1,1,1,0
551,,,fujoshi232,0,3,3,0,3,3,0,0,1,1,1,0
552,,,MargaretKLewis,0,1,1,0,1,1,0,0,1,1,1,0
553,,,margoroths,0,1,1,0,1,1,0,0,2,0.666667,0.75,0
554,,,KENTAMINATION,0,1,1,0,1,1,0,0,2,0.666667,0.75,0
555,,,tendercuriosty,0,1,1,0,1,1,0,0,2,0.666667,0.75,0
556,,,Sabari15061985,0,13,13,0,13,13,0,0,3,0.7,0.801587,0
557,,,bwlmp3,0,1,1,0,1,1,0,0,2,0.666667,0.75,0
558,,,AlexTwaddell,0,1,1,0,1,1,0,0,2,0.666667,0.75,0
559,,,MenaBurke,0,1,1,0,1,1,0,0,2,0.666667,0.75,0
560,,,opuseight,2,7,9,2,7,9,0.125,0.013374,2,0.875,0.928571,7
561,,,DefenseBaron,0,1,1,0,1,1,0,0,2,0.666667,0.75,0
562,,,HestiaJie,0,2,2,0,2,2,0,0,2,0.75,0.833333,0
563,,,bts_army_134340,6,8,14,6,8,14,0.076923,0.040123,2,0.888889,0.9375,40
564,,,academie_educ,9,1,10,15,6,21,0.111111,0.070667,0,0,0,0
565,,,gaonjsus,0,1,1,0,1,1,0,0,1,1,1,0
566,,,spearmexiao,5,1,6,6,2,8,0.2,0.033436,0,0,0,0
567,,,gerryshih,0,1,1,0,1,1,0,0,1,1,1,0
568,,,gillianwong,0,1,1,0,1,1,0,0,1,1,1,0
569,,,adbordreams,0,2,2,0,2,2,0,0,1,1,1,0
570,,,myoongleverse,8,1,9,8,1,9,0.125,0.061679,0,0,0,0
571,,,gaferronato,0,1,1,0,1,1,0,0,1,1,1,0
572,,,joonie_lay,0,3,3,0,3,3,0,0,1,1,1,0
573,,,Sakusaku46wDiem,0,16,16,0,17,17,0,0,3,0.694444,0.806667,0
574,,,vwang3,0,1,1,0,1,1,0,0,1,1,1,0
575,,,1011tsantsan,3,1,4,3,1,4,0,0.01188,1,1,1,3
576,,,_yu_k_k_o,0,7,7,0,7,7,0,0,2,0.888889,0.9375,0
577,,,Lily_BTS_OT7,0,4,4,0,4,4,0,0,2,0.833333,0.9,0
578,,,ms2th,7,1,8,7,1,8,0.142857,0.04681,0,0,0,0
579,,,SugasLeftCheeks,0,2,2,0,2,2,0,0,1,1,1,0
580,,,YoundyC,0,1,1,0,1,1,0,0,1,1,1,0
581,,,Yongcahontas,0,4,4,0,4,4,0,0,1,1,1,0
582,,,van87dan,0,1,1,0,1,1,0,0,1,1,1,0
583,,,bapbIog,0,1,1,0,1,1,0,0,1,1,1,0
584,,,Shomas3A1Lo3F,0,3,3,0,3,3,0,0,2,0.714286,0.8,0
585,,,jo_jlsr3353,3,1,4,4,1,5,0.333333,0.020061,0,0,0,0
586,,,M8IjaLre30syQFI,0,16,16,0,17,17,0,0,2,0.863636,0.921053,0
587,,,dadadahsn,0,2,2,0,3,3,0,0,1,1,1,0
588,,,KLBSt8ofSk8,0,3,3,0,3,3,0,0,5,0.422222,0.510526,0
589,,,tearsmadrigale,0,2,2,0,2,2,0,0,5,0.409091,0.483333,0
590,,,sacookyyy,0,40,40,0,44,44,0.000641,0,2,0.9,0.944444,0
591,,,newyorkglobe,3,1,4,3,1,4,0.333333,0.020061,0,0,0,0
592,,,Kittybox1,0,2,2,0,2,2,0,0,1,1,1,0
593,,,ewong,0,1,1,0,1,1,0,0,1,1,1,0
594,,,mojito_lover_,0,21,21,0,21,21,0,0,3,0.570093,0.655738,0
595,,,rin_kmh,6,7,13,6,7,13,0.083333,0.040123,1,1,1,30
596,,,mucc_sayu_mct,0,1,1,0,1,1,0,0,1,1,1,0
597,,,EINHumanRights,13,1,14,13,1,14,0.076923,0.135852,0,0,0,0
598,,,kwanette,0,2,2,0,2,2,0,0,1,1,1,0
599,,,sangkancilguru,0,2,2,0,2,2,0,0,1,1,1,0
600,,,uzutoracat,0,11,11,0,13,13,0,0,2,0.789474,0.866667,0
601,,,stananaaa,0,4,4,0,4,4,0,0,1,1,1,0
602,,,hanabe455,0,12,12,0,12,12,0,0,5,0.485981,0.574359,0
603,,,remirol1956,0,3,3,0,3,3,0,0,1,1,1,0
604,,,uminekomotti,9,13,22,9,13,22,0.047619,0.060184,2,0.772727,0.852941,136
605,,,PaciFisTMO,0,1,1,0,1,1,0,0,2,0.545455,0.583333,0
606,,,Yi34,0,1,1,0,1,1,0,0,2,0.545455,0.583333,0
607,,,LiYuan6,0,1,1,0,1,1,0,0,3,0.5,0.514493,0
608,,,SoQoooo__t,0,1,1,0,1,1,0,0,3,0.5,0.514493,0
609,,,goatyuzu1207,0,2,2,0,2,2,0,0,3,0.510638,0.534722,0
610,,,freakeyfive,0,1,1,0,2,2,0,0,1,1,1,0
611,,,yukartiste,0,1,1,0,1,1,0,0,1,1,1,0
612,,,lim_n3c,0,4,4,0,4,4,0,0,1,1,1,0
613,,,petehw11,0,1,1,0,1,1,0,0,1,1,1,0
614,,,arliznajia,0,1,1,0,1,1,0,0,1,1,1,0
615,,,remflor008,0,1,1,0,1,1,0,0,1,1,1,0
616,,,H_X_S,0,1,1,0,1,1,0,0,1,1,1,0
617,,,motosukeota,0,2,2,0,2,2,0,0,1,1,1,0
618,,,CXC_RyukoM,0,1,1,0,1,1,0,0,1,1,1,0
619,,,Radlein,0,1,1,0,1,1,0,0,1,1,1,0
620,,,makikoshiro,0,1,1,0,1,1,0,0,1,1,1,0
621,,,gaozhi82,0,1,1,0,1,1,0,0,1,1,1,0
622,,,VincentZhouJPFC,0,1,1,0,1,1,0,0,1,1,1,0
623,,,x1aoIvr,0,1,1,0,1,1,0,0,1,1,1,0
624,,,augus_au,1,1,2,1,1,2,0,0.006687,0,0,0,0
625,,,PekingMike,0,1,1,0,1,1,0,0,1,1,1,0
626,,,RoadTrip_Ciel,0,2,2,0,2,2,0,0,1,1,1,0
627,,,luise_dUbo,0,1,1,0,1,1,0,0,1,1,1,0
628,,,kagechama_,0,1,1,0,1,1,0,0,6,0.333333,0.370299,0
629,,,RealitySelect0r,1,1,2,1,1,2,0,0.006687,0,0,0,0
630,,,tellmetimes,1,1,2,1,1,2,0,0.006687,0,0,0,0
631,,,sameepshastri,8,1,9,9,1,10,0.125,0.053497,0,0,0,0
632,,,skyuzuru,0,2,2,0,2,2,0,0,1,1,1,0
633,,,panphil,0,1,1,0,1,1,0,0,1,1,1,0
634,,,asakareiko1,0,1,1,0,1,1,0,0,1,1,1,0
635,,,mangosorbet0,0,2,2,0,3,3,0,0,1,1,1,0
636,,,Rambo59211915,0,1,1,0,1,1,0,0,1,1,1,0
637,,,dynasty,8,1,9,8,1,9,0.125,0.06398,0,0,0,0
638,,,GUIIZHNG,0,1,1,0,1,1,0,0,1,1,1,0
639,,,hanyu_3,0,1,1,0,1,1,0,0,1,1,1,0
640,,,maravding,0,1,1,0,1,1,0,0,1,1,1,0
641,,,melaniebg720,0,4,4,0,4,4,0,0,1,1,1,0
642,,,cloistweeting,0,3,3,0,3,3,0,0,3,0.545455,0.694444,0
643,,,anand_market,4,1,5,4,1,5,0.25,0.026749,0,0,0,0
644,,,crivons_,0,1,1,0,1,1,0,0,1,1,1,0
645,,,keypoint89,0,1,1,0,1,1,0,0,1,1,1,0
646,,,yolandaar_,0,3,3,0,3,3,0,0,1,1,1,0
647,,,cousimgreg,1,2,3,1,2,3,0.5,0.006687,1,1,1,0
648,,,floyd25377728,3,1,4,3,1,4,0.333333,0.020061,0,0,0,0
649,,,timzeng16,0,1,1,0,1,1,0,0,1,1,1,0
650,,,putafisch,11,1,12,14,3,17,0.090909,0.080547,0,0,0,0
651,,,EmeSan_,0,1,1,0,1,1,0,0,1,1,1,0
652,,,amy_changchien,0,1,1,0,1,1,0,0,1,1,1,0
653,,,MarkLeeArse,1,1,2,1,1,2,0,0.006687,0,0,0,0
654,,,nejinuco,2,1,3,2,1,3,0.5,0.041567,0,0,0,0
655,,,saurlgbt,6,3,9,7,4,11,0.125,0.068077,1,1,1,22
656,,,bitchykimchi_,1,1,2,1,1,2,0,0.006687,0,0,0,0
657,,,21bestnumevar,0,4,4,0,4,4,0,0,1,1,1,0
658,,,e_newsUS,5,1,6,5,1,6,0.2,0.054401,0,0,0,0
659,,,rinko12130908,0,1,1,0,1,1,0,0,1,1,1,0
660,,,therosytent,0,1,1,0,1,1,0,0,1,1,1,0
661,,,zhihuachen,6,3,9,7,4,11,0.125,0.040123,1,1,1,10
662,,,Cult_Crunch,5,1,6,5,1,6,0.2,0.033436,0,0,0,0
663,,,HoldMyBooks,0,1,1,0,1,1,0,0,1,1,1,0
664,,,kaworry,0,4,4,0,4,4,0,0,1,1,1,0
665,,,amyyqin,1,2,3,1,2,3,0.5,0.006687,1,1,1,0
666,,,purelyfast,1,1,2,1,1,2,0,0.006687,0,0,0,0
667,,,Muhabarishaji,4,1,5,5,2,7,0.25,0.026749,0,0,0,0
668,,,gany_iu,22,1,23,25,4,29,0.045455,0.147117,0,0,0,0
669,,,auto_news_feed,1,1,2,1,1,2,0,0.006687,0,0,0,0
670,,,gentecosmotv,2,1,3,2,1,3,0.5,0.013374,0,0,0,0
671,,,max4995,0,8,8,0,8,8,0,0,2,0.785714,0.863636,0
672,,,dev_guy,3,1,4,3,1,4,0.333333,0.030936,0,0,0,0
673,,,kote1102,0,1,1,0,1,1,0,0,1,1,1,0
674,,,lucidagrandis,13,1,14,16,4,20,0.076923,0.086933,0,0,0,0
675,,,mayu8884,0,3,3,0,3,3,0,0,1,1,1,0
676,,,akaknkonko,0,4,4,0,4,4,0,0,1,1,1,0
677,,,806coco,0,1,1,0,1,1,0,0,1,1,1,0
678,,,daisuki15403271,0,1,1,0,1,1,0,0,1,1,1,0
679,,,mmni3014,0,5,5,0,5,5,0,0,2,0.857143,0.916667,0
680,,,mayuta_mayuta,0,3,3,0,3,3,0,0,1,1,1,0
681,,,ryoga4min,0,21,21,0,21,21,0,0,2,0.956522,0.977273,0
682,,,metier_mn,0,2,2,0,2,2,0,0,1,1,1,0
683,,,windicalclub,0,1,1,0,1,1,0,0,1,1,1,0
684,,,ISU_Speed,1,1,2,1,1,2,0,0.006687,0,0,0,0
685,,,ISU_Figure,7,1,8,8,2,10,0.142857,0.04681,0,0,0,0
686,,,longtailedmonk,6,1,7,6,1,7,0.166667,0.040123,0,0,0,0
687,,,GusoCB,0,1,1,0,1,1,0,0,1,1,1,0
688,,,NakkoSawa,0,1,1,0,1,1,0,0,1,1,1,0
689,,,TGIF1994,0,4,4,0,4,4,0,0,1,1,1,0
690,,,CitrusLemonBer1,0,1,1,0,1,1,0,0,1,1,1,0
691,,,cassis0401vocal,0,2,2,0,2,2,0,0,1,1,1,0
692,,,sumire_yoi,0,2,2,0,2,2,0,0,2,0.75,0.833333,0
693,,,grinned_n,0,6,6,0,6,6,0,0,2,0.875,0.928571,0
694,,,PapiandPooh422,0,1,1,0,1,1,0,0,2,0.666667,0.75,0
695,,,rapportheworld,3,6,9,4,7,11,0.125,0.020061,2,0.857143,0.916667,12
696,,,LynnRutherford,1,3,4,1,3,4,0.333333,0.006687,2,0.75,0.833333,0
697,,,Hooniegrin1,0,1,1,0,1,1,0,0,2,0.666667,0.75,0
698,,,migemu,0,5,5,0,5,5,0,0,2,0.727273,0.8125,0
699,,,LindaDeutsch,6,1,7,6,1,7,0.166667,0.0541,0,0,0,0
700,,,reihok,0,2,2,0,2,2,0,0,1,1,1,0
701,,,Maya20389439,0,5,5,0,5,5,0,0,1,1,1,0
702,,,pinkdevilsi,0,5,5,0,5,5,0,0,1,1,1,0
703,,,Elena47563619,0,1,1,0,1,1,0,0,1,1,1,0
704,,,beemupp,5,1,6,5,1,6,0.2,0.033436,0,0,0,0
705,,,FansSkating,0,2,2,0,2,2,0,0,1,1,1,0
706,,,ichigorennyuu7,0,5,5,0,5,5,0,0,1,1,1,0
707,,,Wavywatts,2,1,3,2,1,3,0.5,0.020363,0,0,0,0
708,,,KimDeokSo,2,3,5,2,3,5,0.25,0.013374,1,1,1,2
709,,,LYN44440779,0,1,1,0,1,1,0,0,1,1,1,0
710,,,rtoneeee,0,6,6,0,6,6,0,0,1,1,1,0
711,,,Rilakkuma820,0,1,1,0,1,1,0,0,1,1,1,0
712,,,Luisa21701735,0,1,1,0,1,1,0,0,1,1,1,0
713,,,yrn_tknk,0,1,1,0,1,1,0,0,1,1,1,0
714,,,suryasridhar_,2,1,3,2,1,3,0.5,0.013374,0,0,0,0
715,,,sanika1020__,5,1,6,5,1,6,0.2,0.118079,0,0,0,0
716,,,melody_skating,30,11,41,30,11,41,0.00061,0.128414,2,0.823529,0.892857,456.5
717,,,minka1202,0,7,7,0,7,7,0,0,2,0.818182,0.888889,0
718,,,lesprit_mao_26,0,2,2,0,2,2,0,0,1,1,1,0
719,,,WealthFort,2,1,3,2,1,3,0.5,0.013374,0,0,0,0
720,,,NickMcCarvel,12,2,14,14,4,18,0.076923,0.08374,2,0.6,0.666667,33
721,,,AllawatiNoor,0,1,1,0,1,1,0,0,3,0.444444,0.541667,0
722,,,xihimhis,0,1,1,0,1,1,0,0,3,0.444444,0.541667,0
723,,,thequeenjubilee,0,1,1,0,1,1,0,0,3,0.444444,0.541667,0
724,,,Nathan_Chen_,0,1,1,0,1,1,0,0,3,0.444444,0.541667,0
725,,,BeritDr,0,1,1,0,1,1,0,0,3,0.444444,0.541667,0
726,,,axelhannn,0,1,1,0,1,1,0,0,1,1,1,0
727,,,ComradeCary,0,1,1,0,1,1,0,0,1,1,1,0
728,,,butchcatss,2,1,3,2,1,3,0.5,0.013374,0,0,0,0
729,,,justcurious1313,0,8,8,0,8,8,0,0,2,0.833333,0.9,0
730,,,imjknotddaeng,3,1,4,3,1,4,0.333333,0.020061,0,0,0,0
731,,,freyaminnie,0,1,1,0,1,1,0,0,1,1,1,0
732,,,whirlwtind,0,1,1,0,1,1,0,0,1,1,1,0
733,,,KeshaMarm,4,1,5,13,10,23,0.25,0.026749,0,0,0,0
734,,,hayleyngarcia,2,1,3,2,1,3,0.5,0.013374,0,0,0,0
735,,,kevin37068512,0,1,1,0,1,1,0,0,1,1,1,0
736,,,brandonmscales,0,7,7,0,7,7,0,0,1,1,1,0
737,,,OhBilly2000,13,1,14,19,7,26,0.076923,0.097416,0,0,0,0
738,,,Janetchristie18,0,3,3,0,3,3,0,0,1,1,1,0
739,,,KaliaXi31379368,0,1,1,0,1,1,0,0,1,1,1,0
740,,,catnadeshiko,0,1,1,0,1,1,0,0,1,1,1,0
741,,,seb_schreiber,0,1,1,0,1,1,0,0,1,1,1,0
742,,,TheHeckReaction,0,2,2,0,2,2,0,0,1,1,1,0
743,,,FluxMulder,8,1,9,10,1,11,0.125,0.053497,0,0,0,0
744,,,ButterMLKe,0,1,1,0,1,1,0,0,1,1,1,0
745,,,KarenPatrycja,0,2,2,0,2,2,0,0,1,1,1,0
746,,,timo19571,0,13,13,0,13,13,0,0,2,0.933333,0.964286,0
747,,,MaLuGMinmin,0,2,2,0,2,2,0,0,1,1,1,0
748,,,ApothecaryJeri,0,1,1,0,1,1,0,0,1,1,1,0
749,,,stefionice,0,1,1,0,1,1,0,0,3,0.5,0.547619,0
750,,,Hjon66,1,4,5,1,4,5,0.25,0.006687,1,1,1,0
751,,,Akemi_247,1,1,2,1,1,2,0,0.006687,0,0,0,0
752,,,CUNTY2K,2,1,3,2,1,3,0.5,0.013374,0,0,0,0
753,,,jstar924,0,2,2,0,2,2,0,0,1,1,1,0
754,,,ionknowboutthat,4,1,5,4,1,5,0.25,0.12561,0,0,0,0
755,,,velouriann,27,12,39,34,20,54,0.026316,0.198024,2,0.923077,0.958333,360
756,,,tubegrrl,0,1,1,0,1,1,0,0,1,1,1,0
757,,,DVXz0jpdIDNIzEW,0,1,1,0,1,1,0,0,1,1,1,0
758,,,xnamqi,0,3,3,0,3,3,0,0,1,1,1,0
759,,,cerisiergateau,0,2,2,0,2,2,0,0,1,1,1,0
760,,,AmruthaSivaani,0,1,1,0,1,1,0,0,1,1,1,0
761,,,luvvsapnap,0,1,1,0,1,1,0,0,1,1,1,0
762,,,supersinga,1,1,2,1,1,2,0,0.006687,0,0,0,0
763,,,ThompskeKathryn,6,1,7,7,1,8,0.166667,0.047111,0,0,0,0
764,,,clsn640,0,22,22,0,24,24,0,0,1,1,1,0
765,,,AnJeongJae,0,1,1,0,1,1,0,0,1,1,1,0
766,,,Alenysus,0,1,1,0,1,1,0,0,1,1,1,0
767,,,gabriellee_zu,0,2,2,0,3,3,0,0,1,1,1,0
768,,,Leaf29555654,0,7,7,0,7,7,0,0,1,1,1,0
769,,,davidkurt4455,0,1,1,0,1,1,0,0,1,1,1,0
770,,,gnfsdoormat,5,1,6,5,1,6,0.2,0.03693,0,0,0,0
771,,,classylego,0,1,1,0,1,1,0,0,1,1,1,0
772,,,KKanner123,0,1,1,0,1,1,0,0,1,1,1,0
773,,,aonamida_pencil,0,4,4,0,4,4,0,0,1,1,1,0
774,,,Doodludoo,0,1,1,0,1,1,0,0,1,1,1,0
775,,,bruceechang,1,1,2,1,1,2,0,0.006687,0,0,0,0
776,,,Chriseo26,1,1,2,1,1,2,0,0.006687,0,0,0,0
777,,,meta_versatile,2,1,3,2,1,3,0.5,0.013374,0,0,0,0
778,,,Jordan172573127,0,1,1,0,1,1,0,0,1,1,1,0
779,,,Mapiavva,3,2,5,3,2,5,0.25,0.023556,1,1,1,2
780,,,OlympicDisco,1,5,6,1,5,6,0.2,0.006687,2,0.7,0.785714,0
781,,,Loveskate19,0,7,7,0,7,7,0,0,2,0.769231,0.85,0
782,,,sfdaya,1,1,2,1,1,2,0,0.006687,0,0,0,0
783,,,HalWilliams7,1,2,3,1,2,3,0.5,0.006687,1,1,1,0
784,,,yaochhi,2,1,3,3,1,4,0.5,0.030845,0,0,0,0
785,,,zq200709,5,6,11,5,7,12,0.1,0.033436,1,1,1,20
786,,,RajinSandhu,6,1,7,8,3,11,0.166667,0.040123,0,0,0,0
787,,,kaaelzi,0,1,1,0,1,1,0,0,1,1,1,0
788,,,Bawesome69Jb,0,1,1,0,1,1,0,0,1,1,1,0
789,,,sachijin,0,1,1,0,1,1,0,0,1,1,1,0
790,,,airi_cruz,0,2,2,0,2,2,0,0,1,1,1,0
791,,,sisimaruk7,0,2,2,0,2,2,0,0,1,1,1,0
792,,,RxSAunjVYZEeQex,0,1,1,0,1,1,0,0,1,1,1,0
793,,,TaiFung_Seattle,0,1,1,0,1,1,0,0,1,1,1,0
794,,,nyulevel,3,1,4,3,1,4,0.333333,0.020061,0,0,0,0
795,,,yonaprint,7,2,9,7,2,9,0.125,0.050304,1,1,1,6
796,,,RainbowTara1,0,1,1,0,1,1,0,0,2,0.666667,0.75,0
797,,,CandidlyKate,1,4,5,1,4,5,0.25,0.006687,2,0.666667,0.75,0
798,,,immortaljuniper,0,1,1,0,1,1,0,0,2,0.666667,0.75,0
799,,,1mHongkonger,0,1,1,0,1,1,0,0,2,0.666667,0.75,0
800,,,PippaViktoria,9,1,10,11,3,14,0.111111,0.067173,0,0,0,0
801,,,KunnidaJan,0,1,1,0,1,1,0,0,1,1,1,0
802,,,bearobadnews,1,1,2,1,1,2,0,0.006687,0,0,0,0
803,,,thousandfabrics,1,1,2,1,1,2,0,0.006687,0,0,0,0
804,,,Nicolle99Paola,0,1,1,0,1,1,0,0,1,1,1,0
805,,,Pioneer_Nathan,0,9,9,0,9,9,0,0,1,1,1,0
806,,,VilVil1,2,9,11,2,9,11,0.1,0.013374,1,1,1,8
807,,,anjjeni,3,1,4,3,1,4,0.333333,0.030544,0,0,0,0
808,,,flies9024,0,1,1,0,1,1,0,0,1,1,1,0
809,,,terasu0843,0,2,2,0,2,2,0,0,2,0.75,0.833333,0
810,,,BarryWo31638350,0,1,1,0,1,1,0,0,2,0.666667,0.75,0
811,,,sydthepasserby,3,32,35,3,33,36,0,0.01188,2,0.847826,0.910256,116
812,,,ST4RRYEPIPHANY,0,2,2,0,2,2,0,0,1,1,1,0
813,,,makeshiftthings,1,1,2,1,1,2,0,0.006687,0,0,0,0
814,,,yesulga98,0,1,1,0,1,1,0,0,1,1,1,0
815,,,jnyyankees,0,1,1,0,1,1,0,0,1,1,1,0
816,,,GorurVinay,0,1,1,0,1,1,0,0,1,1,1,0
817,,,mkglimpse,0,7,7,0,7,7,0,0,3,0.666667,0.777778,0
818,,,joannw1203,0,1,1,0,1,1,0,0,1,1,1,0
819,,,clynncam,0,1,1,0,1,1,0,0,3,0.396226,0.420635,0
820,,,7mariaEdwards,6,1,7,8,3,11,0.166667,0.040123,0,0,0,0
821,,,carnivalmatey,2,1,3,2,1,3,0.5,0.013374,0,0,0,0
822,,,mugi_no0,0,2,2,0,2,2,0,0,1,1,1,0
823,,,usconsvancouver,3,1,4,3,1,4,0.333333,0.020061,0,0,0,0
824,,,Paulzsmith75gm1,0,1,1,0,1,1,0,0,1,1,1,0
825,,,b1PiWLUxvJ22Npl,0,2,2,0,2,2,0,0,1,1,1,0
826,,,christie98,4,1,5,5,2,7,0.25,0.026749,0,0,0,0
827,,,theycallmeK2M,0,1,1,0,1,1,0,0,1,1,1,0
828,,,dranielbrungus,0,1,1,0,1,1,0,0,1,1,1,0
829,,,flyonthewindsc,3,1,4,3,1,4,0.333333,0.020061,0,0,0,0
830,,,iceskatepop,0,8,8,0,9,9,0,0,5,0.487805,0.5675,0
831,,,kflan56,0,5,5,0,5,5,0,0,1,1,1,0
832,,,notkennii,1,1,2,1,1,2,0,0.006687,0,0,0,0
833,,,newsman82,2,1,3,2,1,3,0.5,0.013374,0,0,0,0
834,,,kathl33n11,0,1,1,0,1,1,0,0,1,1,1,0
835,,,hessom_r,1,1,2,1,1,2,0,0.006687,0,0,0,0
836,,,hubbellhuechen,5,6,11,7,8,15,0.1,0.063196,3,0.555556,0.7,120
837,,,PeaceNow4Life,4,1,5,5,2,7,0.25,0.026749,0,0,0,0
838,,,plumeria2009,1,1,2,1,1,2,0,0.006687,0,0,0,0
839,,,gpirnia,6,1,7,7,2,9,0.166667,0.040123,0,0,0,0
840,,,RurikoTerada,0,2,2,0,2,2,0,0,1,1,1,0
841,,,MediaSnarking,1,1,2,1,1,2,0,0.006687,0,0,0,0
842,,,ateezyoongi,1,1,2,1,1,2,0,0.006687,0,0,0,0
843,,,yogaACAB,5,1,6,7,3,10,0.2,0.033436,0,0,0,0
844,,,hwanaejimaa,1,1,2,1,1,2,0,0.006687,0,0,0,0
845,,,umcelery,19,1,20,24,1,25,0.052632,0.134044,0,0,0,0
846,,,Richard47364241,0,1,1,0,1,1,0,0,1,1,1,0
847,,,032chan_honey,0,2,2,0,2,2,0,0,1,1,1,0
848,,,salchowproblem,0,2,2,0,2,2,0,0,1,1,1,0
849,,,zhiliang_zhou,0,1,1,0,1,1,0,0,1,1,1,0
850,,,sweet_ohm_smile,0,1,1,0,1,1,0,0,1,1,1,0
851,,,misha321321,0,1,1,0,2,2,0,0,1,1,1,0
852,,,top72010,0,1,1,0,1,1,0,0,1,1,1,0
853,,,PHLNewsInsider,0,4,4,0,4,4,0,0,1,1,1,0
854,,,FootballCommie,0,1,1,0,1,1,0,0,1,1,1,0
855,,,Aprilapplesweet,0,1,1,0,1,1,0,0,1,1,1,0
856,,,Clayonnn,0,1,1,0,1,1,0,0,1,1,1,0
857,,,IAmTheLuckiest7,0,1,1,0,1,1,0,0,1,1,1,0
858,,,aj_adams2,0,5,5,0,5,5,0,0,2,0.857143,0.916667,0
859,,,aleinna_sonkho,0,1,1,0,1,1,0,0,1,1,1,0
860,,,lokicharmzz,0,1,1,0,1,1,0,0,1,1,1,0
861,,,MaryB19447428,2,4,6,2,5,7,0.2,0.013374,1,1,1,3
862,,,paupalmen,0,1,1,0,1,1,0,0,1,1,1,0
863,,,Khwaja_Shaik,0,1,1,0,1,1,0,0,1,1,1,0
864,,,shirley_2031,0,2,2,0,2,2,0,0,3,0.571429,0.708333,0
865,,,justanatefan,0,8,8,0,10,10,0,0,1,1,1,0
866,,,2gaijinneko,0,1,1,0,1,1,0,0,1,1,1,0
867,,,RocketstarMedia,3,1,4,3,1,4,0.333333,0.020061,0,0,0,0
868,,,unon_maon,0,1,1,0,1,1,0,0,1,1,1,0
869,,,D18Hanna,0,1,1,0,1,1,0,0,1,1,1,0
870,,,soyladeayerr,6,1,7,6,1,7,0.166667,0.068342,0,0,0,0
871,,,szm_110_,0,3,3,0,3,3,0,0,1,1,1,0
872,,,galaxietoots,0,1,1,0,1,1,0,0,1,1,1,0
873,,,ErinArias15,0,2,2,0,5,5,0,0,1,1,1,0
874,,,lovesamxntha,1,1,2,1,1,2,0,0.006687,0,0,0,0
875,,,RshallAve,7,1,8,12,2,14,0.142857,0.04681,0,0,0,0
876,,,janiehar,0,1,1,0,1,1,0,0,1,1,1,0
877,,,fool_zhou,0,1,1,0,1,1,0,0,1,1,1,0
878,,,Magnus_Fiskesjo,0,1,1,0,1,1,0,0,1,1,1,0
879,,,turbokat42,2,1,3,2,1,3,0.5,0.013374,0,0,0,0
880,,,kimthsea,0,2,2,0,2,2,0,0,1,1,1,0
881,,,Skyer58708949,1,1,2,2,2,4,0,0.006687,0,0,0,0
882,,,_solarize_,2,1,3,3,2,5,0.5,0.013374,0,0,0,0
883,,,eph_ren,0,1,1,0,1,1,0,0,1,1,1,0
884,,,HuangDogYellow,1,1,2,1,1,2,0,0.006687,0,0,0,0
885,,,hdFk4wqClr0vp2,0,2,2,0,2,2,0,0,1,1,1,0
886,,,CFLMichael,1,1,2,1,1,2,0,0.006687,0,0,0,0
887,,,vlatkasb1tch,1,1,2,1,1,2,0,0.006687,0,0,0,0
888,,,Alex72385784,3,1,4,3,1,4,0.333333,0.020061,0,0,0,0
889,,,kelppshake,0,1,1,0,1,1,0,0,1,1,1,0
890,,,8ngeIs,0,2,2,0,2,2,0,0,1,1,1,0
891,,,soymilkbirthday,2,1,3,2,1,3,0.5,0.013374,0,0,0,0
892,,,gflaccus,3,1,4,3,1,4,0.333333,0.020061,0,0,0,0
893,,,davidwang1963,0,1,1,0,1,1,0,0,1,1,1,0
894,,,tls123_twt,0,3,3,0,3,3,0,0,1,1,1,0
895,,,samuelyork1984,1,1,2,1,1,2,0,0.006687,0,0,0,0
896,,,Bksandauthors,1,1,2,1,1,2,0,0.006687,0,0,0,0
897,,,RyanAcree,3,1,4,3,1,4,0.333333,0.020061,0,0,0,0
898,,,xinsheng006,0,1,1,0,1,1,0,0,1,1,1,0
899,,,WalkerHoang,0,1,1,0,1,1,0,0,1,1,1,0
900,,,librarymeg57,1,1,2,1,1,2,0,0.006687,0,0,0,0
901,,,lesbianarcana,7,1,8,7,1,8,0.142857,0.06002,0,0,0,0
902,,,tsukimachi4033,0,2,2,0,2,2,0,0,1,1,1,0
903,,,ROSRAMON,1,12,13,1,12,13,0,0.00396,1,1,1,12
904,,,matsunaga_24,0,4,4,0,4,4,0,0,1,1,1,0
905,,,sehunxosoul,0,7,7,0,7,7,0,0,2,0.705882,0.791667,0
906,,,beckythecyclist,1,1,2,1,1,2,0,0.006687,0,0,0,0
907,,,bekobaekho,1,3,4,1,3,4,0.333333,0.006687,1,1,1,0
908,,,sbauerAP,1,1,2,1,1,2,0,0.006687,0,0,0,0
909,,,Ben_McRea,4,1,5,4,1,5,0.25,0.03493,0,0,0,0
910,,,tdankmyer,0,1,1,0,1,1,0,0,1,1,1,0
911,,,CalicoCalista,8,1,9,8,1,9,0.125,0.105911,0,0,0,0
912,,,kiviseviyorum,0,1,1,0,1,1,0,0,1,1,1,0
913,,,Byron_Wan,1,2,3,1,2,3,0.5,0.006687,1,1,1,0
914,,,istanmochijimin,4,7,11,4,7,11,0.1,0.026749,1,1,1,18
915,,,3idiotsrule,0,1,1,0,1,1,0,0,1,1,1,0
916,,,miminecco,0,1,1,0,1,1,0,0,1,1,1,0
917,,,GLew3366,0,1,1,0,1,1,0,0,1,1,1,0
918,,,rpamex,5,1,6,5,1,6,0.2,0.047413,0,0,0,0
919,,,fNFBZhIxeTycV7g,0,1,1,0,1,1,0,0,1,1,1,0
920,,,kathvyt,4,26,30,6,28,34,0.034483,0.026749,2,0.903226,0.946429,84
921,,,mengtur,0,1,1,0,1,1,0,0,1,1,1,0
922,,,jeewonkr,1,1,2,1,1,2,0,0.006687,0,0,0,0
923,,,SamosKiki,1,1,2,2,2,4,0,0.006687,0,0,0,0
924,,,nncat2008,3,1,4,3,1,4,0.333333,0.075969,0,0,0,0
925,,,bwaaap,0,2,2,0,2,2,0,0,1,1,1,0
926,,,athendoflight,1,1,2,1,1,2,0,0.006687,0,0,0,0
927,,,grab_the_gold,1,1,2,1,1,2,0,0.006687,0,0,0,0
928,,,lplage,10,1,11,14,5,19,0.1,0.080848,0,0,0,0
929,,,yannli3,0,1,1,0,1,1,0,0,1,1,1,0
930,,,LTjgBenJLadd,0,2,2,0,2,2,0,0,1,1,1,0
931,,,cengokucanon,0,1,1,0,1,1,0,0,1,1,1,0
932,,,greg_trimboli,0,1,1,0,1,1,0,0,1,1,1,0
933,,,Zinctastic,0,1,1,0,2,2,0,0,1,1,1,0
934,,,Christi71386739,0,1,1,0,1,1,0,0,1,1,1,0
935,,,ElonMUSS,0,1,1,0,1,1,0,0,1,1,1,0
936,,,SUEHIROQ,0,2,2,0,2,2,0,0,1,1,1,0
937,,,XujianingVV,0,1,1,0,1,1,0,0,1,1,1,0
938,,,Jessicaj2488,5,1,6,5,1,6,0.2,0.033436,0,0,0,0
939,,,helenwonglh,0,1,1,0,1,1,0,0,1,1,1,0
940,,,NowOfIce,0,1,1,0,1,1,0,0,1,1,1,0
941,,,YuuramNya,0,1,1,0,1,1,0,0,1,1,1,0
942,,,AvalynWu,0,1,1,0,1,1,0,0,1,1,1,0
943,,,sexxyred1,3,2,5,3,2,5,0.25,0.020061,1,1,1,2
944,,,SAlliJii,0,5,5,0,5,5,0,0,2,0.857143,0.916667,0
945,,,MiWHongKonger,0,1,1,0,1,1,0,0,2,0.666667,0.75,0
946,,,yfayewang,2,1,3,3,1,4,0.5,0.013374,0,0,0,0
947,,,ChitownJewrean,1,1,2,1,1,2,0,0.006687,0,0,0,0
948,,,oliviaicastor,6,1,7,6,1,7,0.166667,0.040123,0,0,0,0
949,,,nan2828,0,2,2,0,2,2,0,0,3,0.555556,0.666667,0
950,,,kamanridesbikes,0,1,1,0,1,1,0,0,1,1,1,0
951,,,CTLau3,0,1,1,0,1,1,0,0,1,1,1,0
952,,,hanamic02582113,0,1,1,0,1,1,0,0,1,1,1,0
953,,,deborahbush_nyc,0,1,1,0,1,1,0,0,1,1,1,0
954,,,chocowaiit,1,1,2,1,1,2,0,0.006687,0,0,0,0
955,,,mywhirlwindkid,2,2,4,2,2,4,0.333333,0.013374,1,1,1,1
956,,,G9El8JBKgPGKeXy,0,4,4,0,5,5,0,0,1,1,1,0
957,,,ExaMDZS,0,4,4,0,4,4,0,0,2,0.833333,0.9,0
958,,,oAueOnaaj6pgljY,0,2,2,0,3,3,0,0,1,1,1,0
959,,,jedboal,0,1,1,0,1,1,0,0,1,1,1,0
960,,,ganbugan4,0,1,1,0,1,1,0,0,1,1,1,0
961,,,yakyuai_matsui,0,1,1,0,1,1,0,0,1,1,1,0
962,,,SaulChing5,0,1,1,0,1,1,0,0,1,1,1,0
963,,,PedroGarfbizu,0,1,1,0,1,1,0,0,1,1,1,0
964,,,fo_ozhan,0,1,1,0,1,1,0,0,2,0.666667,0.75,0
965,,,Jim_GarnerCO,1,1,2,1,1,2,0,0.006687,0,0,0,0
966,,,GlennMcArdle2,1,1,2,1,1,2,0,0.006687,0,0,0,0
967,,,pvntr_h,2,1,3,2,1,3,0.5,0.013374,0,0,0,0
968,,,JazzfanDave,0,1,1,0,1,1,0,0,1,1,1,0
969,,,SLC2030,1,1,2,1,1,2,0,0.006687,0,0,0,0
970,,,rfbrownwards,7,1,8,9,2,11,0.142857,0.084991,0,0,0,0
971,,,NathanChenJP,14,2,16,14,3,17,0,0.055439,1,1,1,28
972,,,JadeLuckClub,0,3,3,0,4,4,0,0,1,1,1,0
973,,,ChongGuru,0,1,1,0,1,1,0,0,1,1,1,0
974,,,toshikon,0,6,6,0,6,6,0,0,1,1,1,0
975,,,OttoSuwenINFT,0,1,1,0,1,1,0,0,1,1,1,0
976,,,Mo3Sonia,0,1,1,0,1,1,0,0,1,1,1,0
977,,,LauraDiBella15,1,1,2,1,1,2,0,0.006687,0,0,0,0
978,,,KatFarrington,1,1,2,1,1,2,0,0.006687,0,0,0,0
979,,,APffranklin2,1,1,2,1,1,2,0,0.006687,0,0,0,0
980,,,gay_rhony,1,1,2,1,1,2,0,0.006687,0,0,0,0
981,,,RYNNIOS,2,1,3,3,2,5,0.5,0.013374,0,0,0,0
982,,,Vizion4Artz,0,1,1,0,1,1,0,0,1,1,1,0
983,,,nbyIino,1,1,2,1,1,2,0,0.006687,0,0,0,0
984,,,jepifish,1,1,2,1,1,2,0,0.006687,0,0,0,0
985,,,slavicgurlboss,6,2,8,7,3,10,0.142857,0.040123,1,1,1,5
986,,,yibianquer,0,1,1,0,1,1,0,0,2,0.666667,0.75,0
987,,,ArielVanessa7,0,1,1,0,1,1,0,0,2,0.666667,0.75,0
988,,,kowaruv,0,1,1,0,1,1,0,0,2,0.666667,0.75,0
989,,,amorahae,2,1,3,2,1,3,0.5,0.013374,0,0,0,0
990,,,Vrozuzu,0,2,2,0,2,2,0,0,1,1,1,0
991,,,romyilano,3,1,4,3,1,4,0.333333,0.020061,0,0,0,0
992,,,SciBoycottChina,0,1,1,0,1,1,0,0,1,1,1,0
993,,,Rin_Yunho_tvxq,0,1,1,0,1,1,0,0,1,1,1,0
994,,,jenenlu,1,1,2,1,1,2,0,0.006687,0,0,0,0
995,,,ElissaCPA,4,1,5,5,2,7,0.25,0.026749,0,0,0,0
996,,,chenslutzes,0,1,1,0,1,1,0,0,1,1,1,0
997,,,MissyCooper13,0,3,3,0,3,3,0,0,1,1,1,0
998,,,Okthankyou80,0,1,1,0,1,1,0,0,1,1,1,0
999,,,califor61515531,4,1,5,4,1,5,0.25,0.026749,0,0,0,0
1000,,,ducdigital,0,1,1,0,1,1,0,0,1,1,1,0
1001,,,pulpul_174,0,2,2,0,2,2,0,0,2,0.75,0.833333,0
1002,,,yandexokay,0,1,1,0,1,1,0,0,1,1,1,0
1003,,,Kalz1669,0,1,1,0,1,1,0,0,1,1,1,0
1004,,,PhilipRalph11,0,1,1,0,1,1,0,0,1,1,1,0
1005,,,katquarius,1,1,2,1,1,2,0,0.006687,0,0,0,0
1006,,,GtekCW,1,1,2,1,1,2,0,0.006687,0,0,0,0
1007,,,MariaBr44021683,1,1,2,1,1,2,0,0.006687,0,0,0,0
1008,,,MayersCapitalM1,3,1,4,3,1,4,0.333333,0.020061,0,0,0,0
1009,,,BlackEyedWei,0,2,2,0,2,2,0,0,1,1,1,0
1010,,,sonambsten,0,2,2,0,2,2,0,0,1,1,1,0
1011,,,cosmixyeri,0,1,1,0,1,1,0,0,1,1,1,0
1012,,,DanielRusk16,0,1,1,0,1,1,0,0,1,1,1,0
1013,,,Dawnloveslife1,0,1,1,0,1,1,0,0,1,1,1,0
1014,,,USFigureSkating,0,2,2,0,2,2,0,0,1,1,1,0
1015,,,blackscallop,3,2,5,4,3,7,0.25,0.020061,1,1,1,2
1016,,,tlreyes84,0,1,1,0,1,1,0,0,2,0.666667,0.75,0
1017,,,mermaidblackcat,3,4,7,5,6,11,0.166667,0.020061,1,1,1,6
1018,,,jadeschuso,1,1,2,1,1,2,0,0.006687,0,0,0,0
1019,,,Clairegirly,4,1,5,4,1,5,0.25,0.026749,0,0,0,0
1020,,,kohnosuke3,0,4,4,0,4,4,0,0,1,1,1,0
1021,,,Teakbr,0,1,1,0,1,1,0,0,1,1,1,0
1022,,,4ngrypepper,0,1,1,0,1,1,0,0,1,1,1,0
1023,,,MattJulianCI,1,1,2,1,1,2,0,0.006687,0,0,0,0
1024,,,GQSports,7,1,8,7,1,8,0.142857,0.04681,0,0,0,0
1025,,,funky450,0,2,2,0,2,2,0,0,1,1,1,0
1026,,,TiarePalau,0,1,1,0,1,1,0,0,1,1,1,0
1027,,,0x53746566616E,0,1,1,0,1,1,0,0,1,1,1,0
1028,,,fukushima99,0,1,1,0,1,1,0,0,1,1,1,0
1029,,,qA2ZioJcS4BuH5Y,0,1,1,0,1,1,0,0,1,1,1,0
1030,,,4f3t3lo,2,1,3,3,2,5,0.5,0.013374,0,0,0,0
1031,,,SUNSETJO0N,3,1,4,3,1,4,0.333333,0.020061,0,0,0,0
1032,,,AlarmChina,0,1,1,0,1,1,0,0,1,1,1,0
1033,,,LADYDAY93_TJFGG,0,2,2,0,2,2,0,0,1,1,1,0
1034,,,catherineursill,2,1,3,2,1,3,0.5,0.013374,0,0,0,0
1035,,,GymstaStories,0,4,4,0,4,4,0,0,1,1,1,0
1036,,,lwjoons,0,1,1,0,1,1,0,0,1,1,1,0
1037,,,SheenCon,0,1,1,0,1,1,0,0,1,1,1,0
1038,,,AnnaLog28694349,0,1,1,0,1,1,0,0,1,1,1,0
1039,,,RlNTAKYU,15,1,16,17,3,20,0.066667,0.100307,0,0,0,0
1040,,,gene_loh,0,3,3,0,3,3,0,0,1,1,1,0
1041,,,CamMaderWealth,3,1,4,3,1,4,0.333333,0.020061,0,0,0,0
1042,,,Emma80228316,0,2,2,0,2,2,0,0,1,1,1,0
1043,,,definetly_pedro,0,1,1,0,1,1,0,0,1,1,1,0
1044,,,djsriram98,2,1,3,2,1,3,0.5,0.013374,0,0,0,0
1045,,,nigatsusv,0,1,1,0,1,1,0,0,1,1,1,0
1046,,,KathrynHenzler,1,5,6,1,5,6,0.2,0.006687,1,1,1,0
1047,,,iwafltr,7,1,8,11,5,16,0.142857,0.04681,0,0,0,0
1048,,,manmacome,0,3,3,0,3,3,0,0,2,0.714286,0.8,0
1049,,,TheGreenManuela,3,7,10,3,7,10,0.111111,0.020061,3,0.647059,0.757576,22
1050,,,KenFeltman,1,1,2,1,1,2,0,0.006687,0,0,0,0
1051,,,blackwellsnoir,2,1,3,2,1,3,0.5,0.013374,0,0,0,0
1052,,,aiorganism,5,1,6,5,1,6,0.2,0.033436,0,0,0,0
1053,,,yulinka73007135,0,2,2,0,2,2,0,0,1,1,1,0
1054,,,geronim76006585,0,1,1,0,1,1,0,0,1,1,1,0
1055,,,BAIZUOPatrol,0,1,1,0,1,1,0,0,1,1,1,0
1056,,,ruhger,0,1,1,0,1,1,0,0,1,1,1,0
1057,,,Revcrin,1,1,2,1,1,2,0,0.006687,0,0,0,0
1058,,,DiChristine,0,13,13,0,14,14,0,0,2,0.882353,0.933333,0
1059,,,cinnamochan,0,2,2,0,2,2,0,0,1,1,1,0
1060,,,SarahBurris,1,1,2,1,1,2,0,0.006687,0,0,0,0
1061,,,lukas_34w,0,1,1,0,1,1,0,0,1,1,1,0
1062,,,yoo__kai,0,1,1,0,1,1,0,0,1,1,1,0
1063,,,anncovey,0,1,1,0,1,1,0,0,1,1,1,0
1064,,,LauraNoonan16,0,3,3,0,3,3,0,0,1,1,1,0
1065,,,kingcrimson138,0,1,1,0,1,1,0,0,1,1,1,0
1066,,,ramonwilliamson,2,1,3,3,2,5,0.5,0.013374,0,0,0,0
1067,,,kory_a_hero,0,1,1,0,1,1,0,0,1,1,1,0
1068,,,Kaygirl8Lawana,1,2,3,1,2,3,0.5,0.006687,1,1,1,0
1069,,,kuyashiineko,4,4,8,6,6,12,0.142857,0.026749,1,1,1,9
1070,,,NCHavelock,3,1,4,3,1,4,0.333333,0.020061,0,0,0,0
1071,,,ChuanLiLim,0,2,2,0,2,2,0,0,1,1,1,0
1072,,,hagieverse,0,4,4,0,4,4,0,0,1,1,1,0
1073,,,YU428YU,0,1,1,0,1,1,0,0,1,1,1,0
1074,,,EricaCooper,3,1,4,3,1,4,0.333333,0.020061,0,0,0,0
1075,,,Amara_deMachado,0,1,1,0,1,1,0,0,1,1,1,0
1076,,,PatriotRaywood,0,1,1,0,1,1,0,0,1,1,1,0
1077,,,wizardgry,0,1,1,0,1,1,0,0,1,1,1,0
1078,,,MYAFGnews,1,1,2,1,1,2,0,0.006687,0,0,0,0
1079,,,bipocoutside,1,1,2,1,1,2,0,0.006687,0,0,0,0
1080,,,thestranger515,1,1,2,1,1,2,0,0.006687,0,0,0,0
1081,,,American3141592,1,2,3,1,2,3,0.5,0.006687,1,1,1,0
1082,,,AraDeGrays,0,1,1,0,1,1,0,0,1,1,1,0
1083,,,zy19x,0,1,1,0,1,1,0,0,1,1,1,0
1084,,,DontBeEvilMan,2,1,3,2,1,3,0.5,0.013374,0,0,0,0
1085,,,WTPONZ,0,1,1,0,1,1,0,0,1,1,1,0
1086,,,nahanchun,0,10,10,0,10,10,0,0,1,1,1,0
1087,,,trizzlmynizzl,0,1,1,0,1,1,0,0,1,1,1,0
1088,,,SkeeterWysocki,1,1,2,1,1,2,0,0.006687,0,0,0,0
1089,,,kituays,0,1,1,0,1,1,0,0,1,1,1,0
1090,,,awrin_5,0,1,1,0,1,1,0,0,1,1,1,0
1091,,,Melvin_Donovan,0,1,1,0,1,1,0,0,1,1,1,0
1092,,,aeckevin,0,1,1,0,1,1,0,0,1,1,1,0
1093,,,GZWatcher2020,0,1,1,0,1,1,0,0,1,1,1,0
1094,,,signshroom,3,1,4,4,2,6,0.333333,0.020061,0,0,0,0
1095,,,ksjcafeee,2,1,3,2,1,3,0.5,0.013374,0,0,0,0
1096,,,TonyZ22793763,0,1,1,0,1,1,0,0,1,1,1,0
1097,,,_wabzino,1,1,2,1,1,2,0,0.006687,0,0,0,0
1098,,,Pl4inNinj4,1,1,2,1,1,2,0,0.006687,0,0,0,0
1099,,,RESatt999,2,1,3,2,1,3,0.5,0.013374,0,0,0,0
1100,,,SarahHBana,0,1,1,0,1,1,0,0,1,1,1,0
1101,,,_Joy_R,1,1,2,1,1,2,0,0.006687,0,0,0,0
1102,,,cinnaminmin,1,1,2,1,1,2,0,0.006687,0,0,0,0
1103,,,MundiFinancial,3,1,4,3,1,4,0.333333,0.020061,0,0,0,0
1104,,,Pop_Wasabi,0,1,1,0,1,1,0,0,1,1,1,0
1105,,,zzukei,0,2,2,0,2,2,0,0,1,1,1,0
1106,,,pjomono,2,1,3,2,1,3,0.5,0.069282,0,0,0,0
1107,,,agentofslayos,2,1,3,2,1,3,0.5,0.013374,0,0,0,0
1108,,,sagascius,0,1,1,0,1,1,0,0,1,1,1,0
1109,,,rogueali,2,1,3,2,1,3,0.5,0.013374,0,0,0,0
1110,,,ShortTrackfan8,0,1,1,0,1,1,0,0,1,1,1,0
1111,,,smasunaga,12,4,16,16,8,24,0.066667,0.08374,1,1,1,33
1112,,,diegojorhey,0,1,1,0,1,1,0,0,2,0.571429,0.625,0
1113,,,lon_jeremy,3,1,4,3,1,4,0.333333,0.020061,0,0,0,0
1114,,,dmoc06,0,2,2,0,2,2,0,0,1,1,1,0
1115,,,confusedcastieI,0,1,1,0,1,1,0,0,1,1,1,0
1116,,,Ace_has_Greed,2,1,3,2,1,3,0.5,0.013374,0,0,0,0
1117,,,NotAnAn0n,0,2,2,0,2,2,0,0,3,0.4375,0.547619,0
1118,,,Maytechummia,9,1,10,11,3,14,0.111111,0.063679,0,0,0,0
1119,,,Marcin_34m,0,1,1,0,1,1,0,0,1,1,1,0
1120,,,flowmogogo,0,2,2,0,2,2,0,0,1,1,1,0
1121,,,minobangerz,1,1,2,1,1,2,0,0.006687,0,0,0,0
1122,,,theMESHtv,4,1,5,4,1,5,0.25,0.04422,0,0,0,0
1123,,,ZedStudio3,1,2,3,1,2,3,0.5,0.006687,1,1,1,0
1124,,,Keli0596,0,1,1,0,1,1,0,0,1,1,1,0
1125,,,notadingdong,1,1,2,1,1,2,0,0.006687,0,0,0,0
1126,,,juIietecai,2,1,3,2,1,3,0.5,0.013374,0,0,0,0
1127,,,macnfreeze,0,1,1,0,1,1,0,0,1,1,1,0
1128,,,americanguy40,2,1,3,2,1,3,0.5,0.013374,0,0,0,0
1129,,,orangesucculent,0,1,1,0,1,1,0,0,1,1,1,0
1130,,,MissPwachi,0,2,2,0,2,2,0,0,1,1,1,0
1131,,,AxleLeu8,0,2,2,0,2,2,0,0,1,1,1,0
1132,,,cloudspin11,10,1,11,12,1,13,0.1,0.066871,0,0,0,0
1133,,,23Mjoshi,0,1,1,0,1,1,0,0,1,1,1,0
1134,,,kthomee,0,2,2,0,3,3,0,0,1,1,1,0
1135,,,snackvampire,0,1,1,0,1,1,0,0,1,1,1,0
1136,,,UhcWage,0,1,1,0,1,1,0,0,1,1,1,0
1137,,,crimesoverheart,0,1,1,0,1,1,0,0,1,1,1,0
1138,,,tamdeedd,0,1,1,0,2,2,0,0,1,1,1,0
1139,,,BryanABlake_,0,2,2,0,2,2,0,0,2,0.75,0.833333,0
1140,,,JimmyKeating11,4,1,5,5,2,7,0.25,0.026749,0,0,0,0
1141,,,BurrisSuarez,0,3,3,0,3,3,0,0,2,0.8,0.875,0
1142,,,whitemanswhh0re,0,1,1,0,1,1,0,0,1,1,1,0
1143,,,Mrs__Mirror,8,1,9,12,5,17,0.125,0.053497,0,0,0,0
1144,,,riplutz,0,2,2,0,2,2,0,0,1,1,1,0
1145,,,LopunnyNatasha,5,1,6,5,1,6,0.2,0.033436,0,0,0,0
1146,,,KuroBoyX0,0,2,2,0,2,2,0,0,1,1,1,0
1147,,,pfw2001_h,0,1,1,0,1,1,0,0,1,1,1,0
1148,,,eazeee2004,0,4,4,0,4,4,0,0,2,0.642857,0.722222,0
1149,,,RajabAlmukarrom,0,1,1,0,1,1,0,0,1,1,1,0
1150,,,kpoppie_anonnie,1,1,2,1,1,2,0,0.006687,0,0,0,0
1151,,,DPaulec,1,1,2,1,1,2,0,0.006687,0,0,0,0
1152,,,artysafe,1,1,2,1,1,2,0,0.006687,0,0,0,0
1153,,,deelee60111413,3,1,4,3,1,4,0.333333,0.020061,0,0,0,0
1154,,,AustinLouis5,0,4,4,0,4,4,0,0,1,1,1,0
1155,,,traumen351,0,1,1,0,1,1,0,0,1,1,1,0
1156,,,pat_marzola,1,1,2,1,1,2,0,0.006687,0,0,0,0
1157,,,yuzu_news1,2,1,3,2,1,3,0.5,0.013374,0,0,0,0
1158,,,Remember1421,0,1,1,0,1,1,0,0,1,1,1,0
1159,,,EmrgncyContact,4,1,5,4,1,5,0.25,0.052112,0,0,0,0
1160,,,BobKahler2,7,2,9,9,2,11,0.125,0.050304,1,1,1,6
1161,,,coco_ice0505,0,2,2,0,2,2,0,0,1,1,1,0
1162,,,TKaiere,0,3,3,0,3,3,0,0,1,1,1,0
1163,,,DIORKOOKZ,3,1,4,3,1,4,0.333333,0.020061,0,0,0,0
1164,,,LoneWMcCord1,0,1,1,0,1,1,0,0,1,1,1,0
1165,,,TheJerryPi,0,1,1,0,1,1,0,0,1,1,1,0
1166,,,thePumamama,1,1,2,1,1,2,0,0.006687,0,0,0,0
1167,,,NthemakeupAISLE,2,1,3,2,1,3,0.5,0.013374,0,0,0,0
1168,,,JellyJelloBbear,0,3,3,0,3,3,0,0,1,1,1,0
1169,,,LtsFlwr70,1,1,2,2,2,4,0,0.006687,0,0,0,0
1170,,,ChessKidcom,2,1,3,2,1,3,0.5,0.013374,0,0,0,0
1171,,,claymore2of9,0,3,3,0,3,3,0,0,3,0.625,0.766667,0
1172,,,yixuzi,5,1,6,5,1,6,0.2,0.033436,0,0,0,0
1173,,,TheInfo41603739,0,1,1,0,1,1,0,0,1,1,1,0
1174,,,americand0lphin,0,1,1,0,1,1,0,0,1,1,1,0
1175,,,moron05274469,0,1,1,0,1,1,0,0,1,1,1,0
1176,,,crazysanta09,0,1,1,0,1,1,0,0,1,1,1,0
1177,,,Parlino1946,1,1,2,1,1,2,0,0.006687,0,0,0,0
1178,,,HilluAbblader,2,1,3,2,1,3,0.5,0.013374,0,0,0,0
1179,,,IPurpleBTS0613,0,2,2,0,2,2,0,0,1,1,1,0
1180,,,KatyS45,2,1,3,2,1,3,0.5,0.013374,0,0,0,0
1181,,,tsr_balto,0,1,1,0,1,1,0,0,1,1,1,0
1182,,,butteryoonjin,4,1,5,4,1,5,0.25,0.026749,0,0,0,0
1183,,,elizabeth_ann5_,0,1,1,0,1,1,0,0,1,1,1,0
1184,,,kumaichi523,0,1,1,0,1,1,0,0,1,1,1,0
1185,,,fyreskroll,0,2,2,0,2,2,0,0,1,1,1,0
1186,,,DaveMoore20,1,1,2,1,1,2,0,0.006687,0,0,0,0
1187,,,Shouko_Maecchi,5,1,6,5,1,6,0.2,0.033436,0,0,0,0
1188,,,djsmallchange,0,1,1,0,1,1,0,0,1,1,1,0
1189,,,nMwBNu7PhgnvifE,0,2,2,0,2,2,0,0,1,1,1,0
1190,,,LiaWolff,0,1,1,0,1,1,0,0,1,1,1,0
1191,,,AlyannaJanelJoy,0,1,1,0,1,1,0,0,1,1,1,0
1192,,,CLN46217,2,1,3,2,1,3,0.5,0.044822,0,0,0,0
1193,,,BarstoolGlobal,9,2,11,10,3,13,0.1,0.060184,1,1,1,8
1194,,,silverbow53,2,1,3,2,1,3,0.5,0.013374,0,0,0,0
1195,,,Futuris13933597,0,1,1,0,1,1,0,0,1,1,1,0
1196,,,JAGSING52621982,1,1,2,1,1,2,0,0.006687,0,0,0,0
1197,,,georgewillmdole,5,1,6,6,1,7,0.2,0.033436,0,0,0,0
1198,,,TAsteve2013,0,2,2,0,2,2,0,0,2,0.75,0.833333,0
1199,,,FfeFfef1102,0,1,1,0,1,1,0,0,1,1,1,0
1200,,,MJW_DC,0,1,1,0,2,2,0,0,1,1,1,0
1201,,,melonbirbb,6,2,8,7,3,10,0.142857,0.050606,1,1,1,7
1202,,,EvaSiu21,0,1,1,0,1,1,0,0,2,0.666667,0.75,0
1203,,,tiantian_s,0,1,1,0,1,1,0,0,2,0.666667,0.75,0
1204,,,_ptcm_,0,1,1,0,1,1,0,0,2,0.666667,0.75,0
1205,,,Tommy8668,0,1,1,0,1,1,0,0,2,0.666667,0.75,0
1206,,,mzw007,3,1,4,4,2,6,0.333333,0.028243,0,0,0,0
1207,,,l_multiverse,0,5,5,0,5,5,0,0,1,1,1,0
1208,,,n0t_PLo,6,1,7,7,2,9,0.166667,0.040123,0,0,0,0
1209,,,BarronIncognito,0,1,1,0,1,1,0,0,1,1,1,0
1210,,,mayo4u,0,1,1,0,1,1,0,0,1,1,1,0
1211,,,nichibei,2,1,3,2,1,3,0.5,0.013374,0,0,0,0
1212,,,Awkwardlyautis1,0,1,1,0,1,1,0,0,1,1,1,0
1213,,,BostonAAFilm,5,1,6,7,3,10,0.2,0.033436,0,0,0,0
1214,,,sanyonarahitori,1,1,2,1,1,2,0,0.006687,0,0,0,0
1215,,,ScottSk8Academy,1,1,2,1,1,2,0,0.006687,0,0,0,0
1216,,,FordIceCenter,1,1,2,1,1,2,0,0.006687,0,0,0,0
1217,,,harveyheyy,3,1,4,3,1,4,0.333333,0.020061,0,0,0,0
1218,,,Nooelia10,0,1,1,0,1,1,0,0,1,1,1,0
1219,,,siu_head,0,1,1,0,1,1,0,0,1,1,1,0
1220,,,mareepy,0,2,2,0,2,2,0,0,1,1,1,0
1221,,,ClintonCallie,0,1,1,0,1,1,0,0,1,1,1,0
1222,,,SamHarp65562239,0,1,1,0,1,1,0,0,1,1,1,0
1223,,,erinnmariee__,0,1,1,0,1,1,0,0,1,1,1,0
1224,,,figureetc,0,1,1,0,1,1,0,0,1,1,1,0
1225,,,zhaokeke4,0,1,1,0,1,1,0,0,1,1,1,0
1226,,,kyuu,4,1,5,4,1,5,0.25,0.026749,0,0,0,0
1227,,,yuzurufan7777,0,9,9,0,12,12,0,0,2,0.909091,0.95,0
1228,,,moonkinellsey,0,1,1,0,1,1,0,0,1,1,1,0
1229,,,gblkh2,0,1,1,0,1,1,0,0,1,1,1,0
1230,,,pastorabharris,3,1,4,3,1,4,0.333333,0.020061,0,0,0,0
1231,,,kittycatnoir123,0,1,1,0,1,1,0,0,1,1,1,0
1232,,,audreyandray,0,1,1,0,1,1,0,0,1,1,1,0
1233,,,SchwartzInsGrp,1,1,2,1,1,2,0,0.006687,0,0,0,0
1234,,,IamStephenHuang,5,1,6,5,1,6,0.2,0.033436,0,0,0,0
1235,,,Betelo1,0,1,1,0,1,1,0,0,1,1,1,0
1236,,,Fatfish0721,0,1,1,0,1,1,0,0,1,1,1,0
1237,,,RochonRodney,0,1,1,0,1,1,0,0,1,1,1,0
1238,,,chocochipmunki1,0,1,1,0,1,1,0,0,1,1,1,0
1239,,,lex_shmitty,2,1,3,2,1,3,0.5,0.013374,0,0,0,0
1240,,,OceaniaCCP,0,1,1,0,1,1,0,0,1,1,1,0
1241,,,Fujikiayato,0,1,1,0,1,1,0,0,1,1,1,0
1242,,,onion84466644,0,1,1,0,1,1,0,0,1,1,1,0
1243,,,no_good_wyfe,1,1,2,1,1,2,0,0.006687,0,0,0,0
1244,,,CuprisinCarey,4,1,5,5,2,7,0.25,0.035544,0,0,0,0
1245,,,_collocated_,0,1,1,0,1,1,0,0,1,1,1,0
1246,,,ameliapsr,4,1,5,4,1,5,0.25,0.026749,0,0,0,0
1247,,,misterciruelo,0,1,1,0,1,1,0,0,1,1,1,0
1248,,,antiwumao444,0,1,1,0,1,1,0,0,1,1,1,0
1249,,,orwellnow2047,0,1,1,0,1,1,0,0,1,1,1,0
1250,,,curlybo2,0,2,2,0,2,2,0,0,1,1,1,0
1251,,,Mark3Ds,0,1,1,0,1,1,0,0,1,1,1,0
1252,,,bIuemign,1,1,2,1,1,2,0,0.006687,0,0,0,0
1253,,,SinceMnday,1,1,2,1,1,2,0,0.006687,0,0,0,0
1254,,,lillithmind,5,1,6,5,1,6,0.2,0.033436,0,0,0,0
1255,,,ICukavin,0,1,1,0,1,1,0,0,1,1,1,0
1256,,,sssaffle,0,3,3,0,3,3,0,0,1,1,1,0
1257,,,tuser5555,0,1,1,0,1,1,0,0,1,1,1,0
1258,,,TheDramaClubs1,3,1,4,3,1,4,0.333333,0.020061,0,0,0,0
1259,,,GreatOverlordX,0,1,1,0,1,1,0,0,1,1,1,0
1260,,,Marco_Malavasi,0,1,1,0,1,1,0,0,1,1,1,0
1261,,,CongSanMatDay,1,1,2,1,1,2,0,0.006687,0,0,0,0
1262,,,AgathaSpode,1,1,2,1,1,2,0,0.006687,0,0,0,0
1263,,,xuhughli9,5,1,6,5,1,6,0.2,0.033436,0,0,0,0
1264,,,hirakata,0,1,1,0,1,1,0,0,1,1,1,0
1265,,,fish168,0,1,1,0,1,1,0,0,1,1,1,0
1266,,,WTPOHK,0,1,1,0,1,1,0,0,1,1,1,0
1267,,,JimHLee,0,1,1,0,1,1,0,0,1,1,1,0
1268,,,rickyknives,2,1,3,3,2,5,0.5,0.013374,0,0,0,0
1269,,,magic_kankshell,1,1,2,1,1,2,0,0.006687,0,0,0,0
1270,,,1310_KFKA,2,1,3,2,1,3,0.5,0.013374,0,0,0,0
1271,,,ao64181092,0,1,1,0,1,1,0,0,1,1,1,0
1272,,,AviellaLloyd,3,1,4,3,1,4,0.333333,0.020061,0,0,0,0
1273,,,qiangthesuper,0,1,1,0,1,1,0,0,1,1,1,0
1274,,,_moraida,0,1,1,0,1,1,0,0,1,1,1,0
1275,,,CarlosD47996453,3,1,4,4,2,6,0.333333,0.020061,0,0,0,0
1276,,,sarahconnor0,12,1,13,12,1,13,0.083333,0.087234,0,0,0,0
1277,,,lucernaria_,0,1,1,0,1,1,0,0,1,1,1,0
1278,,,pillowfrost,0,1,1,0,1,1,0,0,1,1,1,0
1279,,,scratchspins,0,1,1,0,1,1,0,0,1,1,1,0
1280,,,iguana012,0,1,1,0,1,1,0,0,1,1,1,0
1281,,,FYH2021,0,1,1,0,1,1,0,0,1,1,1,0
1282,,,ShellSheddy,0,1,1,0,1,1,0,0,1,1,1,0
1283,,,Tiantangdixia,0,1,1,0,1,1,0,0,1,1,1,0
1284,,,princesshreya97,0,9,9,0,9,9,0,0,1,1,1,0
1285,,,lmigaki,1,1,2,1,1,2,0,0.006687,0,0,0,0
1286,,,Ramzscz,3,1,4,3,1,4,0.333333,0.020061,0,0,0,0
1287,,,fcmaca,0,1,1,0,1,1,0,0,1,1,1,0
1288,,,UnitedSpaceCats,0,1,1,0,1,1,0,0,1,1,1,0
1289,,,LindaWilliamsMD,1,1,2,1,1,2,0,0.006687,0,0,0,0
1290,,,Ladyjdt95,0,10,10,0,10,10,0,0,1,1,1,0
1291,,,deepmpolar,0,1,1,0,1,1,0,0,1,1,1,0
1292,,,bigbuddha50,2,1,3,2,1,3,0.5,0.013374,0,0,0,0
1293,,,moriao_hunter,0,1,1,0,1,1,0,0,1,1,1,0
1294,,,vickiep1969,6,1,7,6,1,7,0.166667,0.050606,0,0,0,0
1295,,,Micinski5,3,2,5,4,2,6,0.25,0.020061,1,1,1,2
1296,,,USEmbassyBaku,0,1,1,0,1,1,0,0,1,1,1,0
1297,,,werewolfkevinli,0,2,2,0,2,2,0,0,1,1,1,0
1298,,,marco_maiocchi,0,1,1,0,1,1,0,0,1,1,1,0
1299,,,mandalf3000,4,1,5,4,1,5,0.25,0.026749,0,0,0,0
1300,,,RyanM_79,0,1,1,0,1,1,0,0,1,1,1,0
1301,,,SelfishCitizen,0,1,1,0,1,1,0,0,1,1,1,0
1302,,,szritz,3,1,4,3,1,4,0.333333,0.020061,0,0,0,0
1303,,,mffeetza,0,1,1,0,1,1,0,0,1,1,1,0
1304,,,Jeongins_Guns,1,1,2,1,1,2,0,0.006687,0,0,0,0
1305,,,AuroraAsian,3,1,4,3,1,4,0.333333,0.020061,0,0,0,0
1306,,,k8stover,0,1,1,0,1,1,0,0,1,1,1,0
1307,,,morbid_elation,0,1,1,0,1,1,0,0,1,1,1,0
1308,,,letsthinkdeeply,0,2,2,0,2,2,0,0,1,1,1,0
1309,,,skitzypout,3,1,4,4,2,6,0.333333,0.020061,0,0,0,0
1310,,,imjinnie,0,1,1,0,1,1,0,0,1,1,1,0
1311,,,KagaMayu,0,1,1,0,1,1,0,0,1,1,1,0
1312,,,SocialWkAdvo62,3,1,4,3,1,4,0.333333,0.020061,0,0,0,0
1313,,,shiroitako,0,1,1,0,1,1,0,0,1,1,1,0
1314,,,fleme95,0,3,3,0,3,3,0,0,1,1,1,0
1315,,,mindcaviar,4,1,5,4,1,5,0.25,0.026749,0,0,0,0
1316,,,PLifeBeyondYt,0,1,1,0,1,1,0,0,1,1,1,0
1317,,,MLAS,0,2,2,0,2,2,0,0,1,1,1,0
1318,,,wilson6923,0,1,1,0,1,1,0,0,1,1,1,0
1319,,,BigglesworthX,1,1,2,1,1,2,0,0.006687,0,0,0,0
1320,,,US_China_Menu,7,1,8,8,2,10,0.142857,0.04681,0,0,0,0
1321,,,DarrinGarcia34,0,1,1,0,1,1,0,0,1,1,1,0
1322,,,streamparting,2,1,3,2,1,3,0.5,0.016869,0,0,0,0
1323,,,pkab2000,1,2,3,1,2,3,0.5,0.006687,1,1,1,0
1324,,,KTSavage,3,1,4,3,1,4,0.333333,0.020061,0,0,0,0
1325,,,subgirlCD,0,1,1,0,1,1,0,0,1,1,1,0
1326,,,Shebnem77,0,2,2,0,2,2,0,0,1,1,1,0
1327,,,W0NPLUSWEN,1,1,2,1,1,2,0,0.006687,0,0,0,0
1328,,,MindyPack,1,1,2,1,1,2,0,0.006687,0,0,0,0
1329,,,ponypower1851,1,1,2,1,1,2,0,0.006687,0,0,0,0
1330,,,chellethebirb,1,1,2,1,1,2,0,0.006687,0,0,0,0
1331,,,NAVARRE__,2,1,3,2,1,3,0.5,0.013374,0,0,0,0
1332,,,HeatherFidler2,0,1,1,0,1,1,0,0,1,1,1,0
1333,,,tjwldls2,2,1,3,3,2,5,0.5,0.013374,0,0,0,0
1334,,,_allysonchiu,0,1,1,0,1,1,0,0,1,1,1,0
1335,,,ThreePatchCocoa,1,1,2,1,1,2,0,0.006687,0,0,0,0
1336,,,yibologia,6,1,7,6,1,7,0.166667,0.040123,0,0,0,0
1337,,,newsbysamuels,0,1,1,0,1,1,0,0,1,1,1,0
1338,,,KylyFlyly,3,1,4,3,1,4,0.333333,0.020061,0,0,0,0
1339,,,3dancelover,0,1,1,0,1,1,0,0,1,1,1,0
1340,,,geetsthegrape,0,1,1,0,1,1,0,0,1,1,1,0
1341,,,tourmaline_tree,2,1,3,2,1,3,0.5,0.013374,0,0,0,0
1342,,,DeanieHDunne,0,1,1,0,1,1,0,0,1,1,1,0
1343,,,HMgawry,3,1,4,3,1,4,0.333333,0.020061,0,0,0,0
1344,,,FloraHL6,0,3,3,0,3,3,0,0,1,1,1,0
1345,,,TibetPeople,0,1,1,0,1,1,0,0,1,1,1,0
1346,,,ChasingCrumbs,1,2,3,1,2,3,0.5,0.006687,1,1,1,0
1347,,,EmGusk,0,1,1,0,1,1,0,0,1,1,1,0
1348,,,rachelbianca,0,1,1,0,1,1,0,0,1,1,1,0
1349,,,aboutus,1,1,2,1,1,2,0,0.006687,0,0,0,0
1350,,,alex17ang,1,1,2,1,1,2,0,0.006687,0,0,0,0
1351,,,offonjk,2,1,3,2,1,3,0.5,0.016869,0,0,0,0
1352,,,MamatjanJuma,1,2,3,1,2,3,0.5,0.006687,1,1,1,0
1353,,,rennatts,11,1,12,11,1,12,0.090909,0.073559,0,0,0,0
1354,,,yhkonic,0,1,1,0,1,1,0,0,1,1,1,0
1355,,,triplefucxel,0,1,1,0,1,1,0,0,1,1,1,0
1356,,,akaoni123456,0,1,1,0,1,1,0,0,1,1,1,0
1357,,,Ash40412,0,1,1,0,1,1,0,0,1,1,1,0
1358,,,mainstay01,0,1,1,0,1,1,0,0,1,1,1,0
1359,,,NUrTgVHuLIuLYkD,0,1,1,0,1,1,0,0,1,1,1,0
1360,,,deviImunch,0,1,1,0,1,1,0,0,1,1,1,0
1361,,,joymomomo,0,1,1,0,1,1,0,0,1,1,1,0
1362,,,koume_kikuchiyo,0,1,1,0,1,1,0,0,1,1,1,0
1363,,,Orsa20191,0,1,1,0,1,1,0,0,1,1,1,0
1364,,,palatinelibrary,2,1,3,2,1,3,0.5,0.013374,0,0,0,0
1365,,,noona_pot,0,2,2,0,2,2,0,0,1,1,1,0
1366,,,slitheringnessa,0,1,1,0,1,1,0,0,1,1,1,0
1367,,,TheJetLim,0,1,1,0,1,1,0,0,1,1,1,0
1368,,,seikei0111,0,1,1,0,1,1,0,0,1,1,1,0
1369,,,deiustitiaadrem,0,1,1,0,1,1,0,0,1,1,1,0
1370,,,LaurenEMorrill,9,1,10,10,2,12,0.111111,0.221941,0,0,0,0
1371,,,shogun_uk,0,1,1,0,1,1,0,0,1,1,1,0
1372,,,4a3lo,0,3,3,0,3,3,0,0,1,1,1,0
1373,,,superzuzu,0,2,2,0,2,2,0,0,1,1,1,0
1374,,,Hxnyxpxxh,0,2,2,0,2,2,0,0,1,1,1,0
1375,,,FedUpLys,10,2,12,11,3,14,0.090909,0.07386,1,1,1,10
1376,,,schopelistic,1,1,2,1,1,2,0,0.006687,0,0,0,0
1377,,,atiyanaaa,5,1,6,5,1,6,0.2,0.033436,0,0,0,0
1378,,,marvolochaw,0,1,1,0,1,1,0,0,1,1,1,0
1379,,,Jackson66965241,0,1,1,0,1,1,0,0,1,1,1,0
1380,,,unnamedgirls,0,1,1,0,1,1,0,0,1,1,1,0
1381,,,ia_hy1207,0,1,1,0,1,1,0,0,1,1,1,0
1382,,,AlanVirl,1,1,2,1,1,2,0,0.006687,0,0,0,0
1383,,,AndrewAdamsKSL,0,1,1,0,1,1,0,0,1,1,1,0
1384,,,soymilk_mg,0,1,1,0,1,1,0,0,1,1,1,0
1385,,,8472Hearts,0,1,1,0,1,1,0,0,1,1,1,0
1386,,,KawaiiDaUnicorn,0,2,2,0,2,2,0,0,1,1,1,0
1387,,,andrea21648,0,1,1,0,1,1,0,0,1,1,1,0
1388,,,cali_pygian,2,4,6,2,4,6,0.2,0.013374,1,1,1,3
1389,,,0zeyXQKOM39PKeS,1,1,2,1,1,2,0,0.006687,0,0,0,0
1390,,,isachaengz,3,1,4,3,1,4,0.333333,0.020061,0,0,0,0
1391,,,fiancetank_YV,0,1,1,0,1,1,0,0,1,1,1,0
1392,,,aj110596,0,2,2,0,2,2,0,0,1,1,1,0
1393,,,GiveANote,1,1,2,1,1,2,0,0.006687,0,0,0,0
1394,,,SatbirDhillon22,4,1,5,4,1,5,0.25,0.026749,0,0,0,0
1395,,,LadyLakeMusic,0,1,1,0,1,1,0,0,1,1,1,0
1396,,,bjppx77,0,1,1,0,1,1,0,0,1,1,1,0
1397,,,Tweedia_0907,0,1,1,0,1,1,0,0,1,1,1,0
1398,,,jerrydoby_,0,1,1,0,1,1,0,0,1,1,1,0
1399,,,Himino_0711,0,1,1,0,1,1,0,0,1,1,1,0
1400,,,artsicheng,15,1,16,15,1,16,0.066667,0.130555,0,0,0,0
1401,,,SHIVAKU81476139,0,2,2,0,2,2,0,0,1,1,1,0
1402,,,Asuma_Tan,0,1,1,0,1,1,0,0,1,1,1,0
1403,,,parco3,0,2,2,0,2,2,0,0,1,1,1,0
1404,,,KSL5TV,7,3,10,8,4,12,0.111111,0.071817,2,0.625,0.7,90
1405,,,laikatv,0,1,1,0,1,1,0,0,1,1,1,0
1406,,,Pomu2_Hu,0,1,1,0,1,1,0,0,1,1,1,0
1407,,,ToddHar86581833,0,1,1,0,1,1,0,0,1,1,1,0
1408,,,MasuoRay,0,1,1,0,1,1,0,0,1,1,1,0
1409,,,setosetoda,0,1,1,0,1,1,0,0,1,1,1,0
1410,,,Chilhon2016Lap,0,1,1,0,1,1,0,0,1,1,1,0
1411,,,namzrs,0,1,1,0,1,1,0,0,1,1,1,0
1412,,,newscenterPHL1,0,2,2,0,2,2,0,0,2,0.75,0.833333,0
1413,,,muzzza9,0,1,1,0,1,1,0,0,1,1,1,0
1414,,,nythaikus,2,1,3,2,1,3,0.5,0.013374,0,0,0,0
1415,,,felixkissesboyz,1,1,2,1,1,2,0,0.006687,0,0,0,0
1416,,,jamesesquire6,0,1,1,0,1,1,0,0,1,1,1,0
1417,,,cristallum_arca,0,2,2,0,3,3,0,0,1,1,1,0
1418,,,RickiePhoto,0,1,1,0,1,1,0,0,1,1,1,0
1419,,,xdefning,3,2,5,3,2,5,0.25,0.020061,1,1,1,2
1420,,,AnitaNelam,0,1,1,0,1,1,0,0,2,0.666667,0.75,0
1421,,,rikka,0,1,1,0,1,1,0,0,1,1,1,0
1422,,,hobo862220,0,1,1,0,1,1,0,0,1,1,1,0
1423,,,avokabik,6,1,7,6,1,7,0.166667,0.050998,0,0,0,0
1424,,,KBULL93,0,1,1,0,1,1,0,0,1,1,1,0
1425,,,JohnLew45258123,0,1,1,0,1,1,0,0,1,1,1,0
1426,,,Rain2And,0,2,2,0,2,2,0,0,1,1,1,0
1427,,,a_m_r001,0,1,1,0,1,1,0,0,1,1,1,0
1428,,,CaglePost,7,1,8,8,2,10,0.142857,0.085246,0,0,0,0
1429,,,manaldinho1111,0,1,1,0,1,1,0,0,1,1,1,0
1430,,,katiebradley102,0,1,1,0,1,1,0,0,1,1,1,0
1431,,,starshine_3,1,2,3,1,2,3,0.5,0.006687,1,1,1,0
1432,,,Gzebra5,2,1,3,2,1,3,0.5,0.013374,0,0,0,0
1433,,,YhiromiY,0,1,1,0,1,1,0,0,1,1,1,0
1434,,,Dandeliondirtrd,0,2,2,0,2,2,0,0,1,1,1,0
1435,,,charuman,6,1,7,6,1,7,0.166667,0.040123,0,0,0,0
1436,,,itweetiexist,0,1,1,0,1,1,0,0,1,1,1,0
1437,,,305vies,0,1,1,0,1,1,0,0,1,1,1,0
1438,,,ForeverVenera,0,1,1,0,1,1,0,0,1,1,1,0
1439,,,Vanessacharters,0,1,1,0,1,1,0,0,1,1,1,0
1440,,,lisamariepane,3,1,4,3,1,4,0.333333,0.020061,0,0,0,0
1441,,,gailstout,0,2,2,0,2,2,0,0,2,0.75,0.833333,0
1442,,,IchiShk01,0,1,1,0,1,1,0,0,1,1,1,0
1443,,,kmhall,3,1,4,3,1,4,0.333333,0.020061,0,0,0,0
1444,,,Tomo75933448,0,2,2,0,2,2,0,0,1,1,1,0
1445,,,lunavayaluna,0,1,1,0,1,1,0,0,1,1,1,0
1446,,,OculusFinancial,1,1,2,1,1,2,0,0.006687,0,0,0,0
1447,,,Wisteria0527,0,2,2,0,2,2,0,0,1,1,1,0
1448,,,WZ0210,0,1,1,0,1,1,0,0,1,1,1,0
1449,,,YankeeLew,6,1,7,6,1,7,0.166667,0.061088,0,0,0,0
1450,,,mmaiyuto,0,6,6,0,6,6,0,0,1,1,1,0
1451,,,heisvv,6,7,13,6,7,13,0.083333,0.040123,1,1,1,30
1452,,,mirethecat,0,2,2,0,2,2,0,0,1,1,1,0
1453,,,5gy4Sys0DyCEP1Y,0,2,2,0,2,2,0,0,1,1,1,0
1454,,,rururuice,0,1,1,0,1,1,0,0,1,1,1,0
1455,,,archiestrategos,0,1,1,0,1,1,0,0,1,1,1,0
1456,,,itzIooniz,1,1,2,1,1,2,0,0.006687,0,0,0,0
1457,,,H0TGIRLCOUTURE,5,1,6,5,1,6,0.2,0.033436,0,0,0,0
1458,,,aboabo0602,0,1,1,0,1,1,0,0,1,1,1,0
1459,,,yugo0527,0,1,1,0,1,1,0,0,1,1,1,0
1460,,,CT_FOX,0,1,1,0,1,1,0,0,1,1,1,0
1461,,,ErinArias13,0,6,6,0,9,9,0,0,1,1,1,0
1462,,,Mariam_Calder,0,1,1,0,1,1,0,0,1,1,1,0
1463,,,hyujinee,0,1,1,0,1,1,0,0,1,1,1,0
1464,,,b96981733,0,2,2,0,2,2,0,0,1,1,1,0
1465,,,bluewind_a,0,1,1,0,1,1,0,0,1,1,1,0
1466,,,ciprycanovi,0,1,1,0,1,1,0,0,1,1,1,0
1467,,,tsusa23,0,9,9,0,10,10,0,0,1,1,1,0
1468,,,donkanako,0,2,2,0,2,2,0,0,3,0.545455,0.638889,0
1469,,,Kyleeeeee_C,0,1,1,0,1,1,0,0,1,1,1,0
1470,,,yoiko23421,0,2,2,0,2,2,0,0,1,1,1,0
1471,,,wpohsuan_3197,0,1,1,0,1,1,0,0,1,1,1,0
1472,,,taketnn,0,6,6,0,6,6,0,0,1,1,1,0
1473,,,ymdxmeganeeeeen,0,1,1,0,1,1,0,0,1,1,1,0
1474,,,airhasiescardo,0,6,6,0,6,6,0,0,2,0.875,0.928571,0
1475,,,fukiko0204,4,1,5,4,1,5,0,0.022081,1,1,1,6
1476,,,Ssavi11,0,1,1,0,1,1,0,0,1,1,1,0
1477,,,kiri_390,0,1,1,0,1,1,0,0,1,1,1,0
1478,,,HiVanillaSky,0,1,1,0,1,1,0,0,1,1,1,0
1479,,,lbroske,2,1,3,2,1,3,0.5,0.013374,0,0,0,0
1480,,,tingdingding123,0,1,1,0,1,1,0,0,1,1,1,0
1481,,,DBreban,6,1,7,6,1,7,0.166667,0.040123,0,0,0,0
1482,,,travel_ski_love,0,6,6,0,6,6,0,0,2,0.8,0.875,0
1483,,,Korinokakera_,0,2,2,0,2,2,0,0,1,1,1,0
1484,,,honeyflies05,0,1,1,0,1,1,0,0,1,1,1,0
1485,,,dokuRingo13,0,2,2,0,2,2,0,0,1,1,1,0
1486,,,ue2goten,0,1,1,0,1,1,0,0,1,1,1,0
1487,,,dogandwinelover,2,6,8,2,6,8,0.142857,0.013374,2,0.857143,0.916667,6
1488,,,KSL_AlexCabrero,1,3,4,1,3,4,0.333333,0.006687,1,1,1,0
1489,,,VENTIHYE,6,1,7,7,2,9,0.166667,0.043617,0,0,0,0
1490,,,sarah052794,1,6,7,1,6,7,0.166667,0.006687,2,0.857143,0.916667,0
1491,,,pitkeev,0,3,3,0,3,3,0,0,1,1,1,0
1492,,,drusje__,0,1,1,0,1,1,0,0,1,1,1,0
1493,,,FxxkCCP3,0,1,1,0,1,1,0,0,1,1,1,0
1494,,,kirakir7052464,0,2,2,0,2,2,0,0,1,1,1,0
1495,,,Mie05161,0,3,3,0,3,3,0,0,3,0.583333,0.690476,0
1496,,,idannyb,0,1,1,0,1,1,0,0,1,1,1,0
1497,,,c_jptk,0,1,1,0,1,1,0,0,1,1,1,0
1498,,,yukita_1234,0,1,1,0,1,1,0,0,1,1,1,0
1499,,,CPA271,0,1,1,0,1,1,0,0,1,1,1,0
1500,,,kapuritou,0,1,1,0,1,1,0,0,1,1,1,0
1501,,,carlaguionbajop,0,1,1,0,1,1,0,0,1,1,1,0
1502,,,melon_3103,0,1,1,0,1,1,0,0,1,1,1,0
1503,,,iceberg0707,0,1,1,0,1,1,0,0,1,1,1,0
1504,,,kyu_tyan93,0,1,1,0,1,1,0,0,1,1,1,0
1505,,,aptt,0,3,3,0,3,3,0,0,3,0.535714,0.588889,0
1506,,,makonyan7,0,3,3,0,3,3,0,0,1,1,1,0
1507,,,AiraLifeIsGood,0,1,1,0,1,1,0,0,1,1,1,0
1508,,,wataman2mawata,0,2,2,0,2,2,0,0,1,1,1,0
1509,,,yn12171129,0,1,1,0,1,1,0,0,1,1,1,0
1510,,,Tirxmiisu,0,1,1,0,1,1,0,0,1,1,1,0
1511,,,sbram94,0,5,5,0,5,5,0,0,2,0.857143,0.916667,0
1512,,,writer_fineart,0,1,1,0,1,1,0,0,1,1,1,0
1513,,,Aahmattt,11,1,12,12,2,14,0.090909,0.073559,0,0,0,0
1514,,,marianturkin1,0,1,1,0,1,1,0,0,1,1,1,0
1515,,,B_RadZimm,0,2,2,0,2,2,0,0,1,1,1,0
1516,,,ryankt170219,0,3,3,0,3,3,0,0,2,0.8,0.875,0
1517,,,melanchanly,0,1,1,0,1,1,0,0,1,1,1,0
1518,,,thegalaisnow,0,2,2,0,2,2,0,0,1,1,1,0
1519,,,NBCSports,0,1,1,0,1,1,0,0,1,1,1,0
1520,,,daisukeofsouls,0,3,3,0,3,3,0,0,1,1,1,0
1521,,,Gil00006,0,1,1,0,1,1,0,0,1,1,1,0
1522,,,sconbtea,0,1,1,0,1,1,0,0,1,1,1,0
1523,,,ayuzubot,10,1,11,10,1,11,0.1,0.072326,0,0,0,0
1524,,,liberalbt,0,1,1,0,1,1,0,0,1,1,1,0
1525,,,Chika_su1_1217,0,2,2,0,2,2,0,0,1,1,1,0
1526,,,MFzdsaIkujQHT8K,0,4,4,0,4,4,0,0,1,1,1,0
1527,,,tarosukesaku,0,3,3,0,3,3,0,0,2,0.8,0.875,0
1528,,,goodwilldai,0,2,2,0,2,2,0,0,1,1,1,0
1529,,,xyron76,0,1,1,0,1,1,0,0,1,1,1,0
1530,,,Sandie210,0,3,3,0,3,3,0,0,1,1,1,0
1531,,,tittyai69,2,1,3,2,1,3,0,0.00792,1,1,1,2
1532,,,209jb_,0,1,1,0,1,1,0,0,1,1,1,0
1533,,,LievSalavat,9,1,10,9,1,10,0.111111,0.139103,0,0,0,0
1534,,,tartea3,0,2,2,0,2,2,0,0,1,1,1,0
1535,,,RobbieReyNews,0,1,1,0,1,1,0,0,1,1,1,0
1536,,,narururu2022,0,3,3,0,3,3,0,0,1,1,1,0
1537,,,lifeskate,6,4,10,6,4,10,0.111111,0.040123,1,1,1,15
1538,,,Laurie_Parker_,0,1,1,0,1,1,0,0,1,1,1,0
1539,,,KurtBW_News,0,1,1,0,1,1,0,0,1,1,1,0
1540,,,maeude_znwnkn,0,1,1,0,1,1,0,0,1,1,1,0
1541,,,fuyugasuki__,0,1,1,0,1,1,0,0,1,1,1,0
1542,,,shitiemomm,0,5,5,0,5,5,0,0,1,1,1,0
1543,,,ume_q_li,0,1,1,0,1,1,0,0,1,1,1,0
1544,,,S_B_Macaron,0,1,1,0,1,1,0,0,1,1,1,0
1545,,,theeblackusagi,0,1,1,0,1,1,0,0,1,1,1,0
1546,,,BKoolie,104,1,105,104,1,105,0.009615,0.890015,0,0,0,0
1547,,,Rin_Me,0,5,5,0,5,5,0,0,2,0.857143,0.916667,0
1548,,,prancethecat,0,2,2,0,2,2,0,0,1,1,1,0
1549,,,manjuicecom1,0,1,1,0,1,1,0,0,1,1,1,0
1550,,,ht_dt2010,0,2,2,0,2,2,0,0,1,1,1,0
1551,,,D1skist,0,3,3,0,3,3,0,0,1,1,1,0
1552,,,ktr405_liefde,0,1,1,0,1,1,0,0,1,1,1,0
1553,,,teatimepalace,0,4,4,0,5,5,0,0,1,1,1,0
1554,,,haruru_LUV,0,1,1,0,1,1,0,0,1,1,1,0
1555,,,mjoitt,0,1,1,0,1,1,0,0,1,1,1,0
1556,,,yukinagaharu,0,2,2,0,2,2,0,0,2,0.75,0.833333,0
1557,,,Dynamite4Life,0,2,2,0,2,2,0,0,1,1,1,0
1558,,,evalottalover,0,1,1,0,1,1,0,0,1,1,1,0
1559,,,KatharinaVetos1,0,1,1,0,1,1,0,0,1,1,1,0
1560,,,miska_san,0,1,1,0,1,1,0,0,1,1,1,0
1561,,,lanakani,0,2,2,0,2,2,0,0,1,1,1,0
1562,,,zodiacsign12th,0,1,1,0,1,1,0,0,1,1,1,0
1563,,,inakappetaisyo,0,9,9,0,9,9,0,0,1,1,1,0
1564,,,u_ui6,0,1,1,0,1,1,0,0,1,1,1,0
1565,,,amanda_tavasa,0,1,1,0,1,1,0,0,1,1,1,0
1566,,,kwanfan1212,0,1,1,0,1,1,0,0,1,1,1,0
1567,,,pattinaggio2,0,11,11,0,11,11,0.009091,0,5,0.506173,0.602439,0
1568,,,cotco,0,1,1,0,1,1,0,0,1,1,1,0
1569,,,kaoj0211,0,2,2,0,2,2,0,0,3,0.555556,0.666667,0
1570,,,lishazi0501,0,1,1,0,1,1,0,0,1,1,1,0
1571,,,piko2_yoko,0,1,1,0,1,1,0,0,1,1,1,0
1572,,,rhapsodomancer,0,4,4,0,4,4,0,0,1,1,1,0
1573,,,catadams03,0,4,4,0,4,4,0,0,1,1,1,0
1574,,,telaFigureSkate,0,1,1,0,1,1,0,0,1,1,1,0
1575,,,PesceNic,0,1,1,0,1,1,0,0,1,1,1,0
1576,,,Key_Nyan_neko,0,4,4,0,4,4,0,0,1,1,1,0
1577,,,foretblanche67,0,1,1,0,1,1,0,0,1,1,1,0
1578,,,bonkoginsu,0,2,2,0,2,2,0,0,1,1,1,0
1579,,,wadyunoko1,0,1,1,0,1,1,0,0,1,1,1,0
1580,,,BravesATL2,0,2,2,0,2,2,0,0,1,1,1,0
1581,,,planet_POSS,0,1,1,0,1,1,0,0,1,1,1,0
1582,,,hamahara3,0,9,9,0,10,10,0,0,2,0.909091,0.95,0
1583,,,dazlyn0908,0,3,3,0,3,3,0,0,1,1,1,0
1584,,,minko_taro26,0,1,1,0,1,1,0,0,1,1,1,0
1585,,,kx5urekmp,0,9,9,0,9,9,0,0,2,0.909091,0.95,0
1586,,,ozkaonagadachs,0,6,6,0,6,6,0,0,4,0.555556,0.741667,0
1587,,,MISbOPloZrPanPJ,0,2,2,0,2,2,0,0,1,1,1,0
1588,,,hiokdesu,0,1,1,0,1,1,0,0,1,1,1,0
1589,,,shukorin55,0,3,3,0,3,3,0,0,1,1,1,0
1590,,,ck_hamada,0,1,1,0,1,1,0,0,1,1,1,0
1591,,,jollyzaza,0,5,5,0,5,5,0,0,1,1,1,0
1592,,,greenixApple_4F,0,1,1,0,1,1,0,0,1,1,1,0
1593,,,firebird7802_93,0,1,1,0,1,1,0,0,1,1,1,0
1594,,,st_koh,0,1,1,0,1,1,0,0,1,1,1,0
1595,,,minaruna_aaa,0,1,1,0,1,1,0,0,1,1,1,0
1596,,,H11uzCK8FZA3xl1,0,1,1,0,1,1,0,0,1,1,1,0
1597,,,AVG18,0,1,1,0,1,1,0,0,1,1,1,0
1598,,,fred_sk8_26,0,4,4,0,4,4,0,0,1,1,1,0
1599,,,shikanoyuka,0,1,1,0,1,1,0,0,1,1,1,0
1600,,,qoootaro,0,1,1,0,1,1,0,0,1,1,1,0
1601,,,waka_scorpio,0,1,1,0,1,1,0,0,1,1,1,0
1602,,,Tcapecod1,0,1,1,0,1,1,0,0,1,1,1,0
1603,,,_soleil_skate,2,8,10,2,8,10,0,0.00792,3,0.5,0.588889,60
1604,,,jsmn_1521,0,1,1,0,1,1,0,0,1,1,1,0
1605,,,forester201811,0,1,1,0,1,1,0,0,1,1,1,0
1606,,,pp22_yobupp,3,5,8,3,5,8,0.142857,0.020061,1,1,1,8
1607,,,mayukomayuri,0,6,6,0,6,6,0,0,1,1,1,0
1608,,,nikukyu_san,0,1,1,0,1,1,0,0,1,1,1,0
1609,,,ty0424,0,1,1,0,1,1,0,0,1,1,1,0
1610,,,miyamai_sanya,0,1,1,0,1,1,0,0,1,1,1,0
1611,,,jama_ikka,0,13,13,0,13,13,0,0,1,1,1,0
1612,,,pedalake,0,1,1,0,1,1,0,0,1,1,1,0
1613,,,0_equal_all,0,1,1,0,1,1,0,0,1,1,1,0
1614,,,kc_kobelife,0,2,2,0,2,2,0,0,1,1,1,0
1615,,,aoi__hana_skate,0,1,1,0,1,1,0,0,1,1,1,0
1616,,,BruceterJuice,0,1,1,0,1,1,0,0,1,1,1,0
1617,,,Le_Corsaire505,0,17,17,0,17,17,0,0,4,0.69697,0.844203,0
1618,,,snoopy197944,0,1,1,0,1,1,0,0,1,1,1,0
1619,,,aiphiyaya,0,1,1,0,1,1,0,0,1,1,1,0
1620,,,michi5747,0,2,2,0,2,2,0,0,1,1,1,0
1621,,,di_luna719,4,1,5,4,1,5,0,0.021294,1,1,1,5
1622,,,OIYShUJrL6jpgKO,0,2,2,0,2,2,0,0,1,1,1,0
1623,,,Meiln9255,0,8,8,0,8,8,0,0,1,1,1,0
1624,,,nekomachist,0,2,2,0,2,2,0,0,1,1,1,0
1625,,,Maki01Sasa,0,3,3,0,3,3,0,0,1,1,1,0
1626,,,plussignal,0,1,1,0,1,1,0,0,1,1,1,0
1627,,,makimaki_sk8,0,3,3,0,3,3,0,0,2,0.714286,0.8,0
1628,,,majp2014,0,1,1,0,1,1,0,0,1,1,1,0
1629,,,Oda_Sports,0,2,2,0,2,2,0,0,1,1,1,0
1630,,,TeamUSA,0,2,2,0,2,2,0,0,1,1,1,0
1631,,,IceTeaPod,0,1,1,0,1,1,0,0,1,1,1,0
1632,,,salai_no_,0,2,2,0,2,2,0,0,1,1,1,0
1633,,,yutasluvvr,0,1,1,0,1,1,0,0,1,1,1,0
1634,,,NBCOlympics,10,1,11,12,3,15,0.1,0.07386,0,0,0,0
1635,,,starIixie,11,1,12,11,1,12,0.090909,0.073559,0,0,0,0
1636,,,tooko3,0,1,1,0,1,1,0,0,1,1,1,0
1637,,,yanbur02,0,1,1,0,1,1,0,0,1,1,1,0
1638,,,242144_ray,0,2,2,0,2,2,0,0,1,1,1,0
1639,,,sobayutime,0,1,1,0,1,1,0,0,1,1,1,0
1640,,,eliakim_tkf,0,1,1,0,1,1,0,0,1,1,1,0
1641,,,momofpuggy,0,1,1,0,1,1,0,0,1,1,1,0
1642,,,vogarixb,0,1,1,0,1,1,0,0,1,1,1,0
1643,,,hberkes,0,1,1,0,1,1,0,0,1,1,1,0
1644,,,H0SEOKLOVER,1,1,2,1,1,2,0,0.006687,0,0,0,0
1645,,,noriko55,0,1,1,0,1,1,0,0,1,1,1,0
1646,,,redphoenixwitch,3,1,4,3,1,4,0.333333,0.020061,0,0,0,0
1647,,,NewAPParty,0,1,1,0,1,1,0,0,1,1,1,0
1648,,,Joelle51699383,0,1,1,0,1,1,0,0,1,1,1,0
1649,,,necocco23may,0,2,2,0,2,2,0,0,1,1,1,0
1650,,,popgomouse,0,2,2,0,2,2,0,0,3,0.5,0.633333,0
1651,,,LizMore98394131,0,1,1,0,1,1,0,0,1,1,1,0
1652,,,tannkumame,0,1,1,0,1,1,0,0,1,1,1,0
1653,,,FreeChinaNow_US,0,1,1,0,1,1,0,0,3,0.444444,0.541667,0
1654,,,aha360,0,2,2,0,2,2,0,0,3,0.5,0.633333,0
1655,,,thegoodmangrace,1,4,5,1,4,5,0.25,0.006687,3,0.545455,0.694444,0
1656,,,nastyonoush,0,1,1,0,1,1,0,0,3,0.444444,0.541667,0
1657,,,sattanlann,0,1,1,0,1,1,0,0,1,1,1,0
1658,,,chiyoko_donnie,0,10,10,0,11,11,0,0,2,0.916667,0.954545,0
1659,,,ThereWillBStars,3,1,4,3,1,4,0.333333,0.020061,0,0,0,0
1660,,,fpan1886,0,1,1,0,1,1,0,0,1,1,1,0
1661,,,hkfajie,0,1,1,0,1,1,0,0,1,1,1,0
1662,,,OOTOGARl,6,2,8,11,7,18,0.142857,0.074656,1,1,1,19
1663,,,ashveas,12,1,13,13,1,14,0,0.054508,2,0.666667,0.75,28
1664,,,SamiFaezeh,0,1,1,0,1,1,0,0,1,1,1,0
1665,,,fruitylookingmf,4,2,6,5,3,8,0.2,0.026749,1,1,1,3
1666,,,chnnny,0,1,1,0,1,1,0,0,2,0.666667,0.75,0
1667,,,InspiredMarch,0,1,1,0,1,1,0,0,1,1,1,0
1668,,,kkyutism,0,3,3,0,4,4,0,0,1,1,1,0
1669,,,100glitterstars,3,1,4,3,1,4,0.333333,0.020061,0,0,0,0
1670,,,ianfarrow,0,1,1,0,1,1,0,0,1,1,1,0
1671,,,questfortruth10,0,1,1,0,1,1,0,0,1,1,1,0
1672,,,00LT,5,5,10,5,6,11,0.111111,0.033436,1,1,1,16
1673,,,_diuqsmag29,0,4,4,0,4,4,0,0,2,0.666667,0.75,0
1674,,,chester2680,0,1,1,0,1,1,0,0,2,0.555556,0.6,0
1675,,,fay_jing,0,1,1,0,1,1,0,0,2,0.555556,0.6,0
1676,,,wzylemonade,0,3,3,0,3,3,0,0,2,0.636364,0.714286,0
1677,,,Dorothy23897725,0,1,1,0,1,1,0,0,1,1,1,0
1678,,,yakko6504,0,1,1,0,1,1,0,0,1,1,1,0
1679,,,caya_co,0,1,1,0,1,1,0,0,1,1,1,0
1680,,,soyratte,0,1,1,0,1,1,0,0,1,1,1,0
1681,,,TVPartyPlanner,1,1,2,1,1,2,0,0.006687,0,0,0,0
1682,,,sgreen3,1,1,2,1,1,2,0,0.006687,0,0,0,0
1683,,,MAYDAY62046187,0,1,1,0,1,1,0,0,1,1,1,0
1684,,,TomohikoIshibas,2,1,3,2,1,3,0.5,0.013374,0,0,0,0
1685,,,briasoboojie,5,2,7,7,3,10,0.166667,0.033436,2,0.666667,0.75,8
1686,,,Anniedeboer,0,1,1,0,1,1,0,0,3,0.5,0.611111,0
1687,,,RamitPMasti,4,1,5,4,1,5,0.25,0.026749,0,0,0,0
1688,,,KarlHeinrichMm,0,1,1,0,1,1,0,0,1,1,1,0
1689,,,aki_mitarai,0,1,1,0,1,1,0,0,1,1,1,0
1690,,,andipat100,0,1,1,0,1,1,0,0,1,1,1,0
1691,,,Robert__Beltran,0,1,1,0,1,1,0,0,1,1,1,0
1692,,,GreaselyWee,0,1,1,0,1,1,0,0,1,1,1,0
1693,,,EngrSeoltang,0,1,1,0,1,1,0,0,1,1,1,0
1694,,,maria_isabel_y,0,2,2,0,2,2,0,0,1,1,1,0
1695,,,citizenhk1,0,1,1,0,2,2,0,0,1,1,1,0
1696,,,melnichkaliz,0,3,3,0,3,3,0,0,1,1,1,0
1697,,,Jam13826408,0,2,2,0,3,3,0,0,1,1,1,0
1698,,,badiucao,1,2,3,1,2,3,0.5,0.006687,1,1,1,0
1699,,,ClarityInView,0,2,2,0,2,2,0,0,1,1,1,0
1700,,,zephyrchan,0,1,1,0,1,1,0,0,1,1,1,0
1701,,,9g4nTHCt09vh0nU,0,1,1,0,1,1,0,0,1,1,1,0
1702,,,MrFrostyCool,0,4,4,0,4,4,0,0,1,1,1,0
1703,,,Sei02579989,0,1,1,0,1,1,0,0,1,1,1,0
1704,,,FS_enthusiast,0,4,4,0,4,4,0,0,2,0.833333,0.9,0
1705,,,tokyopiglet1,0,1,1,0,1,1,0,0,1,1,1,0
1706,,,miyamakomo,0,1,1,0,1,1,0,0,1,1,1,0
1707,,,hommeameliorer,1,2,3,1,2,3,0.5,0.006687,1,1,1,0
1708,,,Evertbeetho,2,1,3,2,1,3,0.5,0.013374,0,0,0,0
1709,,,SherlJacks,0,1,1,0,1,1,0,0,1,1,1,0
1710,,,YahooSG,7,1,8,8,2,10,0.142857,0.04681,0,0,0,0
1711,,,0dy3253j1b22201,0,1,1,0,1,1,0,0,1,1,1,0
1712,,,pjOuzJA8rc7n463,0,1,1,0,1,1,0,0,1,1,1,0
1713,,,saku17_fun,0,1,1,0,1,1,0,0,1,1,1,0
1714,,,fuckthe57387390,0,1,1,0,1,1,0,0,1,1,1,0
1715,,,Stargazing0215,0,3,3,0,3,3,0,0,1,1,1,0
1716,,,AnTa46806676,11,1,12,11,1,12,0.090909,0.083274,0,0,0,0
1717,,,emanholic,0,1,1,0,1,1,0,0,1,1,1,0
1718,,,1025moya,0,1,1,0,1,1,0,0,1,1,1,0
1719,,,RisingSunJapan1,0,1,1,0,1,1,0,0,1,1,1,0
1720,,,waonnihongo,0,1,1,0,1,1,0,0,1,1,1,0
1721,,,lightsonmapi,1,1,2,2,1,3,0,0.00396,1,1,1,1
1722,,,anzendaiji_mei,0,1,1,0,1,1,0,0,1,1,1,0
1723,,,nano20_22,0,1,1,0,1,1,0,0,1,1,1,0
1724,,,d1skmashu,0,1,1,0,1,1,0,0,1,1,1,0
1725,,,liberaletta,0,1,1,0,1,1,0,0,1,1,1,0
1726,,,bashi1956,0,2,2,0,2,2,0,0,1,1,1,0
1727,,,mapi45,0,3,3,0,3,3,0,0,1,1,1,0
1728,,,taidai_lovek,0,1,1,0,1,1,0,0,1,1,1,0
1729,,,yyhbbhbb,0,1,1,0,1,1,0,0,1,1,1,0
1730,,,sk8d3,0,2,2,0,2,2,0,0,1,1,1,0
1731,,,LizzieHghj,0,1,1,0,1,1,0,0,1,1,1,0
1732,,,azumin_myane2,0,1,1,0,1,1,0,0,1,1,1,0
1733,,,Alexblx,0,1,1,0,1,1,0,0,1,1,1,0
1734,,,mokachiki901,0,6,6,0,6,6,0,0,1,1,1,0
1735,,,nobumamiya,0,5,5,0,5,5,0,0,1,1,1,0
1736,,,mika_noodle_,0,1,1,0,1,1,0,0,1,1,1,0
1737,,,97Mayumi,0,1,1,0,1,1,0,0,1,1,1,0
1738,,,mmayosyrup,0,4,4,0,4,4,0,0,3,0.666667,0.805556,0
1739,,,openchannel_D,4,1,5,5,2,7,0.25,0.037231,0,0,0,0
1740,,,hongkon03674876,3,2,5,3,2,5,0.25,0.020061,1,1,1,2
1741,,,hrtr42,0,3,3,0,3,3,0,0,1,1,1,0
1742,,,drsinry,1,1,2,1,1,2,0,0.006687,0,0,0,0
1743,,,Demetrehunter23,2,1,3,4,3,7,0.5,0.013374,0,0,0,0
1744,,,BeltwayBoudica,1,1,2,1,1,2,0,0.006687,0,0,0,0
1745,,,WMPhD,0,1,1,0,1,1,0,0,1,1,1,0
1746,,,MAOSHOMAGRYFFIN,1,2,3,1,2,3,0.5,0.006687,1,1,1,0
1747,,,WillyKo,0,2,2,0,2,2,0,0,1,1,1,0
1748,,,naomikoto,0,1,1,0,1,1,0,0,1,1,1,0
1749,,,homosexualkoo,2,1,3,2,1,3,0.5,0.013374,0,0,0,0
1750,,,classofseokjin,2,1,3,2,1,3,0.5,0.016869,0,0,0,0
1751,,,lacrimalaeta,1,2,3,1,2,3,0.5,0.006687,1,1,1,0
1752,,,furu3m,0,1,1,0,1,1,0,0,1,1,1,0
1753,,,Mary_from_Mars,0,1,1,0,1,1,0,0,1,1,1,0
1754,,,wolfjesus,0,1,1,0,1,1,0,0,1,1,1,0
1755,,,aomomiji12,0,2,2,0,2,2,0,0,1,1,1,0
1756,,,gobousei14,0,1,1,0,1,1,0,0,1,1,1,0
1757,,,seishunpower,0,1,1,0,1,1,0,0,1,1,1,0
1758,,,DeSandovalV,0,1,1,0,1,1,0,0,1,1,1,0
1759,,,cheezehao1,0,1,1,0,1,1,0,0,1,1,1,0
1760,,,paladindudiable,0,1,1,0,1,1,0,0,1,1,1,0
1761,,,GheorgheSandu15,8,1,9,8,1,9,0.125,0.053497,0,0,0,0
1762,,,mico_chinn,0,2,2,0,2,2,0,0,1,1,1,0
1763,,,chinadjr,0,2,2,0,2,2,0,0,1,1,1,0
1764,,,shochan016,0,2,2,0,2,2,0,0,1,1,1,0
1765,,,summie_D,0,4,4,0,4,4,0,0,2,0.75,0.833333,0
1766,,,Hygge3hyggeS,0,1,1,0,1,1,0,0,1,1,1,0
1767,,,naeonin,16,1,17,16,1,17,0.0625,0.205855,0,0,0,0
1768,,,cherrieixel,0,1,1,0,1,1,0,0,1,1,1,0
1769,,,schneien,0,2,2,0,2,2,0,0,1,1,1,0
1770,,,choco_holic,0,3,3,0,3,3,0,0,1,1,1,0
1771,,,satsuki1120,0,1,1,0,1,1,0,0,1,1,1,0
1772,,,davy_ninja,0,3,3,0,3,3,0,0,1,1,1,0
1773,,,shun_1971,0,1,1,0,1,1,0,0,1,1,1,0
1774,,,dara122,0,1,1,0,1,1,0,0,1,1,1,0
1775,,,jeux_deau4,0,1,1,0,1,1,0,0,1,1,1,0
1776,,,plaaaaaaloma,0,1,1,0,1,1,0,0,1,1,1,0
1777,,,Shami_Das,8,1,9,8,1,9,0.125,0.084945,0,0,0,0
1778,,,koguma_kuma,0,1,1,0,1,1,0,0,1,1,1,0
1779,,,jyozejyoze,0,1,1,0,1,1,0,0,1,1,1,0
1780,,,waterproofcandy,0,1,1,0,1,1,0,0,1,1,1,0
1781,,,onigirinigiru30,0,1,1,0,1,1,0,0,1,1,1,0
1782,,,mirehmet,8,1,9,9,1,10,0.125,0.053497,0,0,0,0
1783,,,choromatsu333,0,2,2,0,2,2,0,0,1,1,1,0
1784,,,Destiny25251210,0,7,7,0,8,8,0,0,2,0.888889,0.9375,0
1785,,,muremure_mm,0,1,1,0,1,1,0,0,1,1,1,0
1786,,,andreatome_,0,1,1,0,1,1,0,0,1,1,1,0
1787,,,mike5ster,0,1,1,0,1,1,0,0,1,1,1,0
1788,,,hitominn0505,0,4,4,0,6,6,0,0,2,0.833333,0.9,0
1789,,,Yahoo_MY,1,1,2,2,2,4,0,0.006687,0,0,0,0
1790,,,liliyunstephani,4,1,5,4,1,5,0.25,0.081872,0,0,0,0
1791,,,quackxel,0,1,1,0,1,1,0,0,1,1,1,0
1792,,,ElissaNadworny,6,1,7,6,1,7,0.166667,0.095246,0,0,0,0
1793,,,FsMiyabi,0,2,2,0,2,2,0,0,1,1,1,0
1794,,,kamasho0505,0,2,2,0,2,2,0,0,1,1,1,0
1795,,,_youresobea,0,1,1,0,1,1,0,0,1,1,1,0
1796,,,absoluteskating,1,2,3,1,2,3,0.5,0.006687,1,1,1,0
1797,,,EdBeckley5,2,1,3,2,1,3,0.5,0.013374,0,0,0,0
1798,,,mixmel0nl0n,0,1,1,0,1,1,0,0,1,1,1,0
1799,,,cam_l,0,1,1,0,1,1,0,0,1,1,1,0
1800,,,StephenWadeAP,6,1,7,7,2,9,0.166667,0.124766,0,0,0,0
1801,,,Lsun4868,0,3,3,0,3,3,0,0,1,1,1,0
1802,,,UNL92DEsSnpDphY,0,1,1,0,1,1,0,0,1,1,1,0
1803,,,al_malikafarida,2,1,3,2,1,3,0.5,0.013374,0,0,0,0
1804,,,ipeace4all,0,1,1,0,1,1,0,0,1,1,1,0
1805,,,NewstodayCyou,1,1,2,1,1,2,0,0.006687,0,0,0,0
1806,,,Gjmelio,1,1,2,1,1,2,0,0.006687,0,0,0,0
1807,,,jscanare,1,1,2,1,1,2,0,0.006687,0,0,0,0
1808,,,MrC_33,1,1,2,1,1,2,0,0.006687,0,0,0,0
1809,,,the_ashqking,9,1,10,10,1,11,0.111111,0.143381,0,0,0,0
1810,,,boyangfan2,22,25,47,30,34,64,0.022222,0.171577,4,0.75,0.880556,750
1811,,,simonvanrysewyk,0,1,1,0,1,1,0,0,1,1,1,0
1812,,,komak1_sk8i,0,1,1,0,1,1,0,0,1,1,1,0
1813,,,neogem5,0,1,1,0,1,1,0,0,1,1,1,0
1814,,,DL_FH_NB,0,1,1,0,1,1,0,0,1,1,1,0
1815,,,9Tsuialex,0,3,3,0,4,4,0,0,3,0.493151,0.523148,0
1816,,,inquirerdotnet,0,2,2,0,2,2,0,0,1,1,1,0
1817,,,NoCCPGenocide,0,1,1,0,1,1,0,0,1,1,1,0
1818,,,INQUIRERSports,15,1,16,18,3,21,0.066667,0.199168,0,0,0,0
1819,,,SRGUO,0,1,1,0,1,1,0,0,1,1,1,0
1820,,,vuodenaika,0,1,1,0,1,1,0,0,1,1,1,0
1821,,,sevenleung12,0,1,1,0,1,1,0,0,1,1,1,0
1822,,,ElkPapa,4,1,5,4,1,5,0.25,0.026749,0,0,0,0
1823,,,Jared01Ar,0,1,1,0,1,1,0,0,1,1,1,0
1824,,,JaimieBlackman,1,1,2,1,1,2,0,0.006687,0,0,0,0
1825,,,DinahVP,3,1,4,3,1,4,0.333333,0.020061,0,0,0,0
1826,,,weiaoyang1999,0,1,1,0,1,1,0,0,1,1,1,0
1827,,,HLJ_25209,9,1,10,16,8,24,0.111111,0.060184,0,0,0,0
1828,,,toramomo_tweet,0,14,14,0,15,15,0,0,3,0.644444,0.735632,0
1829,,,Kafka60613837,0,1,1,0,1,1,0,0,1,1,1,0
1830,,,BuggaMancini,0,1,1,0,1,1,0,0,1,1,1,0
1831,,,varuniitm,0,1,1,0,1,1,0,0,1,1,1,0
1832,,,xfionanx,0,1,1,0,1,1,0,0,1,1,1,0
1833,,,rianrim,1,1,2,1,1,2,0,0.006687,0,0,0,0
1834,,,yuz4a,0,1,1,0,1,1,0,0,1,1,1,0
1835,,,MichaelJShea4,0,1,1,0,1,1,0,0,1,1,1,0
1836,,,drbennett66,2,1,3,2,1,3,0.5,0.016869,0,0,0,0
1837,,,kslsports,9,3,12,11,5,16,0.090909,0.060184,2,0.75,0.833333,24
1838,,,fN6na1iTwNCPWv2,0,3,3,0,4,4,0,0,3,0.6,0.722222,0
1839,,,duane_an,0,2,2,0,2,2,0,0,3,0.555556,0.666667,0
1840,,,James69888,0,2,2,0,2,2,0,0,3,0.555556,0.666667,0
1841,,,TIMEX99832797,5,1,6,6,1,7,0.2,0.043918,0,0,0,0
1842,,,adizi9999,19,1,20,26,7,33,0.052632,0.144527,0,0,0,0
1843,,,loveiseasyas123,0,1,1,0,1,1,0,0,1,1,1,0
1844,,,suhoneydew,2,1,3,2,1,3,0.5,0.013374,0,0,0,0
1845,,,Tube002020,0,1,1,0,1,1,0,0,1,1,1,0
1846,,,Mich_San_d,4,1,5,4,1,5,0.25,0.026749,0,0,0,0
1847,,,jhwpng,13,1,14,16,4,20,0.076923,0.086933,0,0,0,0
1848,,,Rysiek76102827,0,2,2,0,2,2,0,0,1,1,1,0
1849,,,FWIWmacro,1,1,2,1,1,2,0,0.006687,0,0,0,0
1850,,,nuochan,0,1,1,0,1,1,0,0,1,1,1,0
1851,,,em_ily_donley,0,1,1,0,1,1,0,0,1,1,1,0
1852,,,jac0btweets,5,1,6,5,1,6,0.2,0.033436,0,0,0,0
1853,,,ithasnosense,0,1,1,0,1,1,0,0,1,1,1,0
1854,,,XiaosiQuentin,0,1,1,0,1,1,0,0,1,1,1,0
1855,,,Sunny43826164,0,1,1,0,1,1,0,0,1,1,1,0
1856,,,yoyo0329,0,2,2,0,2,2,0,0,1,1,1,0
1857,,,Silmarillion88,2,1,3,2,1,3,0.5,0.013374,0,0,0,0
1858,,,awajax1,1,1,2,1,1,2,0,0.006687,0,0,0,0
1859,,,swealthinc,2,1,3,2,1,3,0.5,0.013374,0,0,0,0
1860,,,caressa2020,0,1,1,0,1,1,0,0,1,1,1,0
1861,,,Qiying79849603,0,1,1,0,1,1,0,0,1,1,1,0
1862,,,lovemesomemearc,0,2,2,0,2,2,0,0,1,1,1,0
1863,,,tommy_cleary,0,1,1,0,1,1,0,0,1,1,1,0
1864,,,KirstenDLCO,2,1,3,3,2,5,0.5,0.013374,0,0,0,0
1865,,,imheretoscream,14,1,15,23,4,27,0.071429,0.09362,0,0,0,0
1866,,,HelloHK7,0,1,1,0,1,1,0,0,1,1,1,0
1867,,,AnonyLegion1112,0,1,1,0,2,2,0,0,1,1,1,0
1868,,,waseemezzie1234,0,1,1,0,1,1,0,0,1,1,1,0
1869,,,TTrapczynski,0,1,1,0,2,2,0,0,1,1,1,0
1870,,,Sustain_Urban,0,1,1,0,1,1,0,0,1,1,1,0
1871,,,buuchin1,0,2,2,0,2,2,0,0,3,0.513514,0.54386,0
1872,,,WoneTone,0,1,1,0,1,1,0,0,1,1,1,0
1873,,,fuckthepopo4eva,0,1,1,0,1,1,0,0,1,1,1,0
1874,,,Lawyer_A_Ho,0,1,1,0,1,1,0,0,1,1,1,0
1875,,,xzxzanalazy,0,2,2,0,2,2,0,0,1,1,1,0
1876,,,bess_leung,0,1,1,0,1,1,0,0,1,1,1,0
1877,,,lstvincentj,0,1,1,0,1,1,0,0,1,1,1,0
1878,,,bnb952,0,4,4,0,4,4,0,0,3,0.5,0.534188,0
1879,,,cheongsandaegu,4,1,5,4,1,5,0.25,0.026749,0,0,0,0
1880,,,RuyiRuyiHu,0,2,2,0,2,2,0,0,1,1,1,0
1881,,,kiki06579912,0,3,3,0,5,5,0,0,1,1,1,0
1882,,,momcaIIedmefat,4,1,5,4,1,5,0.25,0.026749,0,0,0,0
1883,,,POETJINGWA,0,2,2,0,2,2,0,0,1,1,1,0
1884,,,KeviCassii21,0,1,1,0,1,1,0,0,1,1,1,0
1885,,,kimtogata,0,1,1,0,1,1,0,0,1,1,1,0
1886,,,HinesWealthMgmt,1,1,2,1,1,2,0,0.006687,0,0,0,0
1887,,,advportfolios,7,1,8,9,1,10,0.142857,0.04681,0,0,0,0
1888,,,Blade49340067,0,2,2,0,2,2,0,0,1,1,1,0
1889,,,giang_dasher,0,1,1,0,1,1,0,0,1,1,1,0
1890,,,sscheuch_bine,0,1,1,0,1,1,0,0,1,1,1,0
1891,,,yymods,0,1,1,0,1,1,0,0,1,1,1,0
1892,,,heizeming668,0,1,1,0,1,1,0,0,1,1,1,0
1893,,,Ymer31214745,0,4,4,0,4,4,0.083333,0,1,1,1,0
1894,,,emmanuellelewin,1,1,2,1,1,2,0,0.006687,0,0,0,0
1895,,,RGroupFinancial,6,1,7,6,1,7,0.2,0.071929,0,0,0,0
1896,,,XiaoqiLi12,0,1,1,0,1,1,0,0,1,1,1,0
1897,,,xKrisLynn,0,1,1,0,1,1,0,0,1,1,1,0
1898,,,Zzorelia,11,1,12,11,1,12,0.007576,0.050548,1,1,1,12
1899,,,callumclemson,0,2,2,0,2,2,0,0,1,1,1,0
1900,,,hehemantgang,0,1,1,0,1,1,0,0,1,1,1,0
1901,,,PuppyGyuLovebot,0,1,1,0,1,1,0,0,1,1,1,0
1902,,,SamHuangFan,0,1,1,0,1,1,0,0,1,1,1,0
1903,,,mochii_sungie,0,2,2,0,2,2,0,0,1,1,1,0
1904,,,CarolSchmidlin,6,1,7,6,1,7,0.166667,0.040123,0,0,0,0
1905,,,kylelee168168,0,1,1,0,1,1,0,0,1,1,1,0
1906,,,stevedire,0,1,1,0,1,1,0,0,1,1,1,0
1907,,,sammyard078,0,1,1,0,1,1,0,0,1,1,1,0
1908,,,YanarD_U,0,1,1,0,1,1,0,0,2,0.666667,0.75,0
1909,,,mathiolla,0,1,1,0,1,1,0,0,2,0.666667,0.75,0
1910,,,FireIsBorn3,2,24,26,2,28,30,0.041667,0.020363,4,0.619718,0.74053,88
1911,,,dfghbr6t7,0,1,1,0,1,1,0,0,2,0.666667,0.75,0
1912,,,JohnSmi94424885,0,1,1,0,1,1,0,0,2,0.666667,0.75,0
1913,,,southstyl,0,1,1,0,1,1,0,0,2,0.666667,0.75,0
1914,,,xiaoli_ya,0,1,1,0,1,1,0,0,2,0.666667,0.75,0
1915,,,GrattoDanny,0,1,1,0,1,1,0,0,2,0.666667,0.75,0
1916,,,heyjomachin,2,1,3,2,1,3,0.5,0.013374,0,0,0,0
1917,,,PplFuture,0,1,1,0,1,1,0,0,1,1,1,0
1918,,,pinoymommy,4,1,5,4,1,5,0.25,0.026749,0,0,0,0
1919,,,sunshineca5,0,1,1,0,1,1,0,0,1,1,1,0
1920,,,Jeffarin22,0,2,2,0,2,2,0,0,1,1,1,0
1921,,,CyprusLex,0,2,2,0,2,2,0,0,1,1,1,0
1922,,,jxpiter_exe,3,1,4,3,1,4,0.333333,0.020061,0,0,0,0
1923,,,airwei221,0,1,1,0,1,1,0,0,1,1,1,0
1924,,,ReallyTrueNorth,0,1,1,0,1,1,0,0,1,1,1,0
1925,,,royalgeekg,5,1,6,5,1,6,0.2,0.033436,0,0,0,0
1926,,,brrrrr_noah,0,3,3,0,3,3,0,0,1,1,1,0
1927,,,Eve_USA,0,1,1,0,1,1,0,0,1,1,1,0
1928,,,gmkayumi2,0,1,1,0,1,1,0,0,1,1,1,0
1929,,,UOT9e9F5sPBYvkb,0,1,1,0,1,1,0,0,1,1,1,0
1930,,,youyounxingyunc,1,1,2,1,1,2,0,0.006687,0,0,0,0
1931,,,lenorechinn,4,1,5,6,2,8,0.25,0.026749,0,0,0,0
1932,,,fishushy,0,1,1,0,2,2,0,0,1,1,1,0
1933,,,forestsky15,0,1,1,0,1,1,0,0,1,1,1,0
1934,,,AtlasHopkinton,5,1,6,6,1,7,0.2,0.033436,0,0,0,0
1935,,,vangelicmonk,0,1,1,0,1,1,0,0,1,1,1,0
1936,,,buzzlightyear58,0,1,1,0,2,2,0,0,1,1,1,0
1937,,,Kndwhnsn,0,2,2,0,2,2,0,0,1,1,1,0
1938,,,K9649730142,0,2,2,0,2,2,0,0,3,0.471264,0.495935,0
1939,,,J00NIECHUU,7,1,8,7,1,8,0.142857,0.04681,0,0,0,0
1940,,,JuneMonroe3905,0,1,1,0,1,1,0,0,1,1,1,0
1941,,,xenus_c,0,2,2,0,2,2,0,0,1,1,1,0
1942,,,loko411,0,1,1,0,1,1,0,0,1,1,1,0
1943,,,freqflyer_ck,0,1,1,0,1,1,0,0,1,1,1,0
1944,,,VinnaRoseee,0,1,1,0,1,1,0,0,1,1,1,0
1945,,,GaryDu1962,0,1,1,0,1,1,0,0,1,1,1,0
1946,,,coeus61,0,1,1,0,1,1,0,0,1,1,1,0
1947,,,wildgees8,0,2,2,0,2,2,0,0,1,1,1,0
1948,,,JavisUpdate,0,1,1,0,1,1,0,0,1,1,1,0
1949,,,Harry43521235,0,1,1,0,1,1,0,0,1,1,1,0
1950,,,PachelbelCannon,0,1,1,0,1,1,0,0,1,1,1,0
1951,,,DawnLauri,0,2,2,0,2,2,0,0,1,1,1,0
1952,,,kcbobbie,0,2,2,0,2,2,0,0,1,1,1,0
1953,,,jdaviscpa,1,1,2,1,1,2,0,0.006687,0,0,0,0
1954,,,beastcoastmac,5,1,6,6,2,8,0.2,0.040424,0,0,0,0
1955,,,moltymolter,0,1,1,0,1,1,0,0,3,0.478873,0.495098,0
1956,,,mididoodles,0,3,3,0,3,3,0,0,3,0.493151,0.523148,0
1957,,,PuteriZoey,0,3,3,0,3,3,0,0,3,0.493151,0.523148,0
1958,,,DiamondDevil,0,1,1,0,1,1,0,0,3,0.478873,0.495098,0
1959,,,rkgs11,0,1,1,0,1,1,0,0,3,0.478873,0.495098,0
1960,,,shuaibcolin,0,1,1,0,1,1,0,0,3,0.478873,0.495098,0
1961,,,jgkidd82,0,1,1,0,1,1,0,0,3,0.478873,0.495098,0
1962,,,dvandeventer,0,1,1,0,1,1,0,0,3,0.478873,0.495098,0
1963,,,VictoriaTenshi,0,1,1,0,1,1,0,0,3,0.478873,0.495098,0
1964,,,TheJoeMendoza,0,1,1,0,1,1,0,0,1,1,1,0
1965,,,bannymimigipsa,0,1,1,0,1,1,0,0,1,1,1,0
1966,,,win91275047,0,1,1,0,1,1,0,0,1,1,1,0
1967,,,world_news_eng,0,8,8,0,10,10,0,0,1,1,1,0
1968,,,Penny_G,0,1,1,0,1,1,0,0,1,1,1,0
1969,,,IzagaAngeles,0,1,1,0,1,1,0,0,1,1,1,0
1970,,,meredit71840781,0,1,1,0,1,1,0,0,1,1,1,0
1971,,,ReddySalina,0,1,1,0,1,1,0,0,1,1,1,0
1972,,,1Mr_Kenn,0,1,1,0,1,1,0,0,1,1,1,0
1973,,,furiosalizabeth,18,4,22,23,9,32,0.047619,0.120369,1,1,1,51
1974,,,ghostgirl_q,0,1,1,0,1,1,0,0,2,0.571429,0.625,0
1975,,,Kraken_the_hero,0,1,1,0,1,1,0,0,2,0.571429,0.625,0
1976,,,GundamNorthrop,0,1,1,0,1,1,0,0,2,0.571429,0.625,0
1977,,,Vic1668,2,1,3,2,1,3,0.5,0.013374,0,0,0,0
1978,,,Loopdedo,0,1,1,0,1,1,0,0,1,1,1,0
1979,,,catboyjunhui_,7,1,8,8,1,9,0.142857,0.04681,0,0,0,0
1980,,,garbett_stephen,0,1,1,0,1,1,0,0,1,1,1,0
1981,,,ABCHK12345,0,1,1,0,1,1,0,0,1,1,1,0
1982,,,DrewPavlou,0,1,1,0,1,1,0,0,1,1,1,0
1983,,,BusinessEstate,1,1,2,1,1,2,0,0.006687,0,0,0,0
1984,,,queengramsey,5,1,6,7,1,8,0.2,0.033436,0,0,0,0
1985,,,julien201410,0,2,2,0,2,2,0,0,1,1,1,0
1986,,,zohrathought,0,1,1,0,2,2,0,0,1,1,1,0
1987,,,onerbicakci,0,1,1,0,2,2,0,0,1,1,1,0
1988,,,Pyrrho_Solon,0,1,1,0,1,1,0,0,1,1,1,0
1989,,,johangreg,0,6,6,0,8,8,0,0,1,1,1,0
1990,,,jbjasper,0,1,1,0,1,1,0,0,1,1,1,0
1991,,,ethiketmedias,0,1,1,0,1,1,0,0,3,0.478873,0.495098,0
1992,,,NoelleHannibal,5,1,6,5,1,6,0.2,0.033436,0,0,0,0
1993,,,bighireio,0,1,1,0,1,1,0,0,1,1,1,0
1994,,,LueRuiChao,0,1,1,0,1,1,0,0,1,1,1,0
1995,,,erikuhhhhrowman,0,3,3,0,3,3,0,0,1,1,1,0
1996,,,Tarunkondraju,0,1,1,0,1,1,0,0,1,1,1,0
1997,,,dr_vangry,5,1,6,5,1,6,0.2,0.043134,0,0,0,0
1998,,,HKind_Plastic,0,1,1,0,1,1,0,0,1,1,1,0
1999,,,AKalagianBlunt,0,1,1,0,1,1,0,0,1,1,1,0
2000,,,_fortheroses,0,1,1,0,1,1,0,0,1,1,1,0
2001,,,bigmoof,2,2,4,2,2,4,0.333333,0.023857,1,1,1,3
2002,,,bluemoon2046,1,1,2,1,1,2,0,0.006687,0,0,0,0
2003,,,MCraggettFSG,8,1,9,10,1,11,0.125,0.053497,0,0,0,0
2004,,,taizidang19732,0,2,2,0,3,3,0,0,1,1,1,0
2005,,,ajpgm100,0,1,1,0,1,1,0,0,1,1,1,0
2006,,,SusieTeo,0,1,1,0,1,1,0,0,1,1,1,0
2007,,,Jonesls,0,2,2,0,2,2,0,0,1,1,1,0
2008,,,waacker_bo,0,2,2,0,2,2,0,0,3,0.513514,0.54386,0
2009,,,TshirtClassic1,12,1,13,15,4,19,0.083333,0.094223,0,0,0,0
2010,,,Uyghur_Oghly,0,1,1,0,1,1,0,0,1,1,1,0
2011,,,terpsichore_los,0,3,3,0,3,3,0,0,1,1,1,0
2012,,,DanGarrett97,0,2,2,0,2,2,0,0,1,1,1,0
2013,,,panamafelix0412,2,1,3,2,1,3,0.5,0.013374,0,0,0,0
2014,,,w0r1dpeace,0,1,1,0,1,1,0,0,1,1,1,0
2015,,,melon_yeah,0,1,1,0,1,1,0,0,1,1,1,0
2016,,,MichaelMarich4,0,2,2,0,2,2,0,0,1,1,1,0
2017,,,IMISAID1,11,1,12,11,1,12,0.090909,0.108501,0,0,0,0
2018,,,skyfallwaka,0,2,2,0,2,2,0,0,1,1,1,0
2019,,,za2FJ7SlaBzEjPP,0,1,1,0,1,1,0,0,1,1,1,0
2020,,,HattrickThat,0,1,1,0,1,1,0,0,1,1,1,0
2021,,,KHuentelman,0,1,1,0,1,1,0,0,1,1,1,0
2022,,,Psps69919765,0,1,1,0,1,1,0,0,1,1,1,0
2023,,,IeatMangos,0,1,1,0,1,1,0,0,1,1,1,0
2024,,,NONPLVSD,0,1,1,0,1,1,0,0,1,1,1,0
2025,,,dxp19040219,3,1,4,3,1,4,0.333333,0.020061,0,0,0,0
2026,,,skaye73,0,3,3,0,3,3,0,0,1,1,1,0
2027,,,radiobigdog,0,1,1,0,1,1,0,0,1,1,1,0
2028,,,OakPartners,1,1,2,1,1,2,0,0.006687,0,0,0,0
2029,,,WSPJR4,2,1,3,3,2,5,0.5,0.013374,0,0,0,0
2030,,,CangLong3,1,1,2,1,1,2,0,0.006687,0,0,0,0
2031,,,jiwonstayx,1,1,2,1,1,2,0,0.006687,0,0,0,0
2032,,,ErkinSidick,0,1,1,0,1,1,0,0,1,1,1,0
2033,,,AshleyY2004iv,1,1,2,1,1,2,0,0.006687,0,0,0,0
2034,,,familydisaster,0,1,1,0,1,1,0,0,1,1,1,0
2035,,,Fanfan760188511,0,1,1,0,1,1,0,0,1,1,1,0
2036,,,bettyshalo,7,1,8,9,3,12,0.142857,0.04681,0,0,0,0
2037,,,SdBachman,0,1,1,0,1,1,0,0,1,1,1,0
2038,,,kiimnu,2,1,3,2,1,3,0.5,0.013374,0,0,0,0
2039,,,NewMidEast,1,1,2,1,1,2,0,0.006687,0,0,0,0
2040,,,Adsankey,1,1,2,1,1,2,0,0.006687,0,0,0,0
2041,,,mrbcyber,2,2,4,2,2,4,0.333333,0.013374,1,1,1,1
2042,,,crypt_ot,0,1,1,0,1,1,0,0,2,0.666667,0.75,0
2043,,,CinstaMind,5,1,6,5,1,6,0.2,0.057895,0,0,0,0
2044,,,SoniaHi27303526,0,1,1,0,1,1,0,0,1,1,1,0
2045,,,kuromistwinstar,7,2,9,7,2,9,0.125,0.04681,1,1,1,6
2046,,,ArchangelS_20,0,1,1,0,1,1,0,0,1,1,1,0
2047,,,volever34,0,1,1,0,2,2,0,0,1,1,1,0
2048,,,mrpatto,4,1,5,4,1,5,0.25,0.03493,0,0,0,0
2049,,,ronan68977484,0,1,1,0,1,1,0,0,1,1,1,0
2050,,,GoofMcFloof,0,1,1,0,1,1,0,0,1,1,1,0
2051,,,aaron_neuton,0,2,2,0,2,2,0,0,1,1,1,0
2052,,,LiuCiri,2,1,3,2,1,3,0.5,0.013374,0,0,0,0
2053,,,JayChakrabarti,0,1,1,0,1,1,0,0,1,1,1,0
2054,,,pepsi_spicy,2,1,3,2,1,3,0.5,0.013374,0,0,0,0
2055,,,KBARRetribution,0,1,1,0,1,1,0,0,1,1,1,0
2056,,,dualvectorfoil,3,1,4,3,1,4,0.333333,0.020061,0,0,0,0
2057,,,dr_CatKo,0,1,1,0,1,1,0,0,1,1,1,0
2058,,,zhonnika,0,1,1,0,1,1,0,0,1,1,1,0
2059,,,DadeMeghan,0,2,2,0,2,2,0,0,1,1,1,0
2060,,,hiki_akibs,1,1,2,1,1,2,0,0.006687,0,0,0,0
2061,,,HdzPaoo,3,1,4,3,1,4,0.333333,0.020061,0,0,0,0
2062,,,crownbias,0,1,1,0,1,1,0,0,1,1,1,0
2063,,,BonnieSalm,2,1,3,2,1,3,0.5,0.013374,0,0,0,0
2064,,,pschaap,4,1,5,4,1,5,0.25,0.026749,0,0,0,0
2065,,,drtomas17,0,1,1,0,1,1,0,0,1,1,1,0
2066,,,AnnaWorsnip,0,2,2,0,2,2,0,0,1,1,1,0
2067,,,SmugMischief,3,1,4,3,1,4,0.333333,0.020061,0,0,0,0
2068,,,Goldenashtonus,0,1,1,0,1,1,0,0,1,1,1,0
2069,,,nhathavo51129,0,2,2,0,2,2,0,0,1,1,1,0
2070,,,TheRealBudBundy,1,1,2,1,1,2,0,0.006687,0,0,0,0
2071,,,MomPve,2,1,3,2,1,3,0.5,0.013374,0,0,0,0
2072,,,JPMillerVA,0,1,1,0,1,1,0,0,1,1,1,0
2073,,,dcyiyou,1,1,2,1,1,2,0,0.006687,0,0,0,0
2074,,,KittenHuLuLu,0,1,1,0,1,1,0,0,1,1,1,0
2075,,,MikeZeigle,12,1,13,16,5,21,0.083333,0.080246,0,0,0,0
2076,,,all_serena,0,1,1,0,1,1,0,0,1,1,1,0
2077,,,JIMlNJIMIN,0,1,1,0,1,1,0,0,1,1,1,0
2078,,,arinelri,0,1,1,0,1,1,0,0,1,1,1,0
2079,,,oliverpee,3,1,4,4,1,5,0.333333,0.075969,0,0,0,0
2080,,,deathwizard57,1,1,2,1,1,2,0,0.006687,0,0,0,0
2081,,,ryan_fontanetta,2,1,3,2,1,3,0.5,0.069282,0,0,0,0
2082,,,whatdowehaveher,1,1,2,1,1,2,0,0.006687,0,0,0,0
2083,,,glutenhatr,1,1,2,2,2,4,0,0.006687,0,0,0,0
2084,,,SayNoToSino,0,3,3,0,3,3,0,0,1,1,1,0
2085,,,a_common_tater,0,1,1,0,1,1,0,0,2,0.666667,0.75,0
2086,,,KopaJude,2,1,3,2,1,3,0.5,0.013374,0,0,0,0
2087,,,kissingfauna,0,1,1,0,1,1,0,0,1,1,1,0
2088,,,Chewythewookie1,1,1,2,1,1,2,0,0.006687,0,0,0,0
2089,,,staceymc,1,1,2,1,1,2,0,0.006687,0,0,0,0
2090,,,Jessica718784,4,1,5,4,1,5,0.25,0.026749,0,0,0,0
2091,,,John_Scotus,0,1,1,0,1,1,0,0,1,1,1,0
2092,,,GraniteBayGirl,1,1,2,1,1,2,0,0.006687,0,0,0,0
2093,,,WFOIII,1,1,2,1,1,2,0,0.006687,0,0,0,0
2094,,,Alan_G_Smith_BC,0,1,1,0,1,1,0,0,1,1,1,0
2095,,,meowmyao,1,3,4,1,3,4,0.333333,0.006687,1,1,1,0
2096,,,aj_boston,1,1,2,1,1,2,0,0.006687,0,0,0,0
2097,,,CHIIbabyyy,3,1,4,3,1,4,0.333333,0.020061,0,0,0,0
2098,,,Chartjunkie2,0,1,1,0,1,1,0,0,1,1,1,0
2099,,,MaddyVennin,0,2,2,0,2,2,0,0,2,0.5625,0.611111,0
2100,,,JesseA1986,1,1,2,3,3,6,0,0.006687,0,0,0,0
2101,,,YanZhangClinic,2,1,3,2,1,3,0.5,0.013374,0,0,0,0
2102,,,spsot,0,1,1,0,1,1,0,0,1,1,1,0
2103,,,danharris,4,1,5,5,2,7,0.25,0.04422,0,0,0,0
2104,,,FUTURE_SAMBAKJA,0,1,1,0,1,1,0,0,1,1,1,0
2105,,,pewm12,1,1,2,1,1,2,0,0.006687,0,0,0,0
2106,,,BajyGdJpak15enz,4,1,5,4,1,5,0.25,0.047714,0,0,0,0
2107,,,shanshiines,0,1,1,0,1,1,0,0,1,1,1,0
2108,,,GalvezPrimo,0,2,2,0,2,2,0,0,1,1,1,0
2109,,,philschan,6,2,8,7,3,10,0.142857,0.040123,1,1,1,5
2110,,,MissCrouch5th,1,1,2,1,1,2,0,0.006687,0,0,0,0
2111,,,NFTTSI,3,1,4,3,1,4,0.333333,0.044521,0,0,0,0
2112,,,4flip3toe,6,2,8,7,3,10,0.142857,0.040123,1,1,1,5
2113,,,keirllyrian,0,1,1,0,1,1,0,0,1,1,1,0
2114,,,danny_noles,1,1,2,1,1,2,0,0.006687,0,0,0,0
2115,,,Jerkwheatery,1,1,2,1,1,2,0,0.006687,0,0,0,0
2116,,,5lutz3eu4axel,3,3,6,3,3,6,0.2,0.020061,1,1,1,4
2117,,,huihuihye,2,1,3,2,1,3,0.5,0.013374,0,0,0,0
2118,,,yyunivxrse,2,1,3,3,2,5,0.5,0.069282,0,0,0,0
2119,,,iwzumie,3,1,4,3,1,4,0.333333,0.061992,0,0,0,0
2120,,,trtr_sk8,0,4,4,0,4,4,0,0,3,0.6,0.703704,0
2121,,,GregBJenkins,0,1,1,0,1,1,0,0,2,0.571429,0.625,0
2122,,,lotus9406,1,1,2,1,1,2,0,0.006687,0,0,0,0
2123,,,JaneHyun,1,1,2,1,1,2,0,0.006687,0,0,0,0
2124,,,sandicandie,7,1,8,7,1,8,0.142857,0.04681,0,0,0,0
2125,,,KalinKate_,0,1,1,0,1,1,0,0,1,1,1,0
2126,,,dekusneakers,0,1,1,0,1,1,0,0,1,1,1,0
2127,,,jinsrightshoe,0,1,1,0,1,1,0,0,1,1,1,0
2128,,,bimbo4_life,0,1,1,0,1,1,0,0,1,1,1,0
2129,,,lilbangtankoo,0,1,1,0,1,1,0,0,1,1,1,0
2130,,,BrackensFSN,1,1,2,1,1,2,0,0.006687,0,0,0,0
2131,,,DomitiaEnobaria,5,1,6,5,1,6,0.2,0.033436,0,0,0,0
2132,,,alw4sh0m,0,5,5,0,5,5,0,0,2,0.777778,0.857143,0
2133,,,maolove20,0,1,1,0,1,1,0,0,1,1,1,0
2134,,,FunPasadena,0,2,2,0,2,2,0,0,1,1,1,0
2135,,,Douglasseal4,1,1,2,1,1,2,0,0.006687,0,0,0,0
2136,,,christinezhu142,0,1,1,0,1,1,0,0,1,1,1,0
2137,,,anna__voronova,0,1,1,0,1,1,0,0,1,1,1,0
2138,,,dance_edit,1,1,2,1,1,2,0,0.006687,0,0,0,0
2139,,,erik_engquist,4,1,5,4,1,5,0.25,0.026749,0,0,0,0
2140,,,marq_au,0,1,1,0,1,1,0,0,1,1,1,0
2141,,,APenagrande,0,1,1,0,1,1,0,0,1,1,1,0
2142,,,JiyongDaisy,0,1,1,0,1,1,0,0,1,1,1,0
2143,,,Sonata360,1,1,2,1,1,2,0,0.006687,0,0,0,0
2144,,,miniedwt,3,1,4,3,1,4,0.333333,0.020061,0,0,0,0
2145,,,ninicoledenisse,0,1,1,0,1,1,0,0,1,1,1,0
2146,,,CelticJade13,1,1,2,1,1,2,0,0.006687,0,0,0,0
2147,,,k2012_cad,1,1,2,1,1,2,0,0.006687,0,0,0,0
2148,,,valveone,1,1,2,1,1,2,0,0.006687,0,0,0,0
2149,,,BoundForIthaca,3,1,4,3,1,4,0.333333,0.020061,0,0,0,0
2150,,,ptong2261,0,1,1,0,1,1,0,0,1,1,1,0
2151,,,D1SK000,0,1,1,0,1,1,0,0,1,1,1,0
2152,,,nappayuzu,1,1,2,1,1,2,0,0.006687,0,0,0,0
2153,,,julieakern,1,1,2,1,1,2,0,0.006687,0,0,0,0
2154,,,mikekirbyone,3,1,4,3,1,4,0.333333,0.020061,0,0,0,0
2155,,,itskebon,0,1,1,0,1,1,0,0,1,1,1,0
2156,,,user88060725,0,3,3,0,3,3,0,0,1,1,1,0
2157,,,XinyueZ72698628,0,1,1,0,1,1,0,0,1,1,1,0
2158,,,quietmajority2,4,1,5,4,1,5,0.25,0.026749,0,0,0,0
2159,,,smithieee16,0,1,1,0,1,1,0,0,1,1,1,0
2160,,,____20mn,0,1,1,0,1,1,0,0,1,1,1,0
2161,,,sunnydelight,2,1,3,2,1,3,0.5,0.013374,0,0,0,0
2162,,,ce20065582,0,1,1,0,1,1,0,0,1,1,1,0
2163,,,Rbergen21,1,1,2,2,2,4,0,0.006687,0,0,0,0
2164,,,katfish912,1,1,2,1,1,2,0,0.006687,0,0,0,0
2165,,,sheebsheebs,2,1,3,2,1,3,0.5,0.013374,0,0,0,0
2166,,,J_isForJAWESOME,1,1,2,1,1,2,0,0.006687,0,0,0,0
2167,,,mahadeva20171,5,1,6,5,1,6,0.2,0.047413,0,0,0,0
2168,,,leonie_r,1,1,2,1,1,2,0,0.006687,0,0,0,0
2169,,,tiktokroom00,1,1,2,1,1,2,0,0.006687,0,0,0,0
2170,,,LizanneHynes,4,1,5,4,1,5,0.25,0.03493,0,0,0,0
2171,,,pet41159566,0,1,1,0,1,1,0,0,1,1,1,0
2172,,,DavidBo03050197,0,1,1,0,1,1,0,0,1,1,1,0
2173,,,MEOWWANGS,1,1,2,1,1,2,0,0.006687,0,0,0,0
2174,,,madonnasworld,2,1,3,2,1,3,0.5,0.013374,0,0,0,0
2175,,,0Y1kXjohWCoGBxf,0,1,1,0,1,1,0,0,1,1,1,0
2176,,,car_toast,1,1,2,1,1,2,0,0.006687,0,0,0,0
2177,,,mediaworksPR,2,1,3,2,1,3,0.5,0.013374,0,0,0,0
2178,,,CarlaFreemly,0,2,2,0,2,2,0,0,5,0.444444,0.490625,0
2179,,,AlwaysThinkHow,2,1,3,3,1,4,0.5,0.013374,0,0,0,0
2180,,,reniezxw,0,1,1,0,2,2,0,0,1,1,1,0
2181,,,closedbright,1,1,2,1,1,2,0,0.006687,0,0,0,0
2182,,,GrahamChowder,1,1,2,1,1,2,0,0.006687,0,0,0,0
2183,,,lowder_ja,0,2,2,0,2,2,0,0,1,1,1,0
2184,,,wegoneedcowbell,0,1,1,0,1,1,0,0,1,1,1,0
2185,,,rapture3169,6,1,7,9,4,13,0.166667,0.040123,0,0,0,0
2186,,,time2rebirth,0,1,1,0,1,1,0,0,3,0.478873,0.495098,0
2187,,,ThriftWallet,15,1,16,19,5,24,0.066667,0.121272,0,0,0,0
2188,,,tsuruga_meisai,0,1,1,0,1,1,0,0,1,1,1,0
2189,,,kasaros65,0,2,2,0,2,2,0,0,1,1,1,0
2190,,,AkashiKomei,0,1,1,0,1,1,0,0,1,1,1,0
2191,,,Rabbitlili,3,1,4,3,1,4,0.333333,0.020061,0,0,0,0
2192,,,MsBevanChuang,1,1,2,1,1,2,0,0.006687,0,0,0,0
2193,,,gsrgvch,1,1,2,1,1,2,0,0.006687,0,0,0,0
2194,,,SibeHuskyMom46,5,1,6,6,2,8,0.2,0.033436,0,0,0,0
2195,,,elainemdenison1,0,1,1,0,1,1,0,0,1,1,1,0
2196,,,flotsamnjetsom,0,1,1,0,1,1,0,0,1,1,1,0
2197,,,sunshinecityz,0,2,2,0,2,2,0,0,1,1,1,0
2198,,,YeDreams,0,1,1,0,1,1,0,0,1,1,1,0
2199,,,CCSLibraryNews,2,1,3,2,1,3,0.5,0.013374,0,0,0,0
2200,,,m_ch_ll_g__,0,1,1,0,1,1,0,0,1,1,1,0
2201,,,xleftcoastgirl,2,1,3,2,1,3,0.5,0.013374,0,0,0,0
2202,,,wesley49921497,0,1,1,0,1,1,0,0,1,1,1,0
2203,,,CodyToyota,1,1,2,2,2,4,0,0.006687,0,0,0,0
2204,,,__fluky,3,1,4,4,2,6,0.333333,0.020061,0,0,0,0
2205,,,GarleskyInsAgcy,4,1,5,4,1,5,0.25,0.026749,0,0,0,0
2206,,,sddphoto,0,1,1,0,1,1,0,0,1,1,1,0
2207,,,FarukPolatUygur,0,1,1,0,1,1,0,0,1,1,1,0
2208,,,Vertan72,1,1,2,1,1,2,0,0.006687,0,0,0,0
2209,,,duduacgsfc,0,1,1,0,1,1,0,0,2,0.545455,0.583333,0
2210,,,halsys,0,1,1,0,1,1,0,0,2,0.545455,0.583333,0
2211,,,hokiebrat,0,1,1,0,1,1,0,0,2,0.545455,0.583333,0
2212,,,beachybondgirl,0,1,1,0,1,1,0,0,1,1,1,0
2213,,,harryc2017,0,1,1,0,1,1,0,0,1,1,1,0
2214,,,PNWgramma,2,1,3,2,1,3,0.5,0.013374,0,0,0,0
2215,,,Clue1009,0,1,1,0,1,1,0,0,1,1,1,0
2216,,,BlazeBrandMan,3,1,4,3,1,4,0.333333,0.020061,0,0,0,0
2217,,,la_teacher2019,0,1,1,0,1,1,0,0,1,1,1,0
2218,,,Hqri4Ir,0,1,1,0,1,1,0,0,1,1,1,0
2219,,,Bolvo319,1,1,2,1,1,2,0,0.006687,0,0,0,0
2220,,,trow03,1,1,2,1,1,2,0,0.006687,0,0,0,0
2221,,,Henry73987183,1,1,2,1,1,2,0,0.006687,0,0,0,0
2222,,,SCOURING15,2,1,3,2,1,3,0.5,0.013374,0,0,0,0
2223,,,KristiB06161523,0,1,1,0,1,1,0,0,1,1,1,0
2224,,,Uyghurian,4,1,5,4,1,5,0.25,0.026749,0,0,0,0
2225,,,daum14508511,0,1,1,0,1,1,0,0,1,1,1,0
2226,,,Annoula64,0,1,1,0,1,1,0,0,1,1,1,0
2227,,,revo1776,0,1,1,0,1,1,0,0,1,1,1,0
2228,,,KtWealth,1,1,2,1,1,2,0,0.006687,0,0,0,0
2229,,,seefryar,4,1,5,5,2,7,0.25,0.026749,0,0,0,0
2230,,,convoidelahonte,0,1,1,0,1,1,0,0,1,1,1,0
2231,,,BgBardasMegaRod,0,1,1,0,1,1,0,0,1,1,1,0
2232,,,PelleCreepy,0,1,1,0,1,1,0,0,1,1,1,0
2233,,,WP2Ikgua93wsKWG,2,1,3,2,1,3,0.5,0.013374,0,0,0,0
2234,,,seaseafsf,0,1,1,0,1,1,0,0,1,1,1,0
2235,,,BreitbartNews,2,1,3,3,2,5,0.5,0.013374,0,0,0,0
2236,,,davidburn,2,1,3,2,1,3,0.5,0.013374,0,0,0,0
2237,,,alvarez_nimer,0,2,2,0,2,2,0,0,1,1,1,0
2238,,,BaRealAmerican,1,1,2,1,1,2,0,0.006687,0,0,0,0
2239,,,whoismims,1,1,2,1,1,2,0,0.006687,0,0,0,0
2240,,,gcfslee,1,1,2,1,1,2,0,0.006687,0,0,0,0
2241,,,Simplolic,3,1,4,6,4,10,0.333333,0.020061,0,0,0,0
2242,,,TableTalk101TV,0,2,2,0,2,2,0,0,1,1,1,0
2243,,,JapanToday,1,1,2,2,2,4,0,0.006687,0,0,0,0
2244,,,Natespiano,3,4,7,4,5,9,0.166667,0.020061,2,0.8,0.875,8
2245,,,makianome,0,1,1,0,1,1,0,0,3,0.5,0.566667,0
2246,,,lmartichuski,0,1,1,0,1,1,0,0,3,0.5,0.566667,0
2247,,,55otter,4,1,5,4,1,5,0.25,0.026749,0,0,0,0
2248,,,NephilimArc,1,1,2,1,1,2,0,0.006687,0,0,0,0
2249,,,DoakFinancial,2,1,3,2,1,3,0.5,0.013374,0,0,0,0
2250,,,luvvseokj,0,1,1,0,1,1,0,0,1,1,1,0
2251,,,Epicjikook,0,1,1,0,1,1,0,0,1,1,1,0
2252,,,Betsynancy1,0,1,1,0,1,1,0,0,2,0.666667,0.75,0
2253,,,Ty_Grieve28,0,1,1,0,1,1,0,0,2,0.666667,0.75,0
2254,,,daryyaaa_g,0,3,3,0,3,3,0,0,3,0.535714,0.588889,0
2255,,,CaseyKashem,4,1,5,4,1,5,0.25,0.081872,0,0,0,0
2256,,,totallykylez,0,27,27,0,45,45,0,0,2,0.909091,0.95,0
2257,,,livemebe,0,3,3,0,4,4,0,0,2,0.714286,0.8,0
2258,,,malawiflames,3,1,4,3,1,4,0.333333,0.020061,0,0,0,0
2259,,,marilynjp,0,1,1,0,1,1,0,0,1,1,1,0
2260,,,Ubedhu,2,3,5,3,3,6,0.25,0.013374,1,1,1,2
2261,,,virginsnowbunny,2,1,3,2,1,3,0.5,0.013374,0,0,0,0
2262,,,christo28213184,1,1,2,1,1,2,0,0.006687,0,0,0,0
2263,,,sigma_cori,10,2,12,17,6,23,0.090909,0.066871,1,1,1,9
2264,,,blazemrk,2,1,3,2,1,3,0.5,0.07627,0,0,0,0
2265,,,yankeepolka,18,2,20,19,3,22,0.052632,0.120369,1,1,1,17
2266,,,WuzUpG,1,1,2,1,1,2,0,0.006687,0,0,0,0
2267,,,JosephLalonde,1,1,2,1,1,2,0,0.006687,0,0,0,0
2268,,,redlineduck,4,1,5,5,2,7,0.25,0.026749,0,0,0,0
2269,,,monaukiss9008,0,1,1,0,1,1,0,0,1,1,1,0
2270,,,InStyle,1,1,2,1,1,2,0,0.006687,0,0,0,0
2271,,,RegattaResMonMg,1,1,2,1,1,2,0,0.006687,0,0,0,0
2272,,,m_ciancio,5,1,6,5,1,6,0.2,0.047413,0,0,0,0
2273,,,DrepocalypseNow,0,1,1,0,1,1,0,0,1,1,1,0
2274,,,kaoshang20,0,1,1,0,1,1,0,0,1,1,1,0
2275,,,mare_0303,0,3,3,0,3,3,0,0,1,1,1,0
2276,,,me_and_enhypen,0,1,1,0,1,1,0,0,1,1,1,0
2277,,,b_inlight,0,1,1,0,1,1,0,0,1,1,1,0
2278,,,manuvillavilla,1,1,2,1,1,2,0,0.006687,0,0,0,0
2279,,,thejimjams,2,1,3,2,1,3,0.5,0.013374,0,0,0,0
2280,,,kehat13,0,1,1,0,1,1,0,0,1,1,1,0
2281,,,TsarKastik,6,1,7,6,1,7,0.166667,0.12332,0,0,0,0
2282,,,jolicoeur11,0,2,2,0,2,2,0,0,1,1,1,0
2283,,,uphoseoksass,0,1,1,0,1,1,0,0,1,1,1,0
2284,,,okuyamekko,0,1,1,0,1,1,0,0,1,1,1,0
2285,,,MIYUKI2PRETTY,0,1,1,0,1,1,0,0,1,1,1,0
2286,,,raulgarza374,1,1,2,1,1,2,0,0.006687,0,0,0,0
2287,,,EricAGreschner,1,1,2,1,1,2,0,0.006687,0,0,0,0
2288,,,shepvn,1,1,2,1,1,2,0,0.006687,0,0,0,0
2289,,,snoopsmom123,1,1,2,1,1,2,0,0.006687,0,0,0,0
2290,,,gwendalsedges,2,1,3,2,1,3,0.5,0.021556,0,0,0,0
2291,,,onewpc,3,1,4,3,1,4,0.333333,0.020061,0,0,0,0
2292,,,SkyOnIce,0,1,1,0,1,1,0,0,1,1,1,0
2293,,,gladfly2,2,1,3,2,1,3,0.5,0.013374,0,0,0,0
2294,,,itstimedragons,0,1,1,0,1,1,0,0,1,1,1,0
2295,,,utardolt,1,2,3,1,2,3,0.5,0.006687,1,1,1,0
2296,,,euphori05795632,1,1,2,2,2,4,0,0.006687,0,0,0,0
2297,,,great_changer,1,1,2,1,1,2,0,0.006687,0,0,0,0
2298,,,KTXS_News,2,1,3,2,1,3,0.5,0.013374,0,0,0,0
2299,,,michiamocinzia,0,1,1,0,1,1,0,0,1,1,1,0
2300,,,cindy_sun13,3,1,4,3,1,4,0.333333,0.075969,0,0,0,0
2301,,,WEARDanielg,0,1,1,0,1,1,0,0,1,1,1,0
2302,,,NextShark,14,1,15,17,4,21,0.071429,0.100608,0,0,0,0
2303,,,renaissancerep1,0,2,2,0,2,2,0,0,1,1,1,0
2304,,,River_City,3,1,4,3,1,4,0.333333,0.020061,0,0,0,0
2305,,,SusieKonkle,0,1,1,0,1,1,0,0,1,1,1,0
2306,,,Luzi_im_Sarg,0,4,4,0,4,4,0,0,2,0.833333,0.9,0
2307,,,thisoneiserin,1,2,3,1,2,3,0.5,0.006687,1,1,1,0
2308,,,laurenmm62017,0,1,1,0,1,1,0,0,2,0.666667,0.75,0
2309,,,LaurenDezenski,0,1,1,0,1,1,0,0,1,1,1,0
2310,,,NaveenGRao,1,1,2,1,1,2,0,0.006687,0,0,0,0
2311,,,donmarshagency,1,1,2,1,1,2,0,0.006687,0,0,0,0
2312,,,SandyGarzaIns,2,1,3,2,1,3,0.5,0.013374,0,0,0,0
2313,,,adrienneshih,0,1,1,0,1,1,0,0,1,1,1,0
2314,,,AARPAAPI,10,1,11,11,2,13,0.1,0.118501,0,0,0,0
2315,,,people,2,1,3,3,2,5,0.5,0.013374,0,0,0,0
2316,,,ZvonimirWIRIP,0,1,1,0,1,1,0,0,1,1,1,0
2317,,,thepn_org,2,1,3,2,1,3,0.5,0.013374,0,0,0,0
2318,,,gin_sol,0,1,1,0,1,1,0,0,1,1,1,0
2319,,,AndrewH28212973,0,1,1,0,1,1,0,0,1,1,1,0
2320,,,tokyoswonder,1,1,2,1,1,2,0,0.006687,0,0,0,0
2321,,,LuzanoB,1,1,2,2,2,4,0,0.006687,0,0,0,0
2322,,,maggiecalfee,1,1,2,1,1,2,0,0.006687,0,0,0,0
2323,,,AnneEli23333852,3,1,4,3,1,4,0.333333,0.020061,0,0,0,0
2324,,,seafavson,0,1,1,0,1,1,0,0,1,1,1,0
2325,,,mihrjan,0,1,1,0,1,1,0,0,1,1,1,0
2326,,,JoeyIdeaJones,1,1,2,1,1,2,0,0.006687,0,0,0,0
2327,,,tjinlv,3,1,4,3,1,4,0.333333,0.020061,0,0,0,0
2328,,,zadorecki,0,2,2,0,2,2,0,0,1,1,1,0
2329,,,mcslog,1,1,2,1,1,2,0,0.006687,0,0,0,0
2330,,,adonsports,0,1,1,0,1,1,0,0,1,1,1,0
2331,,,IanPeterReed1,2,1,3,2,1,3,0.5,0.013374,0,0,0,0
2332,,,SyntaxWhiplash,0,1,1,0,1,1,0,0,1,1,1,0
2333,,,Nergal57524067,1,1,2,1,1,2,0,0.006687,0,0,0,0
2334,,,JFSebastian146,0,1,1,0,1,1,0,0,1,1,1,0
2335,,,soshiyerim,2,1,3,4,3,7,0.5,0.013374,0,0,0,0
2336,,,HBabcock10,0,1,1,0,1,1,0,0,2,0.6,0.666667,0
2337,,,smolglovs,0,1,1,0,1,1,0,0,2,0.6,0.666667,0
2338,,,idek3339,0,1,1,0,1,1,0,0,2,0.6,0.666667,0
2339,,,CoreyLallo,1,1,2,1,1,2,0,0.006687,0,0,0,0
2340,,,WSJMSports,1,1,2,1,1,2,0,0.006687,0,0,0,0
2341,,,gitanjalipoonia,0,1,1,0,1,1,0,0,1,1,1,0
2342,,,Nadecitah,0,1,1,0,1,1,0,0,1,1,1,0
2343,,,jaredtendler,1,1,2,1,1,2,0,0.006687,0,0,0,0
2344,,,MichelleFranzen,0,1,1,0,1,1,0,0,1,1,1,0
2345,,,Sportsradio960,1,1,2,1,1,2,0,0.006687,0,0,0,0
2346,,,JoeBarJr,5,1,6,5,1,6,0.2,0.050907,0,0,0,0
2347,,,nessieyasmeen,0,3,3,0,3,3,0,0,1,1,1,0
2348,,,TinnaLiu1,2,2,4,2,2,4,0.333333,0.013374,1,1,1,1
2349,,,niushuy1,0,1,1,0,1,1,0,0,2,0.666667,0.75,0
2350,,,Profokiev,1,1,2,1,1,2,0,0.006687,0,0,0,0
2351,,,thatdougsmith,5,1,6,5,1,6,0.2,0.033436,0,0,0,0
2352,,,etmapp,0,1,1,0,1,1,0,0,1,1,1,0
2353,,,XGirlNYC,0,1,1,0,1,1,0,0,1,1,1,0
2354,,,desnewssports,0,2,2,0,2,2,0,0,1,1,1,0
2355,,,yeahidgaf,0,1,1,0,1,1,0,0,1,1,1,0
2356,,,ryanwmcdonald,1,1,2,1,1,2,0,0.006687,0,0,0,0
2357,,,lauragwinin,3,1,4,4,2,6,0.333333,0.020061,0,0,0,0
2358,,,SeekLiberty1,0,1,1,0,1,1,0,0,1,1,1,0
2359,,,_MattCardin,3,1,4,3,1,4,0.333333,0.023556,0,0,0,0
2360,,,GusuSideEye,1,2,3,1,2,3,0.5,0.006687,1,1,1,0
2361,,,SpottedMonkee,0,2,2,0,2,2,0,0,1,1,1,0
2362,,,meditaudios,3,1,4,3,1,4,0.333333,0.020061,0,0,0,0
2363,,,cosmicjuliet,0,1,1,0,1,1,0,0,1,1,1,0
2364,,,kobayashiko11,1,1,2,1,1,2,0,0.006687,0,0,0,0
2365,,,emillyorr,2,1,3,2,1,3,0.5,0.013374,0,0,0,0
2366,,,MajamboKE,0,12,12,0,13,13,0,0,3,0.648649,0.743056,0
2367,,,GMA,2,1,3,2,1,3,0.5,0.013374,0,0,0,0
2368,,,apopbf,0,1,1,0,1,1,0,0,1,1,1,0
2369,,,jackvulkanengi1,0,1,1,0,2,2,0,0,1,1,1,0
2370,,,natniteray,0,1,1,0,2,2,0,0,1,1,1,0
2371,,,morgatari,2,1,3,2,1,3,0.5,0.013374,0,0,0,0
2372,,,spk0906,0,5,5,0,5,5,0,0,2,0.727273,0.8125,0
2373,,,nikbkh,2,1,3,2,1,3,0.5,0.013374,0,0,0,0
2374,,,Arman25849226,0,2,2,0,2,2,0,0,1,1,1,0
2375,,,36transform,1,1,2,1,1,2,0,0.006687,0,0,0,0
2376,,,anekoda,0,2,2,0,2,2,0,0,1,1,1,0
2377,,,openwonho,6,1,7,6,1,7,0.166667,0.040123,0,0,0,0
2378,,,christieNunez8,0,1,1,0,1,1,0,0,1,1,1,0
2379,,,edward_stilson,0,2,2,0,2,2,0,0,1,1,1,0
2380,,,PartyCd,0,1,1,0,1,1,0,0,1,1,1,0
2381,,,DZANET6666,0,1,1,0,1,1,0,0,1,1,1,0
2382,,,MontrealLyne,3,1,4,3,1,4,0.333333,0.020061,0,0,0,0
2383,,,GovKhan,0,7,7,0,7,7,0,0,1,1,1,0
2384,,,ABC,9,1,10,11,3,14,0.111111,0.060184,0,0,0,0
2385,,,sketchmimi,0,4,4,0,4,4,0,0,1,1,1,0
2386,,,AymenmohamedAli,0,1,1,0,1,1,0,0,1,1,1,0
2387,,,zg4ever,3,1,4,6,4,10,0.333333,0.023556,0,0,0,0
2388,,,laserbcat,0,1,1,0,1,1,0,0,1,1,1,0
2389,,,johnmkraus1,0,1,1,0,1,1,0,0,1,1,1,0
2390,,,1discoqueen,0,1,1,0,1,1,0,0,1,1,1,0
2391,,,inkbeee_,0,2,2,0,2,2,0,0,3,0.5,0.530303,0
2392,,,GlobalAsiaDPU,0,1,1,0,1,1,0,0,3,0.5,0.518519,0
2393,,,glapointewriter,1,1,2,1,1,2,0,0.006687,0,0,0,0
2394,,,KelynSoong,1,1,2,1,1,2,0,0.006687,0,0,0,0
2395,,,JosieK625,1,1,2,1,1,2,0,0.006687,0,0,0,0
2396,,,bitteryang31,7,1,8,8,1,9,0.142857,0.04681,0,0,0,0
2397,,,LoveThePuck,0,1,1,0,1,1,0,0,1,1,1,0
2398,,,AdrianReeder7,0,1,1,0,1,1,0,0,1,1,1,0
2399,,,allenglenn64,0,1,1,0,1,1,0,0,1,1,1,0
2400,,,StanTheMan0000,0,1,1,0,2,2,0,0,1,1,1,0
2401,,,macron_69,0,2,2,0,2,2,0,0,2,0.75,0.833333,0
2402,,,Alan_Nishihara,2,1,3,5,4,9,0.5,0.013374,0,0,0,0
2403,,,mkt_eth,4,1,5,4,1,5,0.25,0.026749,0,0,0,0
2404,,,Dovebyrd,0,2,2,0,2,2,0,0,2,0.75,0.833333,0
2405,,,1776DEFEATS1984,2,1,3,2,1,3,0.5,0.013374,0,0,0,0
2406,,,KellyVaughen,2,1,3,2,1,3,0.5,0.013374,0,0,0,0
2407,,,heavenhansol,0,1,1,0,1,1,0,0,1,1,1,0
2408,,,msbyshouyou,0,1,1,0,1,1,0,0,1,1,1,0
2409,,,BTCbadaBING,1,1,2,1,1,2,0,0.006687,0,0,0,0
2410,,,MihaiScorobete,1,1,2,1,1,2,0,0.006687,0,0,0,0
2411,,,texastwt,1,1,2,1,1,2,0,0.006687,0,0,0,0
2412,,,micheladlondon,4,1,5,5,1,6,0.25,0.033737,0,0,0,0
2413,,,JaneHand19,0,1,1,0,1,1,0,0,1,1,1,0
2414,,,loveletters4ksj,4,1,5,4,1,5,0.25,0.033737,0,0,0,0
2415,,,babe_skate,0,6,6,0,6,6,0,0,1,1,1,0
2416,,,diminiecakes,0,1,1,0,1,1,0,0,1,1,1,0
2417,,,APMKWRealtor,3,1,4,3,1,4,0.333333,0.020061,0,0,0,0
2418,,,tvheidihatch,0,1,1,0,1,1,0,0,1,1,1,0
2419,,,kazinmoon,0,1,1,0,1,1,0,0,1,1,1,0
2420,,,randywhitenow,1,1,2,1,1,2,0,0.006687,0,0,0,0
2421,,,Knewz_Currently,18,1,19,27,10,37,0.055556,0.170191,0,0,0,0
2422,,,AnneRPierce,0,1,1,0,1,1,0,0,1,1,1,0
2423,,,wnbstonerlawyer,0,1,1,0,1,1,0,0,1,1,1,0
2424,,,charbennardo,1,1,2,1,1,2,0,0.006687,0,0,0,0
2425,,,LakeHuronGirl,6,1,7,7,1,8,0.166667,0.040123,0,0,0,0
2426,,,Trailtalk1,0,1,1,0,1,1,0,0,1,1,1,0
2427,,,SusanTaylorSD,0,3,3,0,3,3,0,0,1,1,1,0
2428,,,DeannaGarcia6,0,2,2,0,2,2,0,0,1,1,1,0
2429,,,Kane007,0,2,2,0,2,2,0,0,1,1,1,0
2430,,,guttersniper,1,1,2,1,1,2,0,0.006687,0,0,0,0
2431,,,rainbobow,0,1,1,0,1,1,0,0,1,1,1,0
2432,,,TheChestnutPost,5,1,6,6,2,8,0.2,0.064884,0,0,0,0
2433,,,camilreon,0,1,1,0,1,1,0,0,1,1,1,0
2434,,,sanzokung,0,3,3,0,3,3,0,0,1,1,1,0
2435,,,nrullhnanni,0,1,1,0,1,1,0,0,1,1,1,0
2436,,,faircher,0,1,1,0,1,1,0,0,3,0.5,0.611111,0
2437,,,t0uuuu,0,1,1,0,1,1,0,0,3,0.5,0.611111,0
2438,,,carrotbuddy,0,1,1,0,2,2,0,0,3,0.5,0.611111,0
2439,,,Anii49032746,0,9,9,0,11,11,0.013889,0,3,0.785714,0.893939,0
2440,,,TheWrap,1,1,2,1,1,2,0,0.006687,0,0,0,0
2441,,,mari_ness,10,1,11,10,1,11,0.1,0.084343,0,0,0,0
2442,,,hahipuhepon,0,2,2,0,2,2,0,0,2,0.75,0.833333,0
2443,,,mypolaroidlub,0,4,4,0,5,5,0,0,1,1,1,0
2444,,,ice_aroma1998,0,1,1,0,1,1,0,0,1,1,1,0
2445,,,alsynergy2020,0,1,1,0,1,1,0,0,1,1,1,0
2446,,,DanyOnTheIce,7,1,8,7,1,8,0.142857,0.060787,0,0,0,0
2447,,,syuhuhaha,0,1,1,0,1,1,0,0,1,1,1,0
2448,,,InthesnowRaven,0,1,1,0,1,1,0,0,1,1,1,0
2449,,,better_delhincr,0,1,1,0,1,1,0,0,1,1,1,0
2450,,,hatetoxicfanyus,8,1,9,10,3,13,0.125,0.161153,0,0,0,0
2451,,,TheRealFixNow,0,1,1,0,1,1,0,0,1,1,1,0
2452,,,fuyabing,1,1,2,1,1,2,0,0.006687,0,0,0,0
2453,,,tae_to_my_kook,0,12,12,0,18,18,0,0,4,0.527778,0.627193,0
2454,,,Nicol_oji_panda,0,2,2,0,2,2,0,0,4,0.44186,0.5,0
2455,,,mT9hH5drLXnhzwJ,0,1,1,0,1,1,0,0,1,1,1,0
2456,,,bhavuksahni,0,1,1,0,1,1,0,0,1,1,1,0
2457,,,2A_VA_Supporter,3,1,4,3,1,4,0.333333,0.020061,0,0,0,0
2458,,,IradyZ,0,2,2,0,2,2,0,0,2,0.75,0.833333,0
2459,,,expobear1,0,3,3,0,3,3,0,0,2,0.8,0.875,0
2460,,,tonilds,3,1,4,3,1,4,0.333333,0.020061,0,0,0,0
2461,,,PREClOUSH,9,1,10,11,1,12,0,0.03564,2,0.666667,0.75,18
2462,,,MejiheiNm663432,0,2,2,0,2,2,0,0,2,0.75,0.833333,0
2463,,,JazzChou414,0,1,1,0,1,1,0,0,2,0.666667,0.75,0
2464,,,KavitaMatsko,0,1,1,0,1,1,0,0,2,0.666667,0.75,0
2465,,,KJTorrance,3,1,4,3,1,4,0.333333,0.020061,0,0,0,0
2466,,,galerieeminent,0,6,6,0,6,6,0,0,2,0.8,0.875,0
2467,,,fiona_webster22,0,1,1,0,1,1,0,0,1,1,1,0
2468,,,anonrc,9,1,10,9,1,10,0.111111,0.060184,0,0,0,0
2469,,,Garnet03307608,0,1,1,0,1,1,0,0,1,1,1,0
2470,,,BabyTiger1997,0,2,2,0,2,2,0,0,1,1,1,0
2471,,,20180217gold,0,2,2,0,2,2,0,0,1,1,1,0
2472,,,Viren_Doshi,0,1,1,0,1,1,0,0,1,1,1,0
2473,,,macaron11056,0,2,2,0,2,2,0,0,1,1,1,0
2474,,,lnrd_hk,0,1,1,0,1,1,0,0,1,1,1,0
2475,,,BattaHimawari,0,1,1,0,1,1,0,0,1,1,1,0
2476,,,suzunalei,4,1,5,4,1,5,0.25,0.026749,0,0,0,0
2477,,,YetteSu,0,1,1,0,1,1,0,0,1,1,1,0
2478,,,khuang99,0,1,1,0,1,1,0,0,1,1,1,0
2479,,,mikaylamarti,1,1,2,1,1,2,0,0.006687,0,0,0,0
2480,,,cherrygarcia5,3,1,4,3,1,4,0.333333,0.02705,0,0,0,0
2481,,,brian_arbeloa,0,1,1,0,1,1,0,0,1,1,1,0
2482,,,KUTV2News,3,1,4,4,2,6,0.333333,0.020061,0,0,0,0
2483,,,Brynnergy83,3,1,4,3,1,4,0.333333,0.020061,0,0,0,0
2484,,,shinyahisa,0,1,1,0,1,1,0,0,1,1,1,0
2485,,,YodaTheWeeb,4,1,5,5,2,7,0.25,0.046027,0,0,0,0
2486,,,WILLoftheSTATE,4,1,5,5,1,6,0.25,0.026749,0,0,0,0
2487,,,support_dem,0,1,1,0,1,1,0,0,1,1,1,0
2488,,,taka582160,0,1,1,0,1,1,0,0,1,1,1,0
2489,,,mpls55418,0,1,1,0,1,1,0,0,1,1,1,0
2490,,,28481k,0,2,2,0,2,2,0,0,3,0.555556,0.666667,0
2491,,,loreginadaniels,5,1,6,5,1,6,0.2,0.033436,0,0,0,0
2492,,,stephie_d85,0,1,1,0,1,1,0,0,1,1,1,0
2493,,,turnsup84,0,1,1,0,1,1,0,0,1,1,1,0
2494,,,PhelimKine,0,1,1,0,1,1,0,0,1,1,1,0
2495,,,jwaehope218,1,1,2,1,1,2,0,0.006687,0,0,0,0
2496,,,BiomedicalDude,1,1,2,1,1,2,0,0.006687,0,0,0,0
2497,,,theamgreatness,4,1,5,4,1,5,0.25,0.026749,0,0,0,0
2498,,,RistoReipas10,0,1,1,0,1,1,0,0,1,1,1,0
2499,,,jojjeols,1,1,2,1,1,2,0,0.006687,0,0,0,0
2500,,,nbcsandiego,14,1,15,18,5,23,0.071429,0.09362,0,0,0,0
2501,,,hylyzhy,0,1,1,0,1,1,0,0,1,1,1,0
2502,,,shea_roxi,2,1,3,2,1,3,0.5,0.048317,0,0,0,0
2503,,,ElaineChao,3,1,4,3,1,4,0.333333,0.020061,0,0,0,0
2504,,,LWavghist,3,1,4,3,1,4,0.333333,0.030544,0,0,0,0
2505,,,galaxy00479431,0,1,1,0,1,1,0,0,1,1,1,0
2506,,,bfrazier65,5,1,6,5,1,6,0.2,0.040424,0,0,0,0
2507,,,PanasonicNA,2,1,3,2,1,3,0.5,0.013374,0,0,0,0
2508,,,nirabohzu,0,2,2,0,2,2,0,0,1,1,1,0
2509,,,MobileZenNYC,4,1,5,4,1,5,0.25,0.124587,0,0,0,0
2510,,,HFsportslaw,4,1,5,4,1,5,0.25,0.026749,0,0,0,0
2511,,,denway_kim,0,2,2,0,2,2,0,0,1,1,1,0
2512,,,SVTY2K,1,1,2,1,1,2,0,0.006687,0,0,0,0
2513,,,AnusuyahN,0,1,1,0,1,1,0,0,1,1,1,0
2514,,,sciencemuseummn,2,1,3,2,1,3,0.5,0.013374,0,0,0,0
2515,,,JustBella,0,1,1,0,1,1,0,0,1,1,1,0
2516,,,TheHallucinator,3,1,4,3,1,4,0.333333,0.023556,0,0,0,0
2517,,,ellie_ellbell,0,1,1,0,1,1,0,0,1,1,1,0
2518,,,emedemeli,1,2,3,1,2,3,0.5,0.006687,1,1,1,0
2519,,,thelutzklutz,6,2,8,6,2,8,0.142857,0.040123,1,1,1,5
2520,,,Psywin,0,1,1,0,1,1,0,0,2,0.666667,0.75,0
2521,,,KendallMorrisTV,0,1,1,0,1,1,0,0,2,0.666667,0.75,0
2522,,,_doublemins,0,1,1,0,1,1,0,0,2,0.666667,0.75,0
2523,,,poomeloo_,0,1,1,0,1,1,0,0,2,0.666667,0.75,0
2524,,,hothoehot,0,1,1,0,1,1,0,0,2,0.666667,0.75,0
2525,,,fkwang,0,2,2,0,2,2,0,0,1,1,1,0
2526,,,lainehiggins17,1,1,2,1,1,2,0,0.006687,0,0,0,0
2527,,,AlyGetReal,0,1,1,0,1,1,0,0,1,1,1,0
2528,,,liongrit1,1,1,2,1,1,2,0,0.006687,0,0,0,0
2529,,,DjMastaGee1,2,1,3,2,1,3,0.5,0.013374,0,0,0,0
2530,,,MusicalElo,0,1,1,0,1,1,0,0,1,1,1,0
2531,,,JillMarieRichar,2,1,3,2,1,3,0.5,0.013374,0,0,0,0
2532,,,y001yfsonly,0,1,1,0,1,1,0,0,1,1,1,0
2533,,,MaryEmBern,1,1,2,1,1,2,0,0.006687,0,0,0,0
2534,,,domcapossela1,2,1,3,2,1,3,0.5,0.013374,0,0,0,0
2535,,,MarkinUptx,4,1,5,4,1,5,0.25,0.026749,0,0,0,0
2536,,,Parker1Erin,0,1,1,0,1,1,0,0,1,1,1,0
2537,,,mstepczyk,0,2,2,0,2,2,0,0,1,1,1,0
2538,,,galxyshortbread,0,1,1,0,1,1,0,0,1,1,1,0
2539,,,JesseAnneGlori1,1,1,2,1,1,2,0,0.006687,0,0,0,0
2540,,,Jasmagerwood,1,1,2,1,1,2,0,0.006687,0,0,0,0
2541,,,theuaenews247,1,1,2,1,1,2,0,0.006687,0,0,0,0
2542,,,YuzuruUpdate,1,1,2,1,1,2,0,0.006687,0,0,0,0
2543,,,ThreePointBomb,3,1,4,3,1,4,0.333333,0.020061,0,0,0,0
2544,,,ceder1207,0,1,1,0,1,1,0,0,1,1,1,0
2545,,,DianneT06564576,0,1,1,0,1,1,0,0,1,1,1,0
2546,,,lesbos4yuzuru,14,2,16,17,5,22,0.066667,0.100608,1,1,1,14
2547,,,IRLV4MPIRE,2,1,3,3,1,4,0.5,0.013374,0,0,0,0
2548,,,thereadingdiva,0,1,1,0,2,2,0,0,1,1,1,0
2549,,,L9Shiny,0,1,1,0,1,1,0,0,1,1,1,0
2550,,,WorcTeaParty,0,1,1,0,1,1,0,0,1,1,1,0
2551,,,duskyliterati,0,2,2,0,2,2,0,0,1,1,1,0
2552,,,vinnmank,2,1,3,2,1,3,0.5,0.013374,0,0,0,0
2553,,,IrieTEA,0,1,1,0,1,1,0,0,1,1,1,0
2554,,,CorporateState,2,1,3,2,1,3,0.5,0.013374,0,0,0,0
2555,,,StevenDominic7,2,1,3,2,1,3,0.5,0.013374,0,0,0,0
2556,,,zzlpb,0,2,2,0,2,2,0,0,1,1,1,0
2557,,,fafiyalatha,0,1,1,0,1,1,0,0,1,1,1,0
2558,,,passionflower92,0,1,1,0,1,1,0,0,1,1,1,0
2559,,,rmhx01,2,1,3,2,1,3,0.5,0.013374,0,0,0,0
2560,,,shuangxi75,0,1,1,0,1,1,0,0,1,1,1,0
2561,,,BDOH,1,1,2,1,1,2,0,0.006687,0,0,0,0
2562,,,OIS_Beijing2022,2,1,3,2,1,3,0.5,0.013374,0,0,0,0
2563,,,gun_6th,0,1,1,0,1,1,0,0,1,1,1,0
2564,,,TheViki94033139,3,1,4,4,2,6,0.333333,0.020061,0,0,0,0
2565,,,zxtttt_,0,1,1,0,1,1,0,0,1,1,1,0
2566,,,TheGreatYuzuru,0,4,4,0,4,4,0,0,1,1,1,0
2567,,,Trump_Force1,3,1,4,3,1,4,0.333333,0.020061,0,0,0,0
2568,,,Boyanxiejun,0,1,1,0,1,1,0,0,1,1,1,0
2569,,,jclarkcni,0,1,1,0,1,1,0,0,1,1,1,0
2570,,,AAARPGodess,2,1,3,2,1,3,0.5,0.013374,0,0,0,0
2571,,,tadrow,0,1,1,0,1,1,0,0,1,1,1,0
2572,,,RichOutzen,1,1,2,1,1,2,0,0.006687,0,0,0,0
2573,,,wangxiandianxia,4,1,5,5,2,7,0.25,0.026749,0,0,0,0
2574,,,ClearwaterBK,0,1,1,0,1,1,0,0,1,1,1,0
2575,,,beehivebutch,0,1,1,0,1,1,0,0,1,1,1,0
2576,,,haoyazhilv,0,2,2,0,2,2,0,0,1,1,1,0
2577,,,popicorin2,0,1,1,0,1,1,0,0,1,1,1,0
2578,,,skeeterboyo,4,1,5,4,1,5,0.25,0.026749,0,0,0,0
2579,,,immigrants24,0,1,1,0,1,1,0,0,1,1,1,0
2580,,,s20447924,0,1,1,0,1,1,0,0,1,1,1,0
2581,,,NHYOOWOOHOONOIC,3,1,4,3,1,4,0.333333,0.020061,0,0,0,0
2582,,,GtOpinion,0,1,1,0,1,1,0,0,1,1,1,0
2583,,,mdspl925,0,2,2,0,3,3,0,0,1,1,1,0
2584,,,LizzyRahim,1,1,2,1,1,2,0,0.006687,0,0,0,0
2585,,,globaltimesnews,2,1,3,2,1,3,0.5,0.013374,0,0,0,0
2586,,,shakeflintstone,0,1,1,0,1,1,0,0,1,1,1,0
2587,,,sorrel_thomas,1,1,2,1,1,2,0,0.006687,0,0,0,0
2588,,,LiliLiliLilianB,1,2,3,1,2,3,0.5,0.006687,1,1,1,0
2589,,,nianrencat,8,1,9,8,1,9,0.125,0.053497,0,0,0,0
2590,,,monaludo21,0,1,1,0,1,1,0,0,1,1,1,0
2591,,,_multitrash_,0,1,1,0,1,1,0,0,1,1,1,0
2592,,,LindaHuber19,0,1,1,0,1,1,0,0,1,1,1,0
2593,,,SueGreenMeadow,0,1,1,0,1,1,0,0,1,1,1,0
2594,,,sachimosan,0,1,1,0,1,1,0,0,1,1,1,0
2595,,,bee10ved,0,1,1,0,1,1,0,0,1,1,1,0
2596,,,GlebIgnatyev,1,1,2,1,1,2,0,0.006687,0,0,0,0
2597,,,J59396286,0,1,1,0,1,1,0,0,2,0.666667,0.75,0
2598,,,Jazzmom12,0,1,1,0,1,1,0,0,2,0.666667,0.75,0
2599,,,7chorogi,0,6,6,0,6,6,0,0,2,0.8,0.875,0
2600,,,tweet4852,0,1,1,0,1,1,0,0,1,1,1,0
2601,,,TheOneAngels,0,12,12,0,18,18,0,0,2,0.875,0.928571,0
2602,,,shinningfor,0,1,1,0,1,1,0,0,1,1,1,0
2603,,,Samsonslays2,1,1,2,1,1,2,0,0.006687,0,0,0,0
2604,,,kyihod,2,1,3,2,1,3,0.5,0.013374,0,0,0,0
2605,,,haphuong91,0,2,2,0,2,2,0,0,1,1,1,0
2606,,,HienP00,1,1,2,1,1,2,0,0.006687,0,0,0,0
2607,,,RobertMouton4,5,1,6,5,1,6,0.2,0.033436,0,0,0,0
2608,,,TesLex082016,0,1,1,0,1,1,0,0,1,1,1,0
2609,,,jbw2270775,0,1,1,0,1,1,0,0,1,1,1,0
2610,,,Desertpuma,0,1,1,0,1,1,0,0,1,1,1,0
2611,,,string0310,2,1,3,2,1,3,0.5,0.013374,0,0,0,0
2612,,,kat_xingxing,0,1,1,0,1,1,0,0,1,1,1,0
2613,,,czybyn,1,1,2,1,1,2,0,0.006687,0,0,0,0
2614,,,wcnc,7,1,8,7,1,8,0.142857,0.04681,0,0,0,0
2615,,,nodjdjgvv6,0,1,1,0,1,1,0,0,1,1,1,0
2616,,,irishkafighter,0,1,1,0,1,1,0,0,1,1,1,0
2617,,,SternbildDas,0,2,2,0,2,2,0,0,2,0.666667,0.75,0
2618,,,Tonie65144358,5,1,6,6,1,7,0.2,0.033436,0,0,0,0
2619,,,dare_darou,0,1,1,0,1,1,0,0,1,1,1,0
2620,,,gsmile5969,0,1,1,0,1,1,0,0,1,1,1,0
2621,,,9b3OR2qdITMbDcd,0,1,1,0,1,1,0,0,1,1,1,0
2622,,,GymnasticLoves,1,1,2,1,1,2,0,0.006687,0,0,0,0
2623,,,minaeshit,3,1,4,3,1,4,0.333333,0.020061,0,0,0,0
2624,,,_bootan,0,1,1,0,1,1,0,0,1,1,1,0
2625,,,meichan05642123,0,1,1,0,1,1,0,0,1,1,1,0
2626,,,PCabe14,2,1,3,2,1,3,0.5,0.013374,0,0,0,0
2627,,,MothershipSG,1,1,2,1,1,2,0,0.006687,0,0,0,0
2628,,,jasmine_mmkm,0,1,1,0,1,1,0,0,2,0.666667,0.75,0
2629,,,disastard,2,1,3,2,1,3,0.5,0.013374,0,0,0,0
2630,,,mumaralid,0,1,1,0,1,1,0,0,1,1,1,0
2631,,,Idkfigureskati1,1,2,3,1,2,3,0.5,0.006687,2,0.571429,0.625,0
2632,,,kevin965864,1,1,2,1,1,2,0,0.006687,0,0,0,0
2633,,,GingerSnap5656,2,1,3,2,1,3,0.5,0.013374,0,0,0,0
2634,,,stweettweets,0,1,1,0,1,1,0,0,1,1,1,0
2635,,,SS_YS_MI,0,1,1,0,1,1,0,0,1,1,1,0
2636,,,ichigoote,0,1,1,0,1,1,0,0,1,1,1,0
2637,,,ashdepressed,0,2,2,0,2,2,0,0,2,0.75,0.833333,0
2638,,,alpha_creater,1,1,2,1,1,2,0,0.006687,0,0,0,0
2639,,,ruocyan,0,1,1,0,1,1,0,0,1,1,1,0
2640,,,mzee26,2,1,3,2,1,3,0.5,0.013374,0,0,0,0
2641,,,imsolostinhere,0,1,1,0,1,1,0,0,1,1,1,0
2642,,,huntressrhyia_,4,1,5,4,1,5,0.25,0.026749,0,0,0,0
2643,,,3stike,0,1,1,0,1,1,0,0,1,1,1,0
2644,,,2014kanida,0,2,2,0,2,2,0,0,1,1,1,0
2645,,,jeffreyjamestv,0,1,1,0,1,1,0,0,1,1,1,0
2646,,,aishiterutokyo,2,1,3,2,1,3,0.5,0.013374,0,0,0,0
2647,,,NightSkyLix,0,8,8,0,8,8,0,0,1,1,1,0
2648,,,tagabhishek,1,1,2,1,1,2,0,0.006687,0,0,0,0
2649,,,gumboqueen3030,5,1,6,5,1,6,0.2,0.033436,0,0,0,0
2650,,,ArjunSrivastav_,0,1,1,0,1,1,0,0,1,1,1,0
2651,,,YoloYadav,0,1,1,0,1,1,0,0,1,1,1,0
2652,,,AshearaWilliam1,0,1,1,0,1,1,0,0,1,1,1,0
2653,,,iamreversefunny,1,1,2,1,1,2,0,0.006687,0,0,0,0
2654,,,yenorama,12,1,13,14,3,17,0.083333,0.080246,0,0,0,0
2655,,,Aka08104963,0,3,3,0,3,3,0,0,1,1,1,0
2656,,,fanyuuuuuuu,5,1,6,6,2,8,0.2,0.033436,0,0,0,0
2657,,,0312azu,0,4,4,0,4,4,0,0,1,1,1,0
2658,,,Marlinaayu,0,2,2,0,2,2,0,0,1,1,1,0
2659,,,1stredray,0,1,1,0,1,1,0,0,1,1,1,0
2660,,,1__________l1l,0,1,1,0,1,1,0,0,1,1,1,0
2661,,,cc527ss923,3,1,4,3,1,4,0.333333,0.020061,0,0,0,0
2662,,,viriyabot,0,3,3,0,3,3,0,0,1,1,1,0
2663,,,mirko60036887,0,1,1,0,1,1,0,0,1,1,1,0
2664,,,IndoPac_Info,1,1,2,1,1,2,0,0.006687,0,0,0,0
2665,,,jennerationnext,1,1,2,2,2,4,0,0.006687,0,0,0,0
2666,,,CartoonKim1,0,1,1,0,1,1,0,0,1,1,1,0
2667,,,iambabe14,1,1,2,2,2,4,0,0.006687,0,0,0,0
2668,,,fryguard1,4,1,5,4,1,5,0.25,0.026749,0,0,0,0
2669,,,myrm2z,0,1,1,0,1,1,0,0,1,1,1,0
2670,,,squeakysteph87,0,9,9,0,11,11,0,0,2,0.8,0.875,0
2671,,,121UTYUN,7,1,8,7,1,8,0.142857,0.050304,0,0,0,0
2672,,,ushijiwah,0,1,1,0,1,1,0,0,1,1,1,0
2673,,,fruity_joon,0,1,1,0,1,1,0,0,1,1,1,0
2674,,,DamooreJanice,0,1,1,0,1,1,0,0,1,1,1,0
2675,,,lemonfruit12,0,1,1,0,1,1,0,0,1,1,1,0
2676,,,yungchenlin,1,1,2,1,1,2,0,0.006687,0,0,0,0
2677,,,Dylammy,1,1,2,1,1,2,0,0.006687,0,0,0,0
2678,,,heeichou_,10,1,11,10,1,11,0.1,0.066871,0,0,0,0
2679,,,ahtpoon,0,2,2,0,2,2,0,0,1,1,1,0
2680,,,pcy__ppp,0,3,3,0,3,3,0,0,1,1,1,0
2681,,,asakoguma,0,2,2,0,2,2,0,0,1,1,1,0
2682,,,pmagshib,0,1,1,0,1,1,0,0,1,1,1,0
2683,,,CorneliusMill15,0,1,1,0,1,1,0,0,1,1,1,0
2684,,,mx_val_13,1,1,2,1,1,2,0,0.006687,0,0,0,0
2685,,,Ava58619634,0,2,2,0,2,2,0,0,1,1,1,0
2686,,,2017USAJane,0,1,1,0,1,1,0,0,1,1,1,0
2687,,,AceiTaka,0,2,2,0,2,2,0,0,1,1,1,0
2688,,,ClaraSampri,0,1,1,0,2,2,0,0,1,1,1,0
2689,,,KurtCobian1787,0,2,2,0,2,2,0,0,1,1,1,0
2690,,,senna12mao,0,2,2,0,2,2,0,0,1,1,1,0
2691,,,yanakabossa,0,1,1,0,1,1,0,0,1,1,1,0
2692,,,8MNcD0p6xK524xh,0,1,1,0,1,1,0,0,1,1,1,0
2693,,,HanyuYuzuru0712,0,2,2,0,2,2,0,0,1,1,1,0
2694,,,ZeynepDTrao,0,1,1,0,1,1,0,0,1,1,1,0
2695,,,sammyjoxoxo,1,1,2,1,1,2,0,0.006687,0,0,0,0
2696,,,anndroo,2,1,3,2,1,3,0.5,0.013374,0,0,0,0
2697,,,NineDragons2,1,1,2,1,1,2,0,0.006687,0,0,0,0
2698,,,OyaOyaOmiOmi,2,1,3,2,1,3,0.5,0.013374,0,0,0,0
2699,,,danniera11,0,3,3,0,3,3,0,0,1,1,1,0
2700,,,baaldeer,0,1,1,0,1,1,0,0,1,1,1,0
2701,,,fairieventi,2,1,3,2,1,3,0.5,0.023857,0,0,0,0
2702,,,spacedogvevo,9,1,10,9,1,10,0.111111,0.183624,0,0,0,0
2703,,,linlinyogo,0,1,1,0,1,1,0,0,1,1,1,0
2704,,,clatoed,0,1,1,0,1,1,0,0,1,1,1,0
2705,,,WomanVote,0,2,2,0,2,2,0,0,1,1,1,0
2706,,,rachel1970,0,1,1,0,1,1,0,0,1,1,1,0
2707,,,picheolins,33,2,35,40,6,46,0.029412,0.252124,1,1,1,40
2708,,,redz041,0,2,2,0,2,2,0,0,1,1,1,0
2709,,,RileyRuson,0,1,1,0,1,1,0,0,1,1,1,0
2710,,,bonniemcgahee,0,1,1,0,1,1,0,0,1,1,1,0
2711,,,Tom26058303,0,1,1,0,1,1,0,0,1,1,1,0
2712,,,Tony59956235,0,1,1,0,1,1,0,0,1,1,1,0
2713,,,marissalovesmx,0,2,2,0,2,2,0,0,1,1,1,0
2714,,,omega_paladin,2,1,3,2,1,3,0.5,0.013374,0,0,0,0
2715,,,yuki51yuki,0,1,1,0,1,1,0,0,1,1,1,0
2716,,,ScottAndPark,2,1,3,2,1,3,0.5,0.013374,0,0,0,0
2717,,,austintemple24,0,1,1,0,1,1,0,0,1,1,1,0
2718,,,xososnn,2,1,3,2,1,3,0.5,0.013374,0,0,0,0
2719,,,kiyasum,0,1,1,0,1,1,0,0,1,1,1,0
2720,,,teollom,0,1,1,0,1,1,0,0,1,1,1,0
2721,,,Rurapsuckss,2,2,4,2,2,4,0.333333,0.013374,1,1,1,1
2722,,,yuditter01,0,1,1,0,1,1,0,0,2,0.666667,0.75,0
2723,,,Johnmac07840318,1,1,2,1,1,2,0,0.006687,0,0,0,0
2724,,,bfry1981,2,1,3,2,1,3,0.5,0.020363,0,0,0,0
2725,,,bonjourentrez,1,2,3,2,3,5,0.5,0.006687,1,1,1,0
2726,,,VminKoo_BTSOT7,1,2,3,1,2,3,0.5,0.006687,1,1,1,0
2727,,,MarkVernica,1,1,2,1,1,2,0,0.006687,0,0,0,0
2728,,,Trumpgal9,2,1,3,2,1,3,0.5,0.013374,0,0,0,0
2729,,,TSBull213,1,1,2,1,1,2,0,0.006687,0,0,0,0
2730,,,boguiboy62,5,1,6,5,1,6,0.2,0.033436,0,0,0,0
2731,,,Bellagal7,0,1,1,0,1,1,0,0,1,1,1,0
2732,,,rollypoly31,0,1,1,0,1,1,0,0,1,1,1,0
2733,,,melseguraaa,0,1,1,0,1,1,0,0,1,1,1,0
2734,,,jmedinamolina,1,1,2,1,1,2,0,0.006687,0,0,0,0
2735,,,wjclvrhs,4,1,5,4,1,5,0.25,0.026749,0,0,0,0
2736,,,Temujin52,0,1,1,0,1,1,0,0,1,1,1,0
2737,,,alesle09,0,1,1,0,1,1,0,0,1,1,1,0
2738,,,svintsamu,0,3,3,0,4,4,0,0,1,1,1,0
2739,,,SallyWo42411402,2,1,3,2,1,3,0.5,0.013374,0,0,0,0
2740,,,HarmonyLight,0,1,1,0,1,1,0,0,1,1,1,0
2741,,,bokunosatan,10,1,11,11,2,13,0.1,0.066871,0,0,0,0
2742,,,windy081,0,1,1,0,1,1,0,0,1,1,1,0
2743,,,mtresasierra,0,1,1,0,1,1,0,0,1,1,1,0
2744,,,ri_n_rin,0,1,1,0,1,1,0,0,1,1,1,0
2745,,,p0pkag,0,2,2,0,2,2,0,0,1,1,1,0
2746,,,HattyLalahfield,0,7,7,0,8,8,0,0,1,1,1,0
2747,,,BunkerCarol,2,1,3,2,1,3,0.5,0.013374,0,0,0,0
2748,,,GypsyKingKuber,0,1,1,0,1,1,0,0,1,1,1,0
2749,,,no87273245,0,1,1,0,1,1,0,0,1,1,1,0
2750,,,gawdynews,1,1,2,1,1,2,0,0.006687,0,0,0,0
2751,,,momodezhichi,0,1,1,0,1,1,0,0,1,1,1,0
2752,,,steelpoohbear,0,1,1,0,1,1,0,0,1,1,1,0
2753,,,_martin_42,0,1,1,0,1,1,0,0,1,1,1,0
2754,,,makoto17637197,0,3,3,0,3,3,0,0,3,0.571429,0.666667,0
2755,,,cookieramblings,3,1,4,3,1,4,0.333333,0.028857,0,0,0,0
2756,,,catboyweiwuxian,0,1,1,0,1,1,0,0,1,1,1,0
2757,,,spaghetti916,1,1,2,1,1,2,0,0.006687,0,0,0,0
2758,,,MsCeeAngel,1,1,2,1,1,2,0,0.006687,0,0,0,0
2759,,,kassandria77,2,1,3,3,2,5,0.5,0.013374,0,0,0,0
2760,,,uribou317,0,2,2,0,2,2,0,0,1,1,1,0
2761,,,grammarflic,0,1,1,0,1,1,0,0,1,1,1,0
2762,,,hautahbuhgee,1,1,2,1,1,2,0,0.00396,1,1,1,1
2763,,,redevris,0,1,1,0,1,1,0,0,1,1,1,0
2764,,,Deryaipekc,0,1,1,0,1,1,0,0,1,1,1,0
2765,,,thaliana135,0,2,2,0,2,2,0,0,1,1,1,0
2766,,,jameswwhite2017,0,1,1,0,1,1,0,0,1,1,1,0
2767,,,little_thanks,0,1,1,0,1,1,0,0,1,1,1,0
2768,,,ambientspacenz,1,1,2,1,1,2,0,0.006687,0,0,0,0
2769,,,Ed6567,1,1,2,1,1,2,0,0.006687,0,0,0,0
2770,,,lourdesmoon94,6,1,7,6,1,7,0.166667,0.040123,0,0,0,0
2771,,,ltcallonme,0,1,1,0,1,1,0,0,1,1,1,0
2772,,,Katrin27291,0,1,1,0,1,1,0,0,1,1,1,0
2773,,,krainessk8,0,7,7,0,7,7,0,0,1,1,1,0
2774,,,may_olivia32,0,1,1,0,1,1,0,0,1,1,1,0
2775,,,WellieGirlGinge,3,1,4,3,1,4,0.333333,0.020061,0,0,0,0
2776,,,catesongbird,0,1,1,0,1,1,0,0,1,1,1,0
2777,,,ktyekmrf30,0,1,1,0,1,1,0,0,1,1,1,0
2778,,,Andrew_S_Rosen,0,1,1,0,1,1,0,0,1,1,1,0
2779,,,hanuman84,0,2,2,0,2,2,0,0,2,0.75,0.833333,0
2780,,,corszk0702_21,0,2,2,0,2,2,0,0,1,1,1,0
2781,,,marisapho,1,3,4,1,3,4,0,0.00396,1,1,1,3
2782,,,figureS_kanoko,0,2,2,0,2,2,0,0,1,1,1,0
2783,,,dann_h_b,0,1,1,0,1,1,0,0,1,1,1,0
2784,,,TrollandGarros,1,2,3,1,2,3,0.5,0.006687,1,1,1,0
2785,,,BBK8_e,1,1,2,1,1,2,0,0.006687,0,0,0,0
2786,,,turglo,8,1,9,8,1,9,0.125,0.053497,0,0,0,0
2787,,,roman_moira,0,1,1,0,1,1,0,0,1,1,1,0
2788,,,katakun052514,0,1,1,0,1,1,0,0,1,1,1,0
2789,,,TeensTeven,0,1,1,0,1,1,0,0,1,1,1,0
2790,,,mion_kakera16,0,3,3,0,3,3,0,0,1,1,1,0
2791,,,opallesbiian,0,1,1,0,1,1,0,0,1,1,1,0
2792,,,chisarumanma,0,3,3,0,3,3,0,0,1,1,1,0
2793,,,flyhiighx1_,1,1,2,1,1,2,0,0.006687,0,0,0,0
2794,,,LoProCo,5,1,6,5,1,6,0.2,0.033436,0,0,0,0
2795,,,bananaacookiess,0,1,1,0,1,1,0,0,1,1,1,0
2796,,,yuzu_sol,0,2,2,0,2,2,0,0,2,0.666667,0.75,0
2797,,,soccersarati,0,1,1,0,1,1,0,0,1,1,1,0
2798,,,CAgyemfra,0,3,3,0,3,3,0,0,1,1,1,0
2799,,,sxl_aris,18,1,19,19,1,20,0.055556,0.151817,0,0,0,0
2800,,,Soupypoopy__,0,1,1,0,2,2,0,0,1,1,1,0
2801,,,akimmie5atw2,0,3,3,0,4,4,0,0,1,1,1,0
2802,,,HaniaSaidi1,0,2,2,0,2,2,0,0,1,1,1,0
2803,,,yash_mina,0,2,2,0,2,2,0,0,1,1,1,0
2804,,,ishida_yuu_0072,0,1,1,0,1,1,0,0,1,1,1,0
2805,,,22lunacat,0,1,1,0,1,1,0,0,1,1,1,0
2806,,,santanuts,0,1,1,0,1,1,0,0,1,1,1,0
2807,,,lauraflute3,0,1,1,0,1,1,0,0,1,1,1,0
2808,,,clm1950,0,2,2,0,2,2,0,0,1,1,1,0
2809,,,LOVEMAO11,0,1,1,0,1,1,0,0,1,1,1,0
2810,,,rose_saudade,0,3,3,0,3,3,0,0,1,1,1,0
2811,,,tes0530,0,2,2,0,2,2,0,0,1,1,1,0
2812,,,HikitsukaMaro,0,2,2,0,2,2,0,0,1,1,1,0
2813,,,3axel_2toe_tano,0,2,2,0,2,2,0,0,1,1,1,0
2814,,,keroncho,0,2,2,0,2,2,0,0,2,0.75,0.833333,0
2815,,,rubbersoulster,0,2,2,0,2,2,0,0,1,1,1,0
2816,,,lemonskates_,0,1,1,0,1,1,0,0,1,1,1,0
2817,,,SheRa_Persists,5,1,6,5,1,6,0.2,0.033436,0,0,0,0
2818,,,SugisawaMinato,0,1,1,0,1,1,0,0,1,1,1,0
2819,,,fs_jn,0,1,1,0,1,1,0,0,1,1,1,0
2820,,,cocodoko116,0,2,2,0,2,2,0,0,1,1,1,0
2821,,,cmclymer,5,1,6,5,1,6,0.2,0.047413,0,0,0,0
2822,,,shioyuzuru,0,1,1,0,1,1,0,0,1,1,1,0
2823,,,MarcelvBochove,0,1,1,0,1,1,0,0,1,1,1,0
2824,,,alittletata,0,1,1,0,1,1,0,0,1,1,1,0
2825,,,funefone,0,1,1,0,1,1,0,0,1,1,1,0
2826,,,withspin,0,1,1,0,1,1,0,0,1,1,1,0
2827,,,arichiinen,0,1,1,0,1,1,0,0,1,1,1,0
2828,,,KHSM37610808,0,1,1,0,1,1,0,0,1,1,1,0
2829,,,urazirodog,0,1,1,0,1,1,0,0,2,0.666667,0.75,0
2830,,,REALMATHEW,0,1,1,0,1,1,0,0,2,0.666667,0.75,0
2831,,,AddisonMadden,2,2,4,2,2,4,0.333333,0.013374,1,1,1,1
2832,,,okkuchi1,0,1,1,0,1,1,0,0,2,0.666667,0.75,0
2833,,,MaggieMConnor,5,1,6,5,1,6,0.2,0.033436,0,0,0,0
2834,,,jofapex,0,1,1,0,1,1,0,0,1,1,1,0
2835,,,QASpdL35fTAjEgX,0,1,1,0,1,1,0,0,1,1,1,0
2836,,,godzandmonsters,0,1,1,0,1,1,0,0,1,1,1,0
2837,,,garam50mg,0,1,1,0,1,1,0,0,1,1,1,0
2838,,,amysno,1,1,2,1,1,2,0,0.006687,0,0,0,0
2839,,,LizStrand,3,1,4,3,1,4,0.333333,0.030544,0,0,0,0
2840,,,funakuramasu,0,1,1,0,1,1,0,0,1,1,1,0
2841,,,Tonyama59180360,2,1,3,2,1,3,0.5,0.013374,0,0,0,0
2842,,,clark6271,3,1,4,3,1,4,0.333333,0.020061,0,0,0,0
2843,,,joongiemiin,0,2,2,0,3,3,0,0,1,1,1,0
2844,,,factseekingmom,0,1,1,0,1,1,0,0,1,1,1,0
2845,,,tammytabby,2,1,3,2,1,3,0.5,0.013374,0,0,0,0
2846,,,rynettescavo,0,1,1,0,1,1,0,0,1,1,1,0
2847,,,hobisupremacy3,1,1,2,1,1,2,0,0.006687,0,0,0,0
2848,,,ignissc,0,1,1,0,1,1,0,0,1,1,1,0
2849,,,KittyPo80176717,6,1,7,7,1,8,0.166667,0.040123,0,0,0,0
2850,,,sncaffee,0,1,1,0,1,1,0,0,1,1,1,0
2851,,,TourTheWorld,0,1,1,0,2,2,0,0,1,1,1,0
2852,,,yukarin_s7,0,1,1,0,1,1,0,0,1,1,1,0
2853,,,judy171011,1,1,2,1,1,2,0,0.006687,0,0,0,0
2854,,,louispisani2016,0,1,1,0,1,1,0,0,2,0.6,0.666667,0
2855,,,TokofitRG,2,1,3,2,1,3,0.5,0.013374,0,0,0,0
2856,,,dangerjiminie,0,1,1,0,1,1,0,0,1,1,1,0
2857,,,Nina19893935,5,1,6,5,1,6,0.2,0.033436,0,0,0,0
2858,,,Deborah31524484,0,1,1,0,1,1,0,0,1,1,1,0
2859,,,xyxxv019207,0,1,1,0,1,1,0,0,1,1,1,0
2860,,,sanniebubs,0,1,1,0,1,1,0,0,1,1,1,0
2861,,,BunkerBlast,3,1,4,4,2,6,0.333333,0.020061,0,0,0,0
2862,,,sssoss777177,0,1,1,0,1,1,0,0,1,1,1,0
2863,,,nomoreghost_ac_,0,1,1,0,1,1,0,0,1,1,1,0
2864,,,filmmeebarn,0,1,1,0,1,1,0,0,1,1,1,0
2865,,,Dominic00719779,1,1,2,2,2,4,0,0.006687,0,0,0,0
2866,,,aerosqxx,1,1,2,1,1,2,0,0.006687,0,0,0,0
2867,,,Jerold_Chinn,1,1,2,1,1,2,0,0.006687,0,0,0,0
2868,,,Fiona_Yin_,3,1,4,3,1,4,0.333333,0.020061,0,0,0,0
2869,,,Taeminswetrpaws,0,1,1,0,1,1,0,0,1,1,1,0
2870,,,JemsHologram,0,1,1,0,1,1,0,0,1,1,1,0
2871,,,wintersantonym,2,1,3,2,1,3,0.5,0.023857,0,0,0,0
2872,,,mresundance,3,3,6,3,3,6,0.2,0.020061,1,1,1,4
2873,,,PetraOlson,2,1,3,2,1,3,0.5,0.013374,0,0,0,0
2874,,,smmrdays,0,1,1,0,1,1,0,0,1,1,1,0
2875,,,a24kosto,1,1,2,1,1,2,0,0.006687,0,0,0,0
2876,,,eclectelectric,0,1,1,0,1,1,0,0,2,0.666667,0.75,0
2877,,,00s_hallie,3,1,4,4,2,6,0.333333,0.020061,0,0,0,0
2878,,,lucusfeez,1,1,2,1,1,2,0,0.006687,0,0,0,0
2879,,,LynKaycie,1,1,2,1,1,2,0,0.006687,0,0,0,0
2880,,,tydoyoyo12,0,2,2,0,2,2,0,0,1,1,1,0
2881,,,rainbowzb,0,1,1,0,1,1,0,0,1,1,1,0
2882,,,natedogdodger,2,1,3,2,1,3,0.5,0.013374,0,0,0,0
2883,,,alraivilla2789,0,1,1,0,2,2,0,0,1,1,1,0
2884,,,xiyuqingfeng2,0,1,1,0,1,1,0,0,1,1,1,0
2885,,,nhennen,2,1,3,2,1,3,0.5,0.013374,0,0,0,0
2886,,,MinRenCiwi,0,1,1,0,1,1,0,0,1,1,1,0
2887,,,Dr_CorbinCWong,3,1,4,3,1,4,0.333333,0.044521,0,0,0,0
2888,,,curtisfortin,0,5,5,0,5,5,0,0,2,0.777778,0.857143,0
2889,,,littleponies,7,2,9,7,2,9,0.125,0.04681,1,1,1,6
2890,,,Reillyskater96,0,3,3,0,3,3,0,0,1,1,1,0
2891,,,jingran__,0,1,1,0,1,1,0,0,1,1,1,0
2892,,,HMongilio,3,1,4,3,1,4,0.333333,0.020061,0,0,0,0
2893,,,AnnieGE2,0,1,1,0,1,1,0,0,1,1,1,0
2894,,,zzzzgps,0,1,1,0,1,1,0,0,1,1,1,0
2895,,,make0utcr33k,4,1,5,6,3,9,0.25,0.026749,0,0,0,0
2896,,,e_Broky,10,1,11,14,2,16,0.1,0.066871,0,0,0,0
2897,,,tbzlvrz,0,2,2,0,3,3,0,0,1,1,1,0
2898,,,sacredguitarANR,0,1,1,0,1,1,0,0,1,1,1,0
2899,,,amcneer,0,3,3,0,3,3,0,0,1,1,1,0
2900,,,Park_Journey,1,1,2,1,1,2,0,0.006687,0,0,0,0
2901,,,Matt_NBC4,4,1,5,5,2,7,0.25,0.026749,0,0,0,0
2902,,,drmom01,0,1,1,0,1,1,0,0,2,0.666667,0.75,0
2903,,,1004onIine,2,1,3,2,1,3,0.5,0.013374,0,0,0,0
2904,,,tuunfuegokyle,4,1,5,4,1,5,0.25,0.030243,0,0,0,0
2905,,,minhyun54,0,1,1,0,1,1,0,0,1,1,1,0
2906,,,Komei365TKO,1,3,4,2,4,6,0.333333,0.006687,1,1,1,0
2907,,,garouneko,0,2,2,0,2,2,0,0,3,0.555556,0.666667,0
2908,,,chenstoppable,1,1,2,1,1,2,0,0.006687,0,0,0,0
2909,,,infinitegraces,1,1,2,1,1,2,0,0.006687,0,0,0,0
2910,,,ihayleymills,1,1,2,1,1,2,0,0.006687,0,0,0,0
2911,,,hobkook,1,1,2,1,1,2,0,0.006687,0,0,0,0
2912,,,simplybellamy,1,1,2,1,1,2,0,0.006687,0,0,0,0
2913,,,dhrxsol1234,3,1,4,3,1,4,0.333333,0.020061,0,0,0,0
2914,,,dannyac30,0,1,1,0,1,1,0,0,1,1,1,0
2915,,,scott_squires,0,1,1,0,1,1,0,0,1,1,1,0
2916,,,julianspivey44,3,1,4,3,1,4,0.333333,0.020061,0,0,0,0
2917,,,MariGIN25,0,4,4,0,4,4,0,0,1,1,1,0
2918,,,erharder,2,1,3,2,1,3,0.5,0.013374,0,0,0,0
2919,,,LearnUSAhistory,4,1,5,4,1,5,0.25,0.026749,0,0,0,0
2920,,,atc295,0,1,1,0,1,1,0,0,1,1,1,0
2921,,,MoxCrew2021,0,2,2,0,2,2,0,0,1,1,1,0
2922,,,kateskates94,1,2,3,3,4,7,0.5,0.006687,1,1,1,0
2923,,,lavienrosefbs,2,1,3,2,1,3,0.5,0.013374,0,0,0,0
2924,,,ponytail122,0,1,1,0,1,1,0,0,1,1,1,0
2925,,,koriyashiki,0,1,1,0,1,1,0,0,1,1,1,0
2926,,,Merynhorsepower,0,3,3,0,4,4,0,0,1,1,1,0
2927,,,will385,3,1,4,8,1,9,0.333333,0.020061,0,0,0,0
2928,,,Emily65026057,0,1,1,0,5,5,0,0,1,1,1,0
2929,,,itachisballs,2,1,3,2,1,3,0.5,0.013374,0,0,0,0
2930,,,hinamarukosan1,0,1,1,0,1,1,0,0,1,1,1,0
2931,,,SehunBxG_,9,1,10,9,1,10,0.111111,0.060184,0,0,0,0
2932,,,CindyPhyillaier,0,1,1,0,1,1,0,0,1,1,1,0
2933,,,Ryk003,0,1,1,0,1,1,0,0,1,1,1,0
2934,,,writerofpoetry,0,1,1,0,1,1,0,0,1,1,1,0
2935,,,coldbrewins,2,1,3,3,2,5,0.5,0.013374,0,0,0,0
2936,,,heymeeuhh,1,1,2,1,1,2,0,0.006687,0,0,0,0
2937,,,HillBeverlyhill,3,1,4,3,1,4,0.333333,0.020061,0,0,0,0
2938,,,ruruah10,0,1,1,0,1,1,0,0,1,1,1,0
2939,,,murasakino_o,0,1,1,0,1,1,0,0,1,1,1,0
2940,,,Gondolier9,0,1,1,0,1,1,0,0,1,1,1,0
2941,,,bobaisbest,2,1,3,2,1,3,0.5,0.013374,0,0,0,0
2942,,,gfbp1998,0,1,1,0,1,1,0,0,1,1,1,0
2943,,,DoctorMom14,2,2,4,2,2,4,0.333333,0.013374,1,1,1,1
2944,,,ZpwfOUIdtt1vsh4,0,1,1,0,1,1,0,0,2,0.666667,0.75,0
2945,,,Lindseyhisk,1,1,2,1,1,2,0,0.006687,0,0,0,0
2946,,,benevelynce,6,1,7,7,2,9,0.166667,0.138984,0,0,0,0
2947,,,kame_kichi77,0,2,2,0,2,2,0,0,1,1,1,0
2948,,,25NewsKXXV,1,1,2,1,1,2,0,0.006687,0,0,0,0
2949,,,JustaHellsite,0,1,1,0,1,1,0,0,1,1,1,0
2950,,,elise_mcshick,0,1,1,0,1,1,0,0,1,1,1,0
2951,,,yritto,0,1,1,0,1,1,0,0,1,1,1,0
2952,,,garugar76030850,3,1,4,3,1,4,0.333333,0.020061,0,0,0,0
2953,,,iro12_ruka,0,1,1,0,1,1,0,0,1,1,1,0
2954,,,shartgang,1,1,2,1,1,2,0,0.006687,0,0,0,0
2955,,,ChlosterSays,4,1,5,4,1,5,0.25,0.026749,0,0,0,0
2956,,,aabaker_amy,0,1,1,0,1,1,0,0,1,1,1,0
2957,,,solarsisotoma,4,1,5,4,1,5,0.25,0.029476,0,0,0,0
2958,,,Moonriv58643657,0,1,1,0,1,1,0,0,1,1,1,0
2959,,,gaiastellar,0,3,3,0,3,3,0,0,3,0.6,0.722222,0
2960,,,Xaturdeii,8,1,9,8,1,9,0.125,0.053497,0,0,0,0
2961,,,dsolsen731,0,1,1,0,1,1,0,0,1,1,1,0
2962,,,jer0319,0,1,1,0,1,1,0,0,1,1,1,0
2963,,,hibarino2,0,2,2,0,2,2,0,0,1,1,1,0
2964,,,Erdbeere_y,0,2,2,0,2,2,0,0,1,1,1,0
2965,,,Zhu2009Zhu,0,1,1,0,1,1,0,0,1,1,1,0
2966,,,penphoe,4,1,5,4,1,5,0.25,0.026749,0,0,0,0
2967,,,DAEPHOBIA,0,1,1,0,1,1,0,0,1,1,1,0
2968,,,HsiaoPangQ,0,1,1,0,1,1,0,0,1,1,1,0
2969,,,Makaha88,0,1,1,0,1,1,0,0,1,1,1,0
2970,,,linepoo55,0,1,1,0,1,1,0,0,2,0.666667,0.75,0
2971,,,m_i1209_,0,1,1,0,1,1,0,0,2,0.666667,0.75,0
2972,,,diornaras,4,1,5,4,1,5,0.25,0.026749,0,0,0,0
2973,,,kemi14316,0,1,1,0,1,1,0,0,1,1,1,0
2974,,,NancyHartnett1,0,1,1,0,1,1,0,0,1,1,1,0
2975,,,sugurubot,9,1,10,9,1,10,0.111111,0.063679,0,0,0,0
2976,,,Rishiscribe,0,1,1,0,1,1,0,0,1,1,1,0
2977,,,vKjnaqDXzn4znOC,0,1,1,0,1,1,0,0,1,1,1,0
2978,,,LeidaPaleo,0,2,2,0,2,2,0,0,1,1,1,0
2979,,,XinjXiaoyun007,0,1,1,0,1,1,0,0,1,1,1,0
2980,,,CJsSayingIt,0,1,1,0,1,1,0,0,1,1,1,0
2981,,,CherieLampley,4,1,5,4,1,5,0.25,0.026749,0,0,0,0
2982,,,JackieJ00901530,0,1,1,0,1,1,0,0,1,1,1,0
2983,,,alu23679750,0,1,1,0,1,1,0,0,1,1,1,0
2984,,,hohoho_1003,0,1,1,0,1,1,0,0,1,1,1,0
2985,,,thegreatbeanz,2,1,3,2,1,3,0.5,0.013374,0,0,0,0
2986,,,ChanteGato,0,1,1,0,1,1,0,0,1,1,1,0
2987,,,randrcits,0,2,2,0,2,2,0,0,1,1,1,0
2988,,,eriwski,0,1,1,0,1,1,0,0,1,1,1,0
2989,,,iceominous,6,1,7,6,1,7,0.166667,0.040123,0,0,0,0
2990,,,arroblue,0,1,1,0,1,1,0,0,1,1,1,0
2991,,,kozasa_maon,0,1,1,0,1,1,0,0,1,1,1,0
2992,,,negisobaaan,0,2,2,0,2,2,0,0,1,1,1,0
2993,,,frankfurtsu,1,1,2,1,1,2,0,0.006687,0,0,0,0
2994,,,purplearashi,0,1,1,0,1,1,0,0,1,1,1,0
2995,,,kisscry1217,0,2,2,0,2,2,0,0,1,1,1,0
2996,,,ume_kazumi,0,1,1,0,1,1,0,0,1,1,1,0
2997,,,gsfd57,0,1,1,0,1,1,0,0,1,1,1,0
2998,,,Yukie_tabiwo,0,2,2,0,2,2,0,0,1,1,1,0
2999,,,keikitosk8,0,2,2,0,2,2,0,0,1,1,1,0
3000,,,yukoh777,0,1,1,0,1,1,0,0,1,1,1,0
3001,,,rukikusogame,0,1,1,0,1,1,0,0,1,1,1,0
3002,,,prima_rose,0,1,1,0,1,1,0,0,1,1,1,0
3003,,,So_meow,0,1,1,0,1,1,0,0,1,1,1,0
3004,,,yomoginomimi64,0,1,1,0,1,1,0,0,1,1,1,0
3005,,,Tam_Aki_fs,0,1,1,0,1,1,0,0,1,1,1,0
3006,,,jenniecerrito,0,1,1,0,1,1,0,0,1,1,1,0
3007,,,vegamu23,0,1,1,0,1,1,0,0,1,1,1,0
3008,,,ubik69az,0,1,1,0,1,1,0,0,1,1,1,0
3009,,,loulou01720,19,1,20,19,1,20,0.052632,0.148021,0,0,0,0
3010,,,momo_tarou_5,0,1,1,0,1,1,0,0,1,1,1,0
3011,,,yukinoshinshu,0,1,1,0,1,1,0,0,1,1,1,0
3012,,,KellyGlitzel,0,1,1,0,1,1,0,0,1,1,1,0
3013,,,aoi_2013,0,1,1,0,1,1,0,0,1,1,1,0
3014,,,Balette51k,0,1,1,0,1,1,0,0,1,1,1,0
3015,,,Stubby0207,0,1,1,0,1,1,0,0,1,1,1,0
3016,,,piyo551shoma,0,3,3,0,3,3,0,0,2,0.714286,0.8,0
3017,,,sunagimo_mylove,0,1,1,0,1,1,0,0,1,1,1,0
3018,,,addicted_to_mao,0,2,2,0,2,2,0,0,1,1,1,0
3019,,,CanoninDhana,0,1,1,0,1,1,0,0,1,1,1,0
3020,,,mrmd7,0,1,1,0,1,1,0,0,1,1,1,0
3021,,,ridonme,0,1,1,0,1,1,0,0,1,1,1,0
3022,,,medochanteam,0,1,1,0,1,1,0,0,1,1,1,0
3023,,,thatonekimgirl,6,2,8,9,5,14,0.142857,0.040123,1,1,1,5
3024,,,Chelle1917,0,1,1,0,1,1,0,0,1,1,1,0
3025,,,ladydyla_,11,1,12,11,1,12,0.090909,0.073559,0,0,0,0
3026,,,FXroomAJ,0,1,1,0,1,1,0,0,1,1,1,0
3027,,,yzmo0725,0,1,1,0,1,1,0,0,1,1,1,0
3028,,,wata_momo,0,1,1,0,1,1,0,0,1,1,1,0
3029,,,Jazzykero802484,0,1,1,0,1,1,0,0,1,1,1,0
3030,,,Lilac_d1sk,0,1,1,0,1,1,0,0,1,1,1,0
3031,,,maiorana473,22,1,23,22,1,23,0.045455,0.178831,0,0,0,0
3032,,,tamanijina,0,6,6,0,6,6,0,0,1,1,1,0
3033,,,5shiki_RURI,0,2,2,0,2,2,0,0,1,1,1,0
3034,,,He_is_frank,0,3,3,0,3,3,0,0,1,1,1,0
3035,,,HQPmpfwBjByw3ve,0,3,3,0,3,3,0,0,2,0.8,0.875,0
3036,,,BorderCosette,1,3,4,1,3,4,0.333333,0.006687,1,1,1,0
3037,,,inside__edge,0,3,3,0,3,3,0,0,1,1,1,0
3038,,,4520ishito_4F3T,0,3,3,0,3,3,0,0,1,1,1,0
3039,,,marinco_fs,0,1,1,0,1,1,0,0,1,1,1,0
3040,,,taiwanreporter,0,1,1,0,1,1,0,0,1,1,1,0
3041,,,kovko2011Linux,0,1,1,0,1,1,0,0,1,1,1,0
3042,,,rosenfieldclar1,0,1,1,0,1,1,0,0,1,1,1,0
3043,,,goldenskate,4,1,5,4,1,5,0.25,0.040385,0,0,0,0
3044,,,KiritoKung,4,2,6,4,2,6,0,0.01584,1,1,1,8
3045,,,Hirakky4,0,1,1,0,1,1,0,0,1,1,1,0
3046,,,MandyTTCarr,1,1,2,1,1,2,0,0.006687,0,0,0,0
3047,,,chromatixa,4,1,5,5,2,7,0.25,0.026749,0,0,0,0
3048,,,notthefantadoor,1,1,2,1,1,2,0,0.006687,0,0,0,0
3049,,,ErinSandersNP,1,1,2,1,1,2,0,0.006687,0,0,0,0
3050,,,ShaunB98,1,1,2,1,1,2,0,0.006687,0,0,0,0
3051,,,cenisabelphoto,1,1,2,1,1,2,0,0.006687,0,0,0,0
3052,,,easyfindasia,2,1,3,2,1,3,0.5,0.013374,0,0,0,0
3053,,,weareinthefire,0,1,1,0,1,1,0,0,1,1,1,0
3054,,,mamacat18,3,1,4,4,2,6,0.333333,0.020061,0,0,0,0
3055,,,skate_4T3T,0,1,1,0,1,1,0,0,1,1,1,0
3056,,,rubydelta6,0,2,2,0,2,2,0,0,1,1,1,0
3057,,,Dennis_in_Cali,3,1,4,3,1,4,0.333333,0.020061,0,0,0,0
3058,,,PolyVinci,0,1,1,0,1,1,0,0,1,1,1,0
3059,,,AngelaAbbyAmy,1,1,2,1,1,2,0,0.006687,0,0,0,0
3060,,,pkeegs,1,1,2,1,1,2,0,0.006687,0,0,0,0
3061,,,linjack88,2,1,3,3,2,5,0.5,0.013374,0,0,0,0
3062,,,CaNative,0,1,1,0,1,1,0,0,1,1,1,0
3063,,,SahilRa85851177,1,1,2,1,1,2,0,0.006687,0,0,0,0
3064,,,Debsam1760,1,1,2,1,1,2,0,0.006687,0,0,0,0
3065,,,ArtVilmos,1,1,2,1,1,2,0,0.006687,0,0,0,0
3066,,,Katelyncko,4,1,5,4,1,5,0.25,0.026749,0,0,0,0
3067,,,nanamiscockslut,0,1,1,0,1,1,0,0,1,1,1,0
3068,,,gerphan,0,1,1,0,1,1,0,0,1,1,1,0
3069,,,Apple236734,0,1,1,0,1,1,0,0,1,1,1,0
3070,,,mainrocknews_,3,1,4,3,1,4,0.333333,0.020061,0,0,0,0
3071,,,lvtobehpy,0,1,1,0,1,1,0,0,1,1,1,0
3072,,,llgeb3,2,2,4,2,2,4,0.5,0.013374,5,0.43662,0.474194,0
3073,,,AWorldOutOfMind,0,1,1,0,1,1,0,0,1,1,1,0
3074,,,taezwrId,1,1,2,1,1,2,0,0.006687,0,0,0,0
3075,,,TakeTheFlagBack,1,1,2,1,1,2,0,0.006687,0,0,0,0
3076,,,def181814,3,1,4,3,1,4,0.333333,0.023556,0,0,0,0
3077,,,bling_bangtan,25,1,26,32,8,40,0.04,0.289359,0,0,0,0
3078,,,Awesome_Bidoof,2,1,3,2,1,3,0.5,0.013374,0,0,0,0
3079,,,CHINA__GOOD,0,1,1,0,1,1,0,0,1,1,1,0
3080,,,gaymeralbedo,1,1,2,1,1,2,0,0.006687,0,0,0,0
3081,,,sickgirlisms,3,1,4,3,1,4,0.333333,0.020061,0,0,0,0
3082,,,mikeaubrey2,0,1,1,0,1,1,0,0,1,1,1,0
3083,,,shift_in2_turbo,0,1,1,0,1,1,0,0,1,1,1,0
3084,,,k_enzie_dreomma,1,1,2,1,1,2,0,0.006687,0,0,0,0
3085,,,nateselden,7,1,8,7,1,8,0.142857,0.050304,0,0,0,0
3086,,,receiptmaven,0,1,1,0,1,1,0,0,1,1,1,0
3087,,,mary_s_ingraham,0,1,1,0,1,1,0,0,1,1,1,0
3088,,,i7f_t,0,1,1,0,1,1,0,0,1,1,1,0
3089,,,kyrapractor,5,1,6,5,1,6,0.2,0.033436,0,0,0,0
3090,,,Samsworth_KSL,0,1,1,0,1,1,0,0,1,1,1,0
3091,,,ash_has_ideas,0,1,1,0,1,1,0,0,1,1,1,0
3092,,,mike71914654,0,1,1,0,1,1,0,0,1,1,1,0
3093,,,JJSportsBeat,0,1,1,0,1,1,0,0,1,1,1,0
3094,,,MyshellebelleMy,0,2,2,0,2,2,0,0,1,1,1,0
3095,,,SAL_1207,0,1,1,0,1,1,0,0,1,1,1,0
3096,,,Grlscout13,0,2,2,0,2,2,0,0,1,1,1,0
3097,,,billie_ski,0,2,2,0,2,2,0,0,2,0.666667,0.75,0
3098,,,siimplyjar,1,1,2,1,1,2,0,0.006687,0,0,0,0
3099,,,MaryWanna13,2,1,3,2,1,3,0.5,0.013374,0,0,0,0
3100,,,NYPostOpinion,1,1,2,1,1,2,0,0.006687,0,0,0,0
3101,,,mrbigg425,3,1,4,3,1,4,0.333333,0.020061,0,0,0,0
3102,,,annyeong__127,0,1,1,0,1,1,0,0,1,1,1,0
3103,,,lvrchois,0,1,1,0,1,1,0,0,1,1,1,0
3104,,,dragonflytdh,1,1,2,1,1,2,0,0.006687,0,0,0,0
3105,,,ysysys32469770,0,1,1,0,1,1,0,0,1,1,1,0
3106,,,Majooo291,0,2,2,0,2,2,0,0,1,1,1,0
3107,,,ChoudharyLab,0,1,1,0,1,1,0,0,1,1,1,0
3108,,,jonaatwt,0,1,1,0,1,1,0,0,1,1,1,0
3109,,,FangirlAaya,0,1,1,0,1,1,0,0,1,1,1,0
3110,,,Bob_Stinson1234,0,1,1,0,1,1,0,0,1,1,1,0
3111,,,peterfilcms,2,1,3,2,1,3,0.5,0.013374,0,0,0,0
3112,,,campball1900,0,1,1,0,1,1,0,0,1,1,1,0
3113,,,GoRixter,3,1,4,3,1,4,0.333333,0.020061,0,0,0,0
3114,,,JBxxoxx,0,2,2,0,2,2,0,0,1,1,1,0
3115,,,CoffeeShopBlogg,0,1,1,0,1,1,0,0,1,1,1,0
3116,,,pinkkyooni,2,1,3,2,1,3,0.5,0.030845,0,0,0,0
3117,,,KeithMcCord,0,1,1,0,1,1,0,0,2,0.571429,0.625,0
3118,,,jaeyunsquish,3,1,4,3,1,4,0.333333,0.020061,0,0,0,0
3119,,,fadli_tamam,0,3,3,0,3,3,0,0,1,1,1,0
3120,,,thomwinter,1,1,2,1,1,2,0,0.006687,0,0,0,0
3121,,,maine_witch,1,1,2,1,1,2,0,0.006687,0,0,0,0
3122,,,namjoonunism,1,1,2,1,1,2,0,0.006687,0,0,0,0
3123,,,mnflwr___,2,1,3,2,1,3,0.5,0.013374,0,0,0,0
3124,,,johnburnshk,0,1,1,0,1,1,0,0,1,1,1,0
3125,,,kikipomu,1,1,2,1,1,2,0,0.006687,0,0,0,0
3126,,,Music_Girl_99,1,1,2,1,1,2,0,0.006687,0,0,0,0
3127,,,yeolmaex,1,1,2,1,1,2,0,0.006687,0,0,0,0
3128,,,lleyvajr,0,1,1,0,1,1,0,0,1,1,1,0
3129,,,jennynas888,2,1,3,2,1,3,0.5,0.013374,0,0,0,0
3130,,,Valerie49981298,0,1,1,0,1,1,0,0,1,1,1,0
3131,,,FirebaughNorman,1,1,2,1,1,2,0,0.006687,0,0,0,0
3132,,,chiman321,3,1,4,3,1,4,0.333333,0.037533,0,0,0,0
3133,,,biantaishabi,0,1,1,0,1,1,0,0,1,1,1,0
3134,,,tbzEXlD,1,1,2,1,1,2,0,0.006687,0,0,0,0
3135,,,neckwearr,3,1,4,3,1,4,0.333333,0.020061,0,0,0,0
3136,,,Haertsvale,0,1,1,0,1,1,0,0,1,1,1,0
3137,,,RCC2206,1,1,2,1,1,2,0,0.006687,0,0,0,0
3138,,,daicing,1,1,2,1,1,2,0,0.006687,0,0,0,0
3139,,,gavilicious_,3,1,4,3,1,4,0.333333,0.020061,0,0,0,0
3140,,,Debbiemom,0,1,1,0,1,1,0,0,1,1,1,0
3141,,,aimeelafountain,2,1,3,2,1,3,0.5,0.013374,0,0,0,0
3142,,,sesoolay,0,1,1,0,1,1,0,0,1,1,1,0
3143,,,JConabicycle,1,1,2,1,1,2,0,0.006687,0,0,0,0
3144,,,upsetcitizyn,2,1,3,2,1,3,0.5,0.013374,0,0,0,0
3145,,,CMilanian,0,1,1,0,1,1,0,0,1,1,1,0
3146,,,areumdaunviews,6,1,7,6,1,7,0.166667,0.040123,0,0,0,0
3147,,,girlfromoz1,0,1,1,0,1,1,0,0,1,1,1,0
3148,,,dan_kelly100,0,1,1,0,1,1,0,0,1,1,1,0
3149,,,kyo_0228,0,4,4,0,4,4,0,0,1,1,1,0
3150,,,ChronoStutter,0,1,1,0,1,1,0,0,1,1,1,0
3151,,,014_yol,0,1,1,0,1,1,0,0,1,1,1,0
3152,,,VAP0URWAYV,1,1,2,1,1,2,0,0.006687,0,0,0,0
3153,,,Lucy84701330,2,1,3,2,1,3,0.5,0.013374,0,0,0,0
3154,,,wanggd,0,1,1,0,1,1,0,0,1,1,1,0
3155,,,Tennisteacher2,3,1,4,3,1,4,0.333333,0.020061,0,0,0,0
3156,,,JodiPiercey,0,1,1,0,1,1,0,0,1,1,1,0
3157,,,Pielover471,0,1,1,0,1,1,0,0,1,1,1,0
3158,,,azurelunatic,1,1,2,1,1,2,0,0.006687,0,0,0,0
3159,,,MarthaP29033882,1,1,2,1,1,2,0,0.006687,0,0,0,0
3160,,,ayayaya0522,0,2,2,0,2,2,0,0,1,1,1,0
3161,,,MaryWieden,1,1,2,1,1,2,0,0.006687,0,0,0,0
3162,,,sehof,5,1,6,5,1,6,0.2,0.033436,0,0,0,0
3163,,,akestep2,0,1,1,0,1,1,0,0,1,1,1,0
3164,,,zmt021,0,1,1,0,1,1,0,0,1,1,1,0
3165,,,igudlun,0,1,1,0,1,1,0,0,1,1,1,0
3166,,,316alco,6,1,7,7,2,9,0.166667,0.040123,0,0,0,0
3167,,,paulagent,0,1,1,0,1,1,0,0,1,1,1,0
3168,,,chungakabasil,0,1,1,0,1,1,0,0,1,1,1,0
3169,,,hi_lindaaa,0,1,1,0,1,1,0,0,1,1,1,0
3170,,,ejnews0,3,1,4,3,1,4,0.333333,0.037533,0,0,0,0
3171,,,PissedoffPatr15,0,1,1,0,1,1,0,0,1,1,1,0
3172,,,duzkiez,5,1,6,5,1,6,0.2,0.050907,0,0,0,0
3173,,,jin_kook01,0,1,1,0,1,1,0,0,1,1,1,0
3174,,,Louisalin8,0,1,1,0,1,1,0,0,1,1,1,0
3175,,,bachongyingsama,0,1,1,0,1,1,0,0,1,1,1,0
3176,,,RealTruthNotLie,14,1,15,15,2,17,0.071429,0.09362,0,0,0,0
3177,,,jezuswaskocha,0,1,1,0,1,1,0,0,1,1,1,0
3178,,,shenshow1,0,1,1,0,1,1,0,0,1,1,1,0
3179,,,Barry294718191,0,1,1,0,1,1,0,0,1,1,1,0
3180,,,BuzzFeed,2,1,3,2,1,3,0.5,0.013374,0,0,0,0
3181,,,czajldster,0,1,1,0,1,1,0,0,1,1,1,0
3182,,,skocznykielek,1,1,2,1,1,2,0,0.006687,0,0,0,0
3183,,,woe_is_matty,1,1,2,1,1,2,0,0.006687,0,0,0,0
3184,,,sdgillespie,2,1,3,2,1,3,0.5,0.013374,0,0,0,0
3185,,,cin6i,0,1,1,0,1,1,0,0,1,1,1,0
3186,,,gymandwhizz,0,3,3,0,3,3,0,0,1,1,1,0
3187,,,Dominik_W_,0,1,1,0,1,1,0,0,1,1,1,0
3188,,,Shawnyqueer,0,2,2,0,2,2,0,0,1,1,1,0
3189,,,anotherfangiul,0,2,2,0,2,2,0,0,1,1,1,0
3190,,,xmb0707,0,2,2,0,2,2,0,0,1,1,1,0
3191,,,natalie64247982,0,1,1,0,1,1,0,0,1,1,1,0
3192,,,charheb11,0,1,1,0,1,1,0,0,1,1,1,0
3193,,,aislibrarians,0,1,1,0,1,1,0,0,1,1,1,0
3194,,,Jaelliefish,0,1,1,0,1,1,0,0,1,1,1,0
3195,,,LadybugKae,0,3,3,0,3,3,0,0,1,1,1,0
3196,,,jkIuvr69,4,1,5,5,2,7,0.25,0.026749,0,0,0,0
3197,,,yunalesadios,0,1,1,0,1,1,0,0,1,1,1,0
3198,,,cornumollu,0,2,2,0,2,2,0,0,1,1,1,0
3199,,,MsCatThief,2,1,3,2,1,3,0.5,0.013374,0,0,0,0
3200,,,mayhugs,2,1,3,3,2,5,0.5,0.013374,0,0,0,0
3201,,,jinsoulsvoice,2,1,3,2,1,3,0.5,0.013374,0,0,0,0
3202,,,sigua81599694,0,1,1,0,1,1,0,0,1,1,1,0
3203,,,Chickadee8833,5,1,6,5,1,6,0.2,0.047413,0,0,0,0
3204,,,teauh2,0,1,1,0,1,1,0,0,1,1,1,0
3205,,,_serendipromise,0,1,1,0,1,1,0,0,1,1,1,0
3206,,,ABC10,3,1,4,3,1,4,0.333333,0.020061,0,0,0,0
3207,,,SpookyLambo,0,1,1,0,1,1,0,0,1,1,1,0
3208,,,JamesBu47462513,3,1,4,3,1,4,0.333333,0.020061,0,0,0,0
3209,,,mirihan2021,0,1,1,0,1,1,0,0,1,1,1,0
3210,,,nathbranda,0,1,1,0,1,1,0,0,1,1,1,0
3211,,,ShinyCelebi15,1,1,2,1,1,2,0,0.006687,0,0,0,0
3212,,,kaz2740,3,1,4,3,1,4,0.333333,0.020061,0,0,0,0
3213,,,kurt_rustem,0,1,1,0,1,1,0,0,1,1,1,0
3214,,,jmescoda,0,1,1,0,1,1,0,0,1,1,1,0
3215,,,SarahB1863,3,1,4,3,1,4,0.333333,0.020061,0,0,0,0
3216,,,JessieAK3,0,1,1,0,1,1,0,0,1,1,1,0
3217,,,jeremyb04301,0,1,1,0,1,1,0,0,1,1,1,0
3218,,,casual_neet,0,1,1,0,1,1,0,0,1,1,1,0
3219,,,LeeMi94,0,1,1,0,1,1,0,0,1,1,1,0
3220,,,kajyu68,0,1,1,0,1,1,0,0,1,1,1,0
3221,,,thescytheisdull,0,2,2,0,2,2,0,0,1,1,1,0
3222,,,jackhutton,1,2,3,1,2,3,0.5,0.006687,1,1,1,0
3223,,,macmachado57,0,1,1,0,1,1,0,0,1,1,1,0
3224,,,gloria_sin,4,2,6,5,3,8,0.2,0.026749,1,1,1,3
3225,,,Julia4Freedom,0,1,1,0,1,1,0,0,2,0.666667,0.75,0
3226,,,JA3HYUNO,2,1,3,2,1,3,0.5,0.013374,0,0,0,0
3227,,,Miss_coquito,0,4,4,0,4,4,0,0,2,0.666667,0.75,0
3228,,,Ileanainbliss,3,1,4,3,1,4,0.333333,0.034038,0,0,0,0
3229,,,praninlove14,0,1,1,0,1,1,0,0,1,1,1,0
3230,,,MicheleL_21,1,1,2,1,1,2,0,0.006687,0,0,0,0
3231,,,HennesseyRcaf,0,1,1,0,1,1,0,0,1,1,1,0
3232,,,margaretdunning,0,1,1,0,1,1,0,0,1,1,1,0
3233,,,BJ_Greber,0,1,1,0,1,1,0,0,1,1,1,0
3234,,,MickeyAtwal,0,1,1,0,1,1,0,0,1,1,1,0
3235,,,lovelyboyjjk,0,1,1,0,1,1,0,0,1,1,1,0
3236,,,SkyNewsAust,1,1,2,1,1,2,0,0.006687,0,0,0,0
3237,,,rosydaisies,1,1,2,1,1,2,0,0.006687,0,0,0,0
3238,,,GusfordG,1,1,2,1,1,2,0,0.006687,0,0,0,0
3239,,,Briefing__Room,3,1,4,3,1,4,0.333333,0.020061,0,0,0,0
3240,,,DhonesSantos1,0,1,1,0,1,1,0,0,1,1,1,0
3241,,,jhdcate,0,1,1,0,1,1,0,0,1,1,1,0
3242,,,hotincleveland,1,1,2,1,1,2,0,0.006687,0,0,0,0
3243,,,RealKathJL,1,1,2,1,1,2,0,0.006687,0,0,0,0
3244,,,Delonjo2,1,1,2,1,1,2,0,0.006687,0,0,0,0
3245,,,ausheadlinebot,4,1,5,5,2,7,0.25,0.026749,0,0,0,0
3246,,,tres444,0,1,1,0,1,1,0,0,1,1,1,0
3247,,,DonahueSusanna,0,1,1,0,1,1,0,0,1,1,1,0
3248,,,TeamEconReport,0,1,1,0,1,1,0,0,1,1,1,0
3249,,,WhatQueerIsThis,1,1,2,1,1,2,0,0.006687,0,0,0,0
3250,,,starofpaints,1,1,2,1,1,2,0,0.006687,0,0,0,0
3251,,,bloodyhyune,1,1,2,1,1,2,0,0.006687,0,0,0,0
3252,,,MoonPrismNat,3,1,4,3,1,4,0.333333,0.020061,0,0,0,0
3253,,,scvega40,0,1,1,0,1,1,0,0,1,1,1,0
3254,,,alex65mjhr,0,1,1,0,1,1,0,0,1,1,1,0
3255,,,1oserjk,3,1,4,3,1,4,0.333333,0.020061,0,0,0,0
3256,,,bigtittyjesus42,0,1,1,0,1,1,0,0,1,1,1,0
3257,,,fear2bunny,0,1,1,0,1,1,0,0,1,1,1,0
3258,,,quixoticblazes,1,1,2,1,1,2,0,0.006687,0,0,0,0
3259,,,PV1nc3,1,1,2,1,1,2,0,0.006687,0,0,0,0
3260,,,kittybravofan,1,1,2,1,1,2,0,0.006687,0,0,0,0
3261,,,StarStudmuffin,1,1,2,1,1,2,0,0.006687,0,0,0,0
3262,,,Defsoulian,2,1,3,2,1,3,0.5,0.013374,0,0,0,0
3263,,,hafumatikyu,0,1,1,0,1,1,0,0,1,1,1,0
3264,,,bjyx2026,0,1,1,0,1,1,0,0,1,1,1,0
3265,,,JohnnyBravoNYC,0,1,1,0,1,1,0,0,1,1,1,0
3266,,,Tmbrdly1964Tom,1,1,2,1,1,2,0,0.006687,0,0,0,0
3267,,,Marina_Emmzz,8,1,9,9,2,11,0.125,0.053497,0,0,0,0
3268,,,amelia_bedelia,0,1,1,0,1,1,0,0,1,1,1,0
3269,,,i7O1Q9IB2EEbyVN,0,1,1,0,1,1,0,0,1,1,1,0
3270,,,LapsonLuu,0,1,1,0,1,1,0,0,1,1,1,0
3271,,,JackFould,0,1,1,0,1,1,0,0,1,1,1,0
3272,,,JLe851,1,1,2,1,1,2,0,0.006687,0,0,0,0
3273,,,prairielive,1,1,2,1,1,2,0,0.006687,0,0,0,0
3274,,,holywell_john,1,1,2,1,1,2,0,0.006687,0,0,0,0
3275,,,USmile2022,0,3,3,0,3,3,0,0,1,1,1,0
3276,,,nathanhoang,1,1,2,1,1,2,0,0.006687,0,0,0,0
3277,,,LuisaFerAF,3,1,4,3,1,4,0.333333,0.020061,0,0,0,0
3278,,,TammyCo07309669,0,1,1,0,1,1,0,0,1,1,1,0
3279,,,CSA1776,1,1,2,1,1,2,0,0.006687,0,0,0,0
3280,,,_sailingskies,0,1,1,0,1,1,0,0,1,1,1,0
3281,,,72414_8,4,1,5,4,1,5,0.25,0.026749,0,0,0,0
3282,,,TapoFilms,0,1,1,0,1,1,0,0,1,1,1,0
3283,,,Michael19621962,1,1,2,1,1,2,0,0.006687,0,0,0,0
3284,,,CitizenSE,6,1,7,6,1,7,0.166667,0.040123,0,0,0,0
3285,,,noybsk2017,0,1,1,0,1,1,0,0,1,1,1,0
3286,,,ebf10010,0,1,1,0,1,1,0,0,1,1,1,0
3287,,,slytherindork,0,1,1,0,1,1,0,0,1,1,1,0
3288,,,RohanPuggies,0,1,1,0,1,1,0,0,1,1,1,0
3289,,,dougchia,2,1,3,2,1,3,0.5,0.013374,0,0,0,0
3290,,,monkinsane,0,1,1,0,1,1,0,0,1,1,1,0
3291,,,ToyotaWV,3,1,4,3,1,4,0.333333,0.020061,0,0,0,0
3292,,,stoutyhk,0,1,1,0,1,1,0,0,1,1,1,0
3293,,,Ditchdigger51,0,1,1,0,1,1,0,0,1,1,1,0
3294,,,iharuyos,1,1,2,1,1,2,0,0.006687,0,0,0,0
3295,,,yanglillyy,9,1,10,11,2,13,0.111111,0.067173,0,0,0,0
3296,,,trickyuk1,0,1,1,0,1,1,0,0,1,1,1,0
3297,,,_stationviews,0,1,1,0,1,1,0,0,1,1,1,0
3298,,,nicholas_cussen,0,3,3,0,3,3,0,0,1,1,1,0
3299,,,DixieRebelBelle,4,1,5,4,1,5,0.25,0.026749,0,0,0,0
3300,,,GreenMonsterah,0,1,1,0,1,1,0,0,1,1,1,0
3301,,,massa_cristiane,0,2,2,0,2,2,0,0,1,1,1,0
3302,,,viejomiguelito1,0,1,1,0,1,1,0,0,1,1,1,0
3303,,,LanceB65,2,1,3,2,1,3,0.5,0.013374,0,0,0,0
3304,,,KinniskaMakes,0,1,1,0,1,1,0,0,1,1,1,0
3305,,,becca_kate_,1,1,2,1,1,2,0,0.006687,0,0,0,0
3306,,,taehyunqtears,0,1,1,0,1,1,0,0,1,1,1,0
3307,,,purpleH2Oski,3,1,4,3,1,4,0.333333,0.020061,0,0,0,0
3308,,,RonnyWells,0,1,1,0,1,1,0,0,1,1,1,0
3309,,,vegankaos,0,1,1,0,1,1,0,0,1,1,1,0
3310,,,ReporterCurious,4,1,5,4,1,5,0.25,0.026749,0,0,0,0
3311,,,wolfs_bite,0,1,1,0,1,1,0,0,1,1,1,0
3312,,,triketora,0,2,2,0,2,2,0,0,1,1,1,0
3313,,,JodieI13,0,1,1,0,1,1,0,0,1,1,1,0
3314,,,CrankitLoud,0,1,1,0,1,1,0,0,1,1,1,0
3315,,,1776Independent,2,1,3,2,1,3,0.5,0.013374,0,0,0,0
3316,,,stenar,0,1,1,0,1,1,0,0,1,1,1,0
3317,,,DennisSpain19,6,1,7,6,1,7,0.166667,0.04285,0,0,0,0
3318,,,mixiaopangmama,0,1,1,0,1,1,0,0,1,1,1,0
3319,,,kdrzmas,1,1,2,1,1,2,0,0.00396,1,1,1,1
3320,,,hounderbounder,0,1,1,0,1,1,0,0,1,1,1,0
3321,,,kweintraub,0,1,1,0,1,1,0,0,1,1,1,0
3322,,,pamchenko_twist,0,1,1,0,1,1,0,0,1,1,1,0
3323,,,EntrepreneursXb,2,1,3,2,1,3,0.5,0.013374,0,0,0,0
3324,,,scout_nj,0,1,1,0,1,1,0,0,1,1,1,0
3325,,,tlane_LA,1,1,2,1,1,2,0,0.006687,0,0,0,0
3326,,,ThePirateSax,3,1,4,3,1,4,0.333333,0.020061,0,0,0,0
3327,,,PatiM2,0,1,1,0,1,1,0,0,1,1,1,0
3328,,,TBA201830,0,3,3,0,3,3,0,0,3,0.6,0.722222,0
3329,,,CarolynClburr,0,1,1,0,1,1,0,0,1,1,1,0
3330,,,kv2405,0,1,1,0,1,1,0,0,1,1,1,0
3331,,,xamat,1,1,2,1,1,2,0,0.006687,0,0,0,0
3332,,,CThurston97,1,3,4,1,3,4,0.333333,0.006687,4,0.454545,0.616667,0
3333,,,ttelegraphpost,4,1,5,4,1,5,0.25,0.026749,0,0,0,0
3334,,,TRXfourfiddyr,0,1,1,0,1,1,0,0,1,1,1,0
3335,,,Tr00peRR,0,1,1,0,1,1,0,0,1,1,1,0
3336,,,Elle6841,0,1,1,0,1,1,0,0,1,1,1,0
3337,,,michaelallenmar,1,1,2,1,1,2,0,0.006687,0,0,0,0
3338,,,sehrien,4,2,6,5,3,8,0.2,0.026749,1,1,1,3
3339,,,itmattersalways,0,1,1,0,1,1,0,0,2,0.666667,0.75,0
3340,,,nypost,4,1,5,5,2,7,0.25,0.051208,0,0,0,0
3341,,,drivandalism,0,1,1,0,1,1,0,0,1,1,1,0
3342,,,notaxiwarrior,3,1,4,3,1,4,0.333333,0.020061,0,0,0,0
3343,,,ygebrekiros_,0,1,1,0,1,1,0,0,1,1,1,0
3344,,,JackalPc,0,1,1,0,1,1,0,0,1,1,1,0
3345,,,afrodykee,5,3,8,7,5,12,0.142857,0.033436,1,1,1,8
3346,,,PDtincher1,0,2,2,0,2,2,0,0,2,0.666667,0.75,0
3347,,,kikehz,0,1,1,0,1,1,0,0,2,0.6,0.666667,0
3348,,,epidatageek,0,1,1,0,1,1,0,0,2,0.6,0.666667,0
3349,,,Tokaise,1,1,2,1,1,2,0,0.006687,0,0,0,0
3350,,,maiphoang,3,1,4,3,1,4,0.333333,0.020061,0,0,0,0
3351,,,peterwitte,0,1,1,0,1,1,0,0,1,1,1,0
3352,,,WireframeVC,0,1,1,0,1,1,0,0,1,1,1,0
3353,,,51Sel,2,1,3,2,1,3,0.5,0.013374,0,0,0,0
3354,,,sdkstl,0,1,1,0,1,1,0,0,1,1,1,0
3355,,,WalterIsaacson,1,1,2,1,1,2,0,0.006687,0,0,0,0
3356,,,ChaowyEyes,0,1,1,0,1,1,0,0,2,0.666667,0.75,0
3357,,,JoshErnst2,0,1,1,0,1,1,0,0,2,0.666667,0.75,0
3358,,,zcai,2,1,3,2,1,3,0.5,0.013374,0,0,0,0
3359,,,DDSDogg,0,1,1,0,1,1,0,0,1,1,1,0
3360,,,d818581dany,3,1,4,4,1,5,0.333333,0.020061,0,0,0,0
3361,,,taechiyan,0,3,3,0,4,4,0,0,1,1,1,0
3362,,,pamharr14199861,0,1,1,0,1,1,0,0,1,1,1,0
3363,,,loopsandflutzes,2,1,3,2,1,3,0.5,0.013374,0,0,0,0
3364,,,WillBredderman,0,1,1,0,1,1,0,0,1,1,1,0
3365,,,SquarePegDem,2,1,3,2,1,3,0.5,0.013374,0,0,0,0
3366,,,silverbulletguy,0,1,1,0,1,1,0,0,1,1,1,0
3367,,,thinksabtyuzu,1,1,2,1,1,2,0,0.006687,0,0,0,0
3368,,,JesterWootton,1,1,2,1,1,2,0,0.006687,0,0,0,0
3369,,,3Patriotboys,1,1,2,1,1,2,0,0.006687,0,0,0,0
3370,,,FLMomNYGirl,2,1,3,3,2,5,0.5,0.013374,0,0,0,0
3371,,,ruizeee_,0,1,1,0,1,1,0,0,1,1,1,0
3372,,,quest_for_6,1,1,2,1,1,2,0,0.006687,0,0,0,0
3373,,,BenjaminERogers,1,1,2,1,1,2,0,0.006687,0,0,0,0
3374,,,AdeleTruthSkr,3,1,4,3,1,4,0.333333,0.020061,0,0,0,0
3375,,,travisjohnson,0,1,1,0,1,1,0,0,1,1,1,0
3376,,,mindchangez,0,1,1,0,1,1,0,0,1,1,1,0
3377,,,TheArtofBella,1,1,2,1,1,2,0,0.006687,0,0,0,0
3378,,,pacop1co,2,1,3,2,1,3,0.5,0.013374,0,0,0,0
3379,,,TomCase147,0,1,1,0,1,1,0,0,1,1,1,0
3380,,,CarolBuchananMT,2,1,3,2,1,3,0.5,0.013374,0,0,0,0
3381,,,MichaelRiz,0,1,1,0,1,1,0,0,1,1,1,0
3382,,,robitvxqxo,1,2,3,1,2,3,0.5,0.006687,2,0.6,0.666667,0
3383,,,bdelos57,2,1,3,2,1,3,0.5,0.013374,0,0,0,0
3384,,,stevensu1127,0,1,1,0,1,1,0,0,1,1,1,0
3385,,,riotgrrrl_,1,1,2,1,1,2,0,0.006687,0,0,0,0
3386,,,willow_rani,1,1,2,2,2,4,0,0.006687,0,0,0,0
3387,,,AlexGaria78,0,1,1,0,1,1,0,0,1,1,1,0
3388,,,WynterLegend,0,1,1,0,1,1,0,0,1,1,1,0
3389,,,louise_heeke,3,1,4,3,1,4,0.333333,0.020061,0,0,0,0
3390,,,nehales,0,1,1,0,1,1,0,0,1,1,1,0
3391,,,midnattbaek,0,1,1,0,1,1,0,0,1,1,1,0
3392,,,realNativeTexan,2,1,3,2,1,3,0.5,0.030845,0,0,0,0
3393,,,gisellecygnets,9,1,10,9,1,10,0.111111,0.115308,0,0,0,0
3394,,,go312go,0,1,1,0,1,1,0,0,1,1,1,0
3395,,,bucaneropr,0,1,1,0,1,1,0,0,1,1,1,0
3396,,,FishManwaters,0,1,1,0,1,1,0,0,1,1,1,0
3397,,,2021Swaraj,0,1,1,0,1,1,0,0,1,1,1,0
3398,,,pinkpicg,0,3,3,0,3,3,0,0,1,1,1,0
3399,,,mamamcbear1,0,1,1,0,1,1,0,0,1,1,1,0
3400,,,CMinkuo,6,1,7,6,1,7,0.166667,0.057594,0,0,0,0
3401,,,DeborahWGunn2,0,1,1,0,1,1,0,0,1,1,1,0
3402,,,clooch3,0,1,1,0,1,1,0,0,1,1,1,0
3403,,,TammyLe14915233,7,1,8,7,1,8,0.142857,0.04681,0,0,0,0
3404,,,ajsammy29,0,1,1,0,1,1,0,0,1,1,1,0
3405,,,RogerShi10,0,1,1,0,1,1,0,0,1,1,1,0
3406,,,Nuages1862,0,1,1,0,1,1,0,0,1,1,1,0
3407,,,EvansVibes_,0,1,1,0,1,1,0,0,1,1,1,0
3408,,,sk8maven,0,3,3,0,3,3,0,0,1,1,1,0
3409,,,MonumentalGodis,0,1,1,0,1,1,0,0,1,1,1,0
3410,,,mcarlstromDR,3,1,4,3,1,4,0.333333,0.020061,0,0,0,0
3411,,,BNCovRI,0,1,1,0,1,1,0,0,1,1,1,0
3412,,,TiffLoveIt,1,3,4,1,3,4,0.333333,0.006687,3,0.555556,0.666667,0
3413,,,Michael_Ludden,6,1,7,6,1,7,0.166667,0.040123,0,0,0,0
3414,,,samzhab,0,1,1,0,1,1,0,0,1,1,1,0
3415,,,mrstthomps63,0,1,1,0,1,1,0,0,1,1,1,0
3416,,,uw_u35,0,1,1,0,1,1,0,0,1,1,1,0
3417,,,user14972,0,1,1,0,1,1,0,0,1,1,1,0
3418,,,gigikeno1,0,1,1,0,1,1,0,0,1,1,1,0
3419,,,kentohui,1,1,2,1,1,2,0,0.006687,0,0,0,0
3420,,,mrdragonbeard,0,1,1,0,1,1,0,0,2,0.571429,0.625,0
3421,,,Joyce87594328,0,1,1,0,1,1,0,0,2,0.571429,0.625,0
3422,,,BillyStorey6,0,1,1,0,1,1,0,0,2,0.6,0.666667,0
3423,,,yuzustsq,1,3,4,1,3,4,0.333333,0.006687,1,1,1,0
3424,,,LadyMRules,1,1,2,1,1,2,0,0.006687,0,0,0,0
3425,,,amyrlam,2,1,3,2,1,3,0.5,0.013374,0,0,0,0
3426,,,RhianFazzini,0,1,1,0,1,1,0,0,1,1,1,0
3427,,,real_DRN,1,1,2,1,1,2,0,0.006687,0,0,0,0
3428,,,Chris_1791,1,1,2,2,2,4,0,0.006687,0,0,0,0
3429,,,carolinapress,2,1,3,2,1,3,0.5,0.013374,0,0,0,0
3430,,,GhostofFanny,0,1,1,0,1,1,0,0,1,1,1,0
3431,,,ConservNewsDly,3,1,4,3,1,4,0.333333,0.020061,0,0,0,0
3432,,,TeenAfricaNews,0,1,1,0,1,1,0,0,1,1,1,0
3433,,,GailWeb65569896,0,1,1,0,1,1,0,0,1,1,1,0
3434,,,esquirenews,2,1,3,2,1,3,0.5,0.013374,0,0,0,0
3435,,,Vamos_Brandon,0,1,1,0,1,1,0,0,1,1,1,0
3436,,,fwends95z,0,1,1,0,1,1,0,0,1,1,1,0
3437,,,sed6241,0,2,2,0,2,2,0,0,1,1,1,0
3438,,,Matthew31183918,0,1,1,0,1,1,0,0,1,1,1,0
3439,,,ThonasGareth,0,1,1,0,1,1,0,0,1,1,1,0
3440,,,lupu_flavius,0,1,1,0,1,1,0,0,1,1,1,0
3441,,,sspraguejr,0,1,1,0,1,1,0,0,1,1,1,0
3442,,,Orlien,0,1,1,0,1,1,0,0,1,1,1,0
3443,,,DashCarCrash,0,1,1,0,1,1,0,0,1,1,1,0
3444,,,Dabular,5,1,6,5,1,6,0.2,0.033436,0,0,0,0
3445,,,BasedMom21,0,1,1,0,1,1,0,0,1,1,1,0
3446,,,Thvositobear,0,1,1,0,1,1,0,0,1,1,1,0
3447,,,NeilJamesWeekes,0,1,1,0,1,1,0,0,1,1,1,0
3448,,,JeffSchwaner,0,1,1,0,1,1,0,0,1,1,1,0
3449,,,Sashagaqueenne,2,1,3,2,1,3,0.5,0.013374,0,0,0,0
3450,,,Liseth59222886,0,1,1,0,1,1,0,0,1,1,1,0
3451,,,JeanneKapela,2,1,3,2,1,3,0.5,0.013374,0,0,0,0
3452,,,kevinwidiaman,0,1,1,0,1,1,0,0,1,1,1,0
3453,,,Raymond_Norman,3,1,4,3,1,4,0.333333,0.020061,0,0,0,0
3454,,,fireplug2005,0,1,1,0,1,1,0,0,1,1,1,0
3455,,,StephanieDeGraw,0,1,1,0,1,1,0,0,1,1,1,0
3456,,,amstelnews,1,1,2,1,1,2,0,0.006687,0,0,0,0
3457,,,weatherati,3,1,4,3,1,4,0.333333,0.020061,0,0,0,0
3458,,,AustinTexPerez,0,3,3,0,4,4,0,0,1,1,1,0
3459,,,VeldonL,0,1,1,0,1,1,0,0,2,0.666667,0.75,0
3460,,,graziatweets,2,1,3,2,1,3,0.5,0.013374,0,0,0,0
3461,,,super_misky,0,1,1,0,1,1,0,0,1,1,1,0
3462,,,MistralWinds,3,1,4,4,1,5,0.333333,0.020061,0,0,0,0
3463,,,mayqueenpaige,0,1,1,0,1,1,0,0,1,1,1,0
3464,,,screen_moon,1,1,2,1,1,2,0,0.006687,0,0,0,0
3465,,,CRNDigitalTalk,1,1,2,1,1,2,0,0.006687,0,0,0,0
3466,,,SuperModelLexi,1,1,2,1,1,2,0,0.006687,0,0,0,0
3467,,,mrod59,3,1,4,3,1,4,0.333333,0.034038,0,0,0,0
3468,,,SciFiBookAddict,0,1,1,0,1,1,0,0,1,1,1,0
3469,,,nijimonoseven,5,1,6,5,1,6,0.2,0.033436,0,0,0,0
3470,,,BrianGrNotABot,0,1,1,0,1,1,0,0,1,1,1,0
3471,,,compiegn,0,1,1,0,1,1,0,0,1,1,1,0
3472,,,BrianBu99892348,0,1,1,0,1,1,0,0,1,1,1,0
3473,,,s3ulgiii,6,1,7,7,2,9,0.166667,0.040123,0,0,0,0
3474,,,ashbunii,0,1,1,0,1,1,0,0,1,1,1,0
3475,,,mjasmin2051,0,1,1,0,1,1,0,0,1,1,1,0
3476,,,leftistwitch,5,1,6,5,1,6,0.2,0.033436,0,0,0,0
3477,,,lapislauli,0,1,1,0,1,1,0,0,1,1,1,0
3478,,,AgyemangKay,0,1,1,0,1,1,0,0,1,1,1,0
3479,,,beruuse,0,1,1,0,1,1,0,0,1,1,1,0
3480,,,himerdos,2,1,3,2,1,3,0.5,0.013374,0,0,0,0
3481,,,daegubaegu,0,1,1,0,1,1,0,0,1,1,1,0
3482,,,OR7NGE,1,1,2,1,1,2,0,0.006687,0,0,0,0
3483,,,christingabby93,1,1,2,1,1,2,0,0.006687,0,0,0,0
3484,,,dooms_1211,0,1,1,0,1,1,0,0,4,0.413793,0.465278,0
3485,,,querenciawith,0,1,1,0,1,1,0,0,4,0.413793,0.465278,0
3486,,,bc29852744,7,1,8,7,1,8,0.142857,0.04681,0,0,0,0
3487,,,feyren_,0,1,1,0,1,1,0,0,1,1,1,0
3488,,,taendkookies2,0,1,1,0,1,1,0,0,1,1,1,0
3489,,,FJHauck,0,1,1,0,1,1,0,0,1,1,1,0
3490,,,dimondj42,1,1,2,1,1,2,0,0.006687,0,0,0,0
3491,,,y3oreum,7,2,9,9,4,13,0.125,0.04681,2,0.6,0.666667,18
3492,,,S0LSTlCES,0,1,1,0,1,1,0,0,3,0.444444,0.541667,0
3493,,,zachary_ibarra,0,1,1,0,1,1,0,0,3,0.444444,0.541667,0
3494,,,mrMISDEMEANOR,4,1,5,4,1,5,0.25,0.030243,0,0,0,0
3495,,,Senkouji_sensei,0,1,1,0,1,1,0,0,1,1,1,0
3496,,,SilentCrescendo,1,2,3,1,2,3,0.5,0.006687,1,1,1,0
3497,,,ClaireS81610943,0,1,1,0,1,1,0,0,1,1,1,0
3498,,,edgery,2,1,3,2,1,3,0.5,0.013374,0,0,0,0
3499,,,momomomomachabu,0,1,1,0,1,1,0,0,1,1,1,0
3500,,,EABronsonBlair,9,1,10,9,1,10,0.111111,0.060184,0,0,0,0
3501,,,r_jasonbennion,0,1,1,0,1,1,0,0,1,1,1,0
3502,,,Ichuse2,0,1,1,0,1,1,0,0,1,1,1,0
3503,,,2e6658f32bcf414,0,1,1,0,1,1,0,0,1,1,1,0
3504,,,Oblivia_nt,0,1,1,0,1,1,0,0,1,1,1,0
3505,,,KivieJ,0,1,1,0,1,1,0,0,1,1,1,0
3506,,,NFT_Delaris,0,1,1,0,1,1,0,0,1,1,1,0
3507,,,_z_z_z____,0,1,1,0,1,1,0,0,1,1,1,0
3508,,,welleanor,0,1,1,0,1,1,0,0,2,0.538462,0.571429,0
3509,,,onsep11,2,1,3,2,1,3,0.5,0.013374,0,0,0,0
3510,,,danaemolina,0,1,1,0,1,1,0,0,1,1,1,0
3511,,,HomeCareGurus,1,1,2,1,1,2,0,0.006687,0,0,0,0
3512,,,ct1234567,3,1,4,3,1,4,0.333333,0.020061,0,0,0,0
3513,,,angeldee0,0,1,1,0,1,1,0,0,1,1,1,0
3514,,,hanyu4A,0,1,1,0,1,1,0,0,1,1,1,0
3515,,,motiansky,7,1,8,8,2,10,0.142857,0.04681,0,0,0,0
3516,,,Steven55580381,1,1,2,1,1,2,0,0.006687,0,0,0,0
3517,,,letsbrilliantly,1,1,2,1,1,2,0,0.006687,0,0,0,0
3518,,,Junkpostsforfun,3,1,4,3,1,4,0.333333,0.020061,0,0,0,0
3519,,,VegasUte,0,1,1,0,1,1,0,0,1,1,1,0
3520,,,andreagail_k,0,1,1,0,1,1,0,0,1,1,1,0
3521,,,sanzoidy,3,1,4,3,1,4,0.333333,0.020061,0,0,0,0
3522,,,rosario_1802,0,1,1,0,1,1,0,0,1,1,1,0
3523,,,erlorello,0,1,1,0,1,1,0,0,1,1,1,0
3524,,,marklesT_T,2,1,3,2,1,3,0.5,0.013374,0,0,0,0
3525,,,Diana__tiny,0,1,1,0,1,1,0,0,1,1,1,0
3526,,,cosmetology,2,1,3,2,1,3,0.5,0.013374,0,0,0,0
3527,,,castellanoskin3,0,1,1,0,1,1,0,0,1,1,1,0
3528,,,Pengumi12,0,2,2,0,2,2,0,0,1,1,1,0
3529,,,AmericaBluebird,1,1,2,1,1,2,0,0.006687,0,0,0,0
3530,,,fashionbabyluv,1,1,2,1,1,2,0,0.006687,0,0,0,0
3531,,,ejn123,2,1,3,2,1,3,0.5,0.013374,0,0,0,0
3532,,,KandelkarSapir,0,5,5,0,6,6,0,0,1,1,1,0
3533,,,jg1234567,3,1,4,3,1,4,0.333333,0.020061,0,0,0,0
3534,,,RedQuixote,0,2,2,0,2,2,0,0,1,1,1,0
3535,,,PuggieSue,0,1,1,0,1,1,0,0,1,1,1,0
3536,,,ryotozier,1,1,2,1,1,2,0,0.006687,0,0,0,0
3537,,,Gnesiothymos,1,1,2,1,1,2,0,0.006687,0,0,0,0
3538,,,Kate_HAGardens,1,1,2,1,1,2,0,0.006687,0,0,0,0
3539,,,alexsimonelis,0,1,1,0,1,1,0,0,1,1,1,0
3540,,,Lovemomdad4,0,1,1,0,1,1,0,0,1,1,1,0
3541,,,Mariell90662007,2,2,4,2,2,4,0.333333,0.013374,1,1,1,1
3542,,,ImmerSieAlice,0,1,1,0,1,1,0,0,2,0.666667,0.75,0
3543,,,Cheryl80601653,3,1,4,3,1,4,0.333333,0.020061,0,0,0,0
3544,,,opalnkem,1,1,2,1,1,2,0,0.006687,0,0,0,0
3545,,,yuzu_riii,1,1,2,1,1,2,0,0.006687,0,0,0,0
3546,,,BrianDude,1,1,2,1,1,2,0,0.006687,0,0,0,0
3547,,,FillmoreWhite,0,1,1,0,1,1,0,0,1,1,1,0
3548,,,SamParsons,0,1,1,0,1,1,0,0,1,1,1,0
3549,,,kaashiqt,1,1,2,1,1,2,0,0.00396,1,1,1,1
3550,,,RemecTine,0,1,1,0,1,1,0,0,2,0.666667,0.75,0
3551,,,IdesKat315,1,1,2,1,1,2,0,0.006687,0,0,0,0
3552,,,samsam_washere,1,1,2,1,1,2,0,0.006687,0,0,0,0
3553,,,prasadagirl,1,1,2,1,1,2,0,0.006687,0,0,0,0
3554,,,repub9989,1,1,2,1,1,2,0,0.006687,0,0,0,0
3555,,,LVJOYband,1,1,2,1,1,2,0,0.006687,0,0,0,0
3556,,,celicalms,2,1,3,2,1,3,0.5,0.013374,0,0,0,0
3557,,,Trudru61,0,1,1,0,1,1,0,0,1,1,1,0
3558,,,samiraculous,2,1,3,2,1,3,0.5,0.013374,0,0,0,0
3559,,,eevilpool,0,1,1,0,1,1,0,0,1,1,1,0
3560,,,Iamanactualoser,3,1,4,3,1,4,0.333333,0.020061,0,0,0,0
3561,,,LOVERXBOYYYY,0,1,1,0,1,1,0,0,1,1,1,0
3562,,,rchlggnn,1,1,2,1,1,2,0,0.006687,0,0,0,0
3563,,,karcan_g,1,1,2,1,1,2,0,0.006687,0,0,0,0
3564,,,GarciaCroft,1,1,2,1,1,2,0,0.006687,0,0,0,0
3565,,,challenger_prof,2,1,3,2,1,3,0.5,0.013374,0,0,0,0
3566,,,nabyssoul,0,1,1,0,1,1,0,0,1,1,1,0
3567,,,SchenkerYael,0,1,1,0,1,1,0,0,1,1,1,0
3568,,,Gastein,0,1,1,0,1,1,0,0,1,1,1,0
3569,,,DP_PD90,0,1,1,0,1,1,0,0,1,1,1,0
3570,,,janette_11,1,1,2,1,1,2,0,0.006687,0,0,0,0
3571,,,brunoIover,2,1,3,2,1,3,0.5,0.013374,0,0,0,0
3572,,,CobainRift,0,1,1,0,1,1,0,0,1,1,1,0
3573,,,GeorgeSTEBBINS4,3,1,4,3,1,4,0.333333,0.020061,0,0,0,0
3574,,,MannerRichard,0,1,1,0,1,1,0,0,1,1,1,0
3575,,,OscarRant,0,2,2,0,2,2,0,0,1,1,1,0
3576,,,pmcanulty01,0,1,1,0,1,1,0,0,1,1,1,0
3577,,,H4EJU,1,1,2,2,2,4,0,0.006687,0,0,0,0
3578,,,SHOKAL7,3,1,4,3,1,4,0.333333,0.020061,0,0,0,0
3579,,,DoIn42976153,0,1,1,0,1,1,0,0,1,1,1,0
3580,,,IanEChiang,1,1,2,1,1,2,0,0.006687,0,0,0,0
3581,,,SCOTUSBios,0,1,1,0,1,1,0,0,1,1,1,0
3582,,,KimH40092121,1,1,2,1,1,2,0,0.006687,0,0,0,0
3583,,,JamesRussellCa3,0,1,1,0,1,1,0,0,1,1,1,0
3584,,,Nh3_engineer,0,1,1,0,1,1,0,0,1,1,1,0
3585,,,yamaaki1130,0,1,1,0,1,1,0,0,1,1,1,0
3586,,,BakaMeep,1,1,2,1,1,2,0,0.006687,0,0,0,0
3587,,,Dr_Zil_White,1,2,3,1,2,3,0.5,0.006687,1,1,1,0
3588,,,KarenStephan,0,2,2,0,2,2,0,0,1,1,1,0
3589,,,yunkiwhisky,0,2,2,0,2,2,0,0,1,1,1,0
3590,,,dcgriz,0,1,1,0,1,1,0,0,1,1,1,0
3591,,,StonewallYDems,0,1,1,0,1,1,0,0,1,1,1,0
3592,,,JeffBrailsford,0,1,1,0,1,1,0,0,2,0.538462,0.571429,0
3593,,,supportttruth,0,2,2,0,2,2,0,0,2,0.571429,0.625,0
3594,,,hylevel902,0,1,1,0,1,1,0,0,2,0.538462,0.571429,0
3595,,,NotVerySmarts,1,1,2,1,1,2,0,0.006687,0,0,0,0
3596,,,Torres_Z92,1,1,2,1,1,2,0,0.006687,0,0,0,0
3597,,,mightyglu,0,1,1,0,1,1,0,0,1,1,1,0
3598,,,melindamharden,0,1,1,0,1,1,0,0,1,1,1,0
3599,,,ShoreEJV,1,1,2,1,1,2,0,0.006687,0,0,0,0
3600,,,LiuWendland,1,1,2,1,1,2,0,0.006687,0,0,0,0
3601,,,Nickw8000,2,1,3,2,1,3,0.5,0.013374,0,0,0,0
3602,,,DanSitbon7,1,1,2,1,1,2,0,0.006687,0,0,0,0
3603,,,BingRomL,3,1,4,3,1,4,0.333333,0.020061,0,0,0,0
3604,,,Takashin__,0,1,1,0,1,1,0,0,1,1,1,0
3605,,,JdSchatzi,1,1,2,1,1,2,0,0.006687,0,0,0,0
3606,,,abbyfulton97,7,1,8,8,2,10,0.142857,0.050304,0,0,0,0
3607,,,vanellapoohh,0,3,3,0,3,3,0,0,1,1,1,0
3608,,,DublinMimi,0,1,1,0,1,1,0,0,1,1,1,0
3609,,,bengin1003,0,3,3,0,3,3,0,0,1,1,1,0
3610,,,4444Yoonie,0,1,1,0,1,1,0,0,1,1,1,0
3611,,,rowtendo,2,1,3,2,1,3,0.5,0.013374,0,0,0,0
3612,,,PHINewsNet1,0,1,1,0,1,1,0,0,1,1,1,0
3613,,,BigDeporte,4,1,5,4,1,5,0.25,0.040725,0,0,0,0
3614,,,Cassanevaz,0,1,1,0,1,1,0,0,1,1,1,0
3615,,,MRC_SLC,0,1,1,0,1,1,0,0,1,1,1,0
3616,,,jassogne,7,1,8,7,1,8,0.142857,0.04681,0,0,0,0
3617,,,Shelly18152462,0,1,1,0,1,1,0,0,1,1,1,0
3618,,,DoomGundam,0,1,1,0,1,1,0,0,1,1,1,0
3619,,,__NuNuuuu,0,1,1,0,1,1,0,0,1,1,1,0
3620,,,uzuis4thwifu,0,2,2,0,2,2,0,0,1,1,1,0
3621,,,davidnespanol,0,1,1,0,1,1,0,0,1,1,1,0
3622,,,papadakisandcry,2,1,3,2,1,3,0.5,0.013374,0,0,0,0
3623,,,jeanneenabottle,0,2,2,0,2,2,0,0,1,1,1,0
3624,,,BattleOfHudson,5,1,6,6,1,7,0.2,0.033436,0,0,0,0
3625,,,lotusyuna,0,1,1,0,1,1,0,0,1,1,1,0
3626,,,yuzuruicegod,0,3,3,0,3,3,0,0,1,1,1,0
3627,,,CarlosG62434106,0,1,1,0,1,1,0,0,1,1,1,0
3628,,,jeanorjeanny,1,1,2,1,1,2,0,0.006687,0,0,0,0
3629,,,pop38373730,1,1,2,1,1,2,0,0.006687,0,0,0,0
3630,,,U_Call_Me_Daddy,3,1,4,3,1,4,0.333333,0.020061,0,0,0,0
3631,,,JannieGavile,0,1,1,0,1,1,0,0,1,1,1,0
3632,,,mkhodges,0,1,1,0,1,1,0,0,1,1,1,0
3633,,,amusicalpenguin,1,1,2,1,1,2,0,0.006687,0,0,0,0
3634,,,EstebanJimenez,4,1,5,4,1,5,0.25,0.026749,0,0,0,0
3635,,,saraxqfan,0,1,1,0,1,1,0,0,1,1,1,0
3636,,,anafurlongas,0,1,1,0,1,1,0,0,1,1,1,0
3637,,,buccos08,0,1,1,0,1,1,0,0,1,1,1,0
3638,,,YUZURUSLEGACY,1,1,2,1,1,2,0,0.006687,0,0,0,0
3639,,,MikeSteinman,0,1,1,0,1,1,0,0,1,1,1,0
3640,,,Miggy_curiel,0,1,1,0,1,1,0,0,1,1,1,0
3641,,,Dragondescendan,1,1,2,1,1,2,0,0.006687,0,0,0,0
3642,,,AnnieB42NY,0,1,1,0,1,1,0,0,1,1,1,0
3643,,,StunnedVoter,0,4,4,0,4,4,0,0,1,1,1,0
3644,,,zen4ever2us,0,2,2,0,2,2,0,0,1,1,1,0
3645,,,daurelia47,0,2,2,0,2,2,0,0,1,1,1,0
3646,,,chamomishtea,0,1,1,0,1,1,0,0,1,1,1,0
3647,,,FrizzyMarz,0,1,1,0,1,1,0,0,1,1,1,0
3648,,,CaudiaAngelica,0,1,1,0,1,1,0,0,1,1,1,0
3649,,,jblyle_battle,0,1,1,0,1,1,0,0,2,0.571429,0.625,0
3650,,,Tico_Romao,0,1,1,0,1,1,0,0,2,0.571429,0.625,0
3651,,,janattheocean,0,1,1,0,1,1,0,0,2,0.571429,0.625,0
3652,,,natseushi,0,1,1,0,1,1,0,0,2,0.571429,0.625,0
3653,,,Booker25,0,1,1,0,1,1,0,0,2,0.571429,0.625,0
3654,,,cmills2008,10,1,11,10,1,11,0.1,0.066871,0,0,0,0
3655,,,HyJaxLTD,0,1,1,0,1,1,0,0,1,1,1,0
3656,,,CathyJoeGPT,0,1,1,0,1,1,0,0,1,1,1,0
3657,,,MichaelWinship,0,1,1,0,1,1,0,0,1,1,1,0
3658,,,sexygirl798,0,2,2,0,2,2,0,0,1,1,1,0
3659,,,MercuryReports,0,1,1,0,1,1,0,0,1,1,1,0
3660,,,CTrevorNelson,0,1,1,0,1,1,0,0,1,1,1,0
3661,,,DMHaselden3,0,2,2,0,2,2,0,0,3,0.518519,0.559524,0
3662,,,Ashqui_Ventures,0,1,1,0,1,1,0,0,1,1,1,0
3663,,,BettyBuckley,0,1,1,0,1,1,0,0,1,1,1,0
3664,,,sarahncotton,1,1,2,1,1,2,0,0.006687,0,0,0,0
3665,,,Patbagley,1,1,2,1,1,2,0,0.006687,0,0,0,0
3666,,,ShaynaChabrow,5,1,6,5,1,6,0.2,0.033436,0,0,0,0
3667,,,buffiehb,0,2,2,0,2,2,0,0,1,1,1,0
3668,,,AdamMadison96,0,1,1,0,1,1,0,0,1,1,1,0
3669,,,AmyMartin1994,0,1,1,0,1,1,0,0,1,1,1,0
3670,,,SamClay2020,0,1,1,0,1,1,0,0,1,1,1,0
3671,,,hxmosuperior,2,1,3,3,2,5,0.5,0.013374,0,0,0,0
3672,,,Krowl72,3,1,4,3,1,4,0.333333,0.020061,0,0,0,0
3673,,,drkyla,0,1,1,0,1,1,0,0,1,1,1,0
3674,,,yingguangism,1,1,2,1,1,2,0,0.006687,0,0,0,0
3675,,,gfernandoamb,3,1,4,3,1,4,0.333333,0.020061,0,0,0,0
3676,,,kristine_kenyon,0,3,3,0,3,3,0,0,1,1,1,0
3677,,,wolfiemouse,0,1,1,0,1,1,0,0,1,1,1,0
3678,,,patnangel22,2,1,3,2,1,3,0.5,0.013374,0,0,0,0
3679,,,BillLan01876667,1,1,2,1,1,2,0,0.006687,0,0,0,0
3680,,,VictorC99087523,0,1,1,0,1,1,0,0,1,1,1,0
3681,,,ForwardProgres6,0,1,1,0,1,1,0,0,1,1,1,0
3682,,,Robinwa04676435,1,1,2,1,1,2,0,0.006687,0,0,0,0
3683,,,A_N_D_R_E_W_17,0,1,1,0,1,1,0,0,2,0.666667,0.75,0
3684,,,AouabdiaYakoub,1,1,2,1,1,2,0,0.006687,0,0,0,0
3685,,,dos_knockquis,3,1,4,3,1,4,0.333333,0.020061,0,0,0,0
3686,,,JakeDunnegan,0,1,1,0,1,1,0,0,1,1,1,0
3687,,,ChopKnighttime,0,1,1,0,1,1,0,0,1,1,1,0
3688,,,buddy_dek,1,1,2,1,1,2,0,0.006687,0,0,0,0
3689,,,NoryaAyron,0,1,1,0,1,1,0,0,2,0.666667,0.75,0
3690,,,rchapuseaux13,5,1,6,5,1,6,0.2,0.033436,0,0,0,0
3691,,,KenZimmern,0,1,1,0,1,1,0,0,1,1,1,0
3692,,,beefour4,0,1,1,0,1,1,0,0,1,1,1,0
3693,,,RichardHurtz17,0,1,1,0,1,1,0,0,1,1,1,0
3694,,,Visionaire14,0,1,1,0,1,1,0,0,2,0.555556,0.6,0
3695,,,sasrmaynard,0,1,1,0,1,1,0,0,2,0.555556,0.6,0
3696,,,quadlutze,2,1,3,2,1,3,0.5,0.013374,0,0,0,0
3697,,,wistfulrain,0,2,2,0,2,2,0,0,1,1,1,0
3698,,,tsumugisoup,7,1,8,9,2,11,0.142857,0.050304,0,0,0,0
3699,,,flygriz,0,1,1,0,1,1,0,0,1,1,1,0
3700,,,hasnaabee,1,2,3,1,3,4,0.5,0.006687,1,1,1,0
3701,,,TrZZLJtaX8azND7,0,1,1,0,1,1,0,0,1,1,1,0
3702,,,harryduvet,1,1,2,1,1,2,0,0.006687,0,0,0,0
3703,,,FrackoffF,2,1,3,2,1,3,0.5,0.013374,0,0,0,0
3704,,,liangjiez,0,1,1,0,1,1,0,0,1,1,1,0
3705,,,emilylurice,4,1,5,4,1,5,0.25,0.033737,0,0,0,0
3706,,,jerri_kestner,2,2,4,2,2,4,0.333333,0.013374,1,1,1,1
3707,,,tears_hiro,0,1,1,0,1,1,0,0,1,1,1,0
3708,,,iIuvkoobiii,0,1,1,0,1,1,0,0,1,1,1,0
3709,,,chimchixm,0,2,2,0,2,2,0,0,2,0.75,0.833333,0
3710,,,SigSauer1814,1,1,2,1,1,2,0,0.006687,0,0,0,0
3711,,,dmcconnico,3,1,4,3,1,4,0.333333,0.020061,0,0,0,0
3712,,,soupisokayig,0,1,1,0,1,1,0,0,1,1,1,0
3713,,,TomGroyperson,0,1,1,0,1,1,0,0,1,1,1,0
3714,,,teenmd,0,1,1,0,1,1,0,0,1,1,1,0
3715,,,Scarlett161819,0,1,1,0,1,1,0,0,1,1,1,0
3716,,,marymjupiter,0,1,1,0,1,1,0,0,1,1,1,0
3717,,,Rafaelanpaz,1,1,2,1,1,2,0,0.006687,0,0,0,0
3718,,,BrentWi16609490,0,1,1,0,1,1,0,0,1,1,1,0
3719,,,reIuctantlyhere,1,1,2,1,1,2,0,0.006687,0,0,0,0
3720,,,rosiemarie10395,3,1,4,3,1,4,0.333333,0.020061,0,0,0,0
3721,,,Shane61680232,0,1,1,0,1,1,0,0,1,1,1,0
3722,,,SUGARTHEGIRL,0,1,1,0,1,1,0,0,1,1,1,0
3723,,,ntg_gi,4,1,5,4,1,5,0.25,0.026749,0,0,0,0
3724,,,MrTexasUSA1,0,1,1,0,1,1,0,0,1,1,1,0
3725,,,TrinidaPatrick,0,1,1,0,1,1,0,0,1,1,1,0
3726,,,OonaRuin,2,1,3,2,1,3,0.5,0.013374,0,0,0,0
3727,,,bobnap20,0,1,1,0,1,1,0,0,1,1,1,0
3728,,,edwinroldan1963,5,1,6,5,1,6,0.2,0.033436,0,0,0,0
3729,,,boggled102,0,1,1,0,1,1,0,0,1,1,1,0
3730,,,JEFFWH75,0,1,1,0,1,1,0,0,1,1,1,0
3731,,,TheMadGodHaelor,0,1,1,0,1,1,0,0,1,1,1,0
3732,,,Jphamilton1,0,1,1,0,1,1,0,0,1,1,1,0
3733,,,SPEARB1NGE,2,1,3,2,1,3,0.5,0.013374,0,0,0,0
3734,,,Hipocresiaroja,0,1,1,0,1,1,0,0,1,1,1,0
3735,,,RobMaguire,4,1,5,4,1,5,0.25,0.026749,0,0,0,0
3736,,,Receptorem,0,1,1,0,1,1,0,0,1,1,1,0
3737,,,hinahinalalala,0,1,1,0,1,1,0,0,1,1,1,0
3738,,,China4Tech,0,2,2,0,2,2,0,0,1,1,1,0
3739,,,janaseva_news,1,1,2,1,1,2,0,0.006687,0,0,0,0
3740,,,HarryPhillipsIV,0,1,1,0,1,1,0,0,1,1,1,0
3741,,,badrihammodi,0,1,1,0,1,1,0,0,1,1,1,0
3742,,,SampleATL,0,1,1,0,1,1,0,0,1,1,1,0
3743,,,martmc88b,0,2,2,0,2,2,0,0,3,0.518519,0.559524,0
3744,,,jenmillsap,8,1,9,8,1,9,0.125,0.053497,0,0,0,0
3745,,,CrucioKing,0,1,1,0,1,1,0,0,1,1,1,0
3746,,,alkie44057732,0,1,1,0,1,1,0,0,1,1,1,0
3747,,,PutoElKeLeaEsto,0,1,1,0,1,1,0,0,1,1,1,0
3748,,,OJthetard,0,1,1,0,1,1,0,0,1,1,1,0
3749,,,PaulMorehouse,0,1,1,0,1,1,0,0,1,1,1,0
3750,,,nypostsports,1,1,2,1,1,2,0,0.006687,0,0,0,0
3751,,,mozart242,0,1,1,0,1,1,0,0,1,1,1,0
3752,,,OCMama_Bear,0,1,1,0,1,1,0,0,1,1,1,0
3753,,,erin_hanyu,7,2,9,7,2,9,0.125,0.04681,1,1,1,6
3754,,,rqcye,0,1,1,0,1,1,0,0,2,0.666667,0.75,0
3755,,,isela_hyung,0,1,1,0,1,1,0,0,2,0.666667,0.75,0
3756,,,AnoushkaLova,0,2,2,0,2,2,0,0,2,0.75,0.833333,0
3757,,,PersonThingy_0,0,1,1,0,1,1,0,0,2,0.666667,0.75,0
3758,,,NancyWoodall13,0,1,1,0,1,1,0,0,2,0.666667,0.75,0
3759,,,PIMPMCGEE,3,1,4,3,1,4,0.333333,0.020061,0,0,0,0
3760,,,calicomug,0,2,2,0,2,2,0,0,1,1,1,0
3761,,,DebRose10,0,1,1,0,1,1,0,0,1,1,1,0
3762,,,yeongsamfruit,3,2,5,3,2,5,0.25,0.020061,1,1,1,2
3763,,,iceu38,0,1,1,0,1,1,0,0,2,0.666667,0.75,0
3764,,,nanaseme,4,1,5,4,1,5,0.25,0.026749,0,0,0,0
3765,,,ModerateOc,0,1,1,0,1,1,0,0,1,1,1,0
3766,,,bbsdoublep,0,1,1,0,1,1,0,0,1,1,1,0
3767,,,genereaux2019,0,1,1,0,1,1,0,0,1,1,1,0
3768,,,linzoidprime,4,1,5,4,1,5,0.25,0.026749,0,0,0,0
3769,,,Natasha335,0,2,2,0,2,2,0,0,1,1,1,0
3770,,,rob74scot,0,1,1,0,1,1,0,0,1,1,1,0
3771,,,forgrands,0,1,1,0,1,1,0,0,1,1,1,0
3772,,,hwaisas,1,1,2,1,1,2,0,0.006687,0,0,0,0
3773,,,AB45272064,3,1,4,3,1,4,0.333333,0.029351,0,0,0,0
3774,,,orange___birb,2,6,8,2,6,8,0.142857,0.021556,1,1,1,20
3775,,,liberalvixen,0,1,1,0,1,1,0,0,1,1,1,0
3776,,,LeahTeichholtz,3,1,4,3,1,4,0.333333,0.020061,0,0,0,0
3777,,,inminivanhell,0,1,1,0,1,1,0,0,1,1,1,0
3778,,,neocutietech,1,2,3,1,2,3,0.5,0.006687,1,1,1,0
3779,,,SusanFi54199921,5,1,6,5,1,6,0.2,0.03693,0,0,0,0
3780,,,at1147raizo,0,1,1,0,1,1,0,0,1,1,1,0
3781,,,MM93262470,0,1,1,0,1,1,0,0,1,1,1,0
3782,,,lizbet_fs,1,1,2,1,1,2,0,0.006687,0,0,0,0
3783,,,PolarJohan15,1,1,2,1,1,2,0,0.006687,0,0,0,0
3784,,,Dee_C_ROD,2,1,3,2,1,3,0.5,0.013374,0,0,0,0
3785,,,Shirley36077908,3,1,4,3,1,4,0.333333,0.020061,0,0,0,0
3786,,,Yuzuru_Indo,0,1,1,0,1,1,0,0,1,1,1,0
3787,,,fearhand_,0,1,1,0,1,1,0,0,1,1,1,0
3788,,,SRunningcloud,2,1,3,3,2,5,0.5,0.013374,0,0,0,0
3789,,,artiimoo,0,1,1,0,1,1,0,0,1,1,1,0
3790,,,ugone2us475,1,1,2,1,1,2,0,0.006687,0,0,0,0
3791,,,kimann115,4,1,5,5,2,7,0.25,0.026749,0,0,0,0
3792,,,gonatha40722506,0,2,2,0,2,2,0,0,1,1,1,0
3793,,,sexton_geno,0,1,1,0,1,1,0,0,1,1,1,0
3794,,,TakePvs,1,1,2,1,1,2,0,0.006687,0,0,0,0
3795,,,pkmn_shitpost,0,2,2,0,2,2,0,0,1,1,1,0
3796,,,TheoTheGolden1,1,1,2,1,1,2,0,0.006687,0,0,0,0
3797,,,wmramsey,0,1,1,0,1,1,0,0,1,1,1,0
3798,,,ZhengYidan_,0,1,1,0,1,1,0,0,1,1,1,0
3799,,,GillelandKristi,0,2,2,0,2,2,0,0,1,1,1,0
3800,,,hyucksyang,2,1,3,2,1,3,0.5,0.013374,0,0,0,0
3801,,,MAC8800,0,1,1,0,1,1,0,0,1,1,1,0
3802,,,JOANNA0125,2,4,6,2,4,6,0.2,0.013374,3,0.5,0.558824,17
3803,,,erinmarie_xox,0,1,1,0,1,1,0,0,4,0.346154,0.384259,0
3804,,,JoseCar51340149,0,1,1,0,1,1,0,0,1,1,1,0
3805,,,TeamUSATracker,5,1,6,9,5,14,0.2,0.033436,0,0,0,0
3806,,,kostobell,0,1,1,0,1,1,0,0,1,1,1,0
3807,,,kbsez,3,1,4,3,1,4,0.333333,0.020061,0,0,0,0
3808,,,lmiancholy,0,1,1,0,1,1,0,0,1,1,1,0
3809,,,romiulloab,0,1,1,0,1,1,0,0,1,1,1,0
3810,,,kovertkookie,6,1,7,6,1,7,0.166667,0.040123,0,0,0,0
3811,,,TravelingGirl50,0,1,1,0,1,1,0,0,1,1,1,0
3812,,,bklovergirl,0,2,2,0,2,2,0,0,1,1,1,0
3813,,,satansbaII,0,1,1,0,1,1,0,0,1,1,1,0
3814,,,maelthemoon,3,3,6,3,3,6,0.2,0.020061,2,0.75,0.833333,6
3815,,,lixibian,0,1,1,0,1,1,0,0,3,0.5,0.583333,0
3816,,,JensenShots,1,1,2,1,1,2,0,0.006687,0,0,0,0
3817,,,SueKinMA,4,1,5,4,1,5,0.25,0.026749,0,0,0,0
3818,,,Anatgcf,0,1,1,0,1,1,0,0,1,1,1,0
3819,,,nuonuo11xd,0,2,2,0,2,2,0,0,1,1,1,0
3820,,,SKamalananthan,7,1,8,9,2,11,0.142857,0.04681,0,0,0,0
3821,,,Strabrrx,0,1,1,0,1,1,0,0,1,1,1,0
3822,,,tinybird21,0,1,1,0,2,2,0,0,1,1,1,0
3823,,,BaxterKing4,0,1,1,0,1,1,0,0,1,1,1,0
3824,,,boogieboogiewuu,4,1,5,4,1,5,0.25,0.026749,0,0,0,0
3825,,,Lemon90301773,0,1,1,0,1,1,0,0,1,1,1,0
3826,,,TZtQD2fte4qLLXo,0,1,1,0,1,1,0,0,1,1,1,0
3827,,,sassy_mummy,0,1,1,0,1,1,0,0,1,1,1,0
3828,,,AmandaSxcks,0,2,2,0,2,2,0,0,1,1,1,0
3829,,,yuzu_san_fanyu,0,3,3,0,3,3,0,0,1,1,1,0
3830,,,iwantyoutohitme,0,1,1,0,1,1,0,0,1,1,1,0
3831,,,mminaeng,0,1,1,0,1,1,0,0,1,1,1,0
3832,,,Adriana65532966,0,1,1,0,1,1,0,0,1,1,1,0
3833,,,higurenomori,0,1,1,0,1,1,0,0,1,1,1,0
3834,,,DonnaJoWilliams,0,1,1,0,1,1,0,0,1,1,1,0
3835,,,toracha7,0,1,1,0,1,1,0,0,1,1,1,0
3836,,,Slate,20,1,21,22,3,25,0.05,0.133743,0,0,0,0
3837,,,AdakCharley,0,1,1,0,1,1,0,0,1,1,1,0
3838,,,edwardallenmir1,0,1,1,0,1,1,0,0,1,1,1,0
3839,,,ebisonokonyomm,0,1,1,0,1,1,0,0,1,1,1,0
3840,,,chloeskating,0,1,1,0,1,1,0,0,1,1,1,0
3841,,,is_this_real11,3,1,4,3,1,4,0.333333,0.020061,0,0,0,0
3842,,,WQ5bs9tbzDQAg58,0,1,1,0,1,1,0,0,1,1,1,0
3843,,,Medishurahan,2,1,3,3,2,5,0.5,0.013374,0,0,0,0
3844,,,gfrnita,0,1,1,0,1,1,0,0,1,1,1,0
3845,,,steeldieman,2,1,3,2,1,3,0.5,0.013374,0,0,0,0
3846,,,nmpforever,0,1,1,0,1,1,0,0,1,1,1,0
3847,,,dashingwhippets,7,1,8,7,1,8,0.142857,0.057293,0,0,0,0
3848,,,S9upNaTyr2owf1q,0,1,1,0,1,1,0,0,1,1,1,0
3849,,,bornbama72,0,1,1,0,1,1,0,0,1,1,1,0
3850,,,AdultInvesting,0,1,1,0,1,1,0,0,1,1,1,0
3851,,,kingliang6689,0,1,1,0,1,1,0,0,1,1,1,0
3852,,,spotavia,0,2,2,0,2,2,0,0,1,1,1,0
3853,,,sycipft,2,1,3,3,2,5,0.5,0.013374,0,0,0,0
3854,,,espinacas,3,1,4,3,1,4,0.333333,0.020061,0,0,0,0
3855,,,alexa_lanuza,0,1,1,0,1,1,0,0,1,1,1,0
3856,,,chanellawhore,0,1,1,0,1,1,0,0,1,1,1,0
3857,,,phailinli,2,1,3,2,1,3,0.5,0.013374,0,0,0,0
3858,,,cheollieswrld,0,1,1,0,1,1,0,0,1,1,1,0
3859,,,HanyuElla,1,1,2,1,1,2,0,0.006687,0,0,0,0
3860,,,jenn24w,2,1,3,2,1,3,0.5,0.013374,0,0,0,0
3861,,,magical_bears,0,2,2,0,2,2,0,0,1,1,1,0
3862,,,foolishduck3,1,1,2,1,1,2,0,0.006687,0,0,0,0
3863,,,alice_v_smith,1,1,2,1,1,2,0,0.006687,0,0,0,0
3864,,,Tara_Shinhye,3,1,4,3,1,4,0.333333,0.037533,0,0,0,0
3865,,,fanyuuuu_,0,1,1,0,1,1,0,0,1,1,1,0
3866,,,ElectroniMusic1,1,1,2,1,1,2,0,0.006687,0,0,0,0
3867,,,leaderizjichu,1,1,2,1,1,2,0,0.006687,0,0,0,0
3868,,,xyyy_potato,7,1,8,8,1,9,0.142857,0.04681,0,0,0,0
3869,,,onegoodkat,0,1,1,0,1,1,0,0,1,1,1,0
3870,,,trytobeinlove,0,1,1,0,1,1,0,0,1,1,1,0
3871,,,SilverBlue32,0,2,2,0,2,2,0,0,1,1,1,0
3872,,,Yo0nnation,0,2,2,0,2,2,0,0,1,1,1,0
3873,,,purpleeTaebear,0,2,2,0,2,2,0,0,1,1,1,0
3874,,,RudeJudy2,0,1,1,0,2,2,0,0,1,1,1,0
3875,,,viventii,3,1,4,3,1,4,0.333333,0.020061,0,0,0,0
3876,,,CheRoza,2,1,3,2,1,3,0.5,0.013374,0,0,0,0
3877,,,Jupajujube,0,1,1,0,1,1,0,0,1,1,1,0
3878,,,mollymay42,4,1,5,4,1,5,0.25,0.026749,0,0,0,0
3879,,,polinahowlwlRMD,0,1,1,0,1,1,0,0,1,1,1,0
3880,,,TurhRobert,1,1,2,1,1,2,0,0.006687,0,0,0,0
3881,,,10VELIER,0,1,1,0,1,1,0,0,1,1,1,0
3882,,,Forgetmenot0822,0,2,2,0,2,2,0,0,1,1,1,0
3883,,,ktbaeohana1,0,2,2,0,2,2,0,0,1,1,1,0
3884,,,nonaenaenae,0,1,1,0,1,1,0,0,1,1,1,0
3885,,,joy00569,0,1,1,0,1,1,0,0,1,1,1,0
3886,,,yuzurvhanyu,2,2,4,2,2,4,0.333333,0.013374,1,1,1,1
3887,,,_youngsleepy,0,1,1,0,1,1,0,0,2,0.666667,0.75,0
3888,,,Mint_choosay,0,1,1,0,1,1,0,0,1,1,1,0
3889,,,Purp1eHeartae,0,1,1,0,1,1,0,0,1,1,1,0
3890,,,dilucx,0,2,2,0,2,2,0,0,2,0.538462,0.571429,0
3891,,,autumn_ccg,1,1,2,1,1,2,0,0.006687,0,0,0,0
3892,,,sunsetcIub,3,2,5,3,2,5,0.25,0.020061,1,1,1,2
3893,,,Genesys62723954,0,1,1,0,1,1,0,0,2,0.666667,0.75,0
3894,,,shomaUNO111,0,1,1,0,1,1,0,0,2,0.666667,0.75,0
3895,,,_darthvaper,9,1,10,10,2,12,0.111111,0.060184,0,0,0,0
3896,,,tummyroof2015,0,1,1,0,1,1,0,0,1,1,1,0
3897,,,nV3biXQeku3iTz8,0,1,1,0,1,1,0,0,1,1,1,0
3898,,,Americanopleasu,0,1,1,0,1,1,0,0,1,1,1,0
3899,,,gl0ssgoogie,0,1,1,0,1,1,0,0,1,1,1,0
3900,,,daviemurrey,0,1,1,0,1,1,0,0,1,1,1,0
3901,,,kellee_maria,0,1,1,0,1,1,0,0,1,1,1,0
3902,,,koyafm,2,1,3,2,1,3,0.5,0.013374,0,0,0,0
3903,,,irissocy,0,1,1,0,1,1,0,0,1,1,1,0
3904,,,Butters360,2,1,3,3,2,5,0.5,0.013374,0,0,0,0
3905,,,Glo1859,0,1,1,0,1,1,0,0,1,1,1,0
3906,,,_ccchanggg_,2,1,3,2,1,3,0.5,0.013374,0,0,0,0
3907,,,ElsaSk8s,0,1,1,0,1,1,0,0,1,1,1,0
3908,,,TainyTalk,0,1,1,0,1,1,0,0,1,1,1,0
3909,,,Charlottes_Mimi,0,1,1,0,1,1,0,0,1,1,1,0
3910,,,leonten_,0,1,1,0,1,1,0,0,1,1,1,0
3911,,,iL0VEMINSG,0,2,2,0,2,2,0,0,1,1,1,0
3912,,,moonlight21__,0,1,1,0,1,1,0,0,1,1,1,0
3913,,,Doraemonpika,0,4,4,0,4,4,0,0,1,1,1,0
3914,,,Maikoooovilla,0,1,1,0,1,1,0,0,1,1,1,0
3915,,,tsukihoshi14,1,1,2,1,1,2,0,0.006687,0,0,0,0
3916,,,hyunnee_j,0,1,1,0,1,1,0,0,1,1,1,0
3917,,,Taeten_cult,0,1,1,0,1,1,0,0,1,1,1,0
3918,,,jlCKpZOvabgNp8B,0,1,1,0,1,1,0,0,1,1,1,0
3919,,,10veholics,0,1,1,0,1,1,0,0,1,1,1,0
3920,,,JTwaitingU,0,1,1,0,1,1,0,0,1,1,1,0
3921,,,ato_ten,0,1,1,0,1,1,0,0,1,1,1,0
3922,,,EShay79,0,1,1,0,1,1,0,0,1,1,1,0
3923,,,f_richard_green,0,1,1,0,1,1,0,0,1,1,1,0
3924,,,Robgrady3,0,1,1,0,1,1,0,0,1,1,1,0
3925,,,QuadrupleAxels,15,1,16,17,1,18,0.066667,0.100307,0,0,0,0
3926,,,tighee1,0,1,1,0,2,2,0,0,1,1,1,0
3927,,,tensfly,0,1,1,0,1,1,0,0,1,1,1,0
3928,,,bkal911,0,1,1,0,1,1,0,0,1,1,1,0
3929,,,ulthonoka,0,1,1,0,1,1,0,0,1,1,1,0
3930,,,ericsosag,0,1,1,0,1,1,0,0,1,1,1,0
3931,,,DavidPetr4,0,1,1,0,1,1,0,0,1,1,1,0
3932,,,Dorothy20012271,0,1,1,0,1,1,0,0,1,1,1,0
3933,,,sonicsmacksass,0,1,1,0,1,1,0,0,1,1,1,0
3934,,,DhLadylaw,0,1,1,0,1,1,0,0,1,1,1,0
3935,,,frontroyalgirl,0,1,1,0,2,2,0,0,1,1,1,0
3936,,,lacyrice2,0,1,1,0,1,1,0,0,1,1,1,0
3937,,,liu24409157,0,1,1,0,1,1,0,0,1,1,1,0
3938,,,kiwi_egg,0,1,1,0,1,1,0,0,1,1,1,0
3939,,,nabichwe,1,1,2,1,1,2,0,0.006687,0,0,0,0
3940,,,nosecrinkleyuzu,2,1,3,3,2,5,0.5,0.013374,0,0,0,0
3941,,,doctorawinter,2,1,3,2,1,3,0.5,0.013374,0,0,0,0
3942,,,beomflrt,0,1,1,0,1,1,0,0,1,1,1,0
3943,,,HUANGMAID,3,1,4,3,1,4,0.333333,0.020061,0,0,0,0
3944,,,Mstan7A,0,1,1,0,1,1,0,0,2,0.666667,0.75,0
3945,,,Ypparii,0,1,1,0,1,1,0,0,2,0.666667,0.75,0
3946,,,zxjkws,0,2,2,0,3,3,0,0,2,0.75,0.833333,0
3947,,,levispridevans,0,1,1,0,1,1,0,0,2,0.666667,0.75,0
3948,,,rolowrld,0,1,1,0,3,3,0,0,2,0.666667,0.75,0
3949,,,AytchAnd,1,1,2,1,1,2,0,0.006687,0,0,0,0
3950,,,treashka,0,1,1,0,1,1,0,0,1,1,1,0
3951,,,ataeyna,4,1,5,4,1,5,0.25,0.026749,0,0,0,0
3952,,,hartjej,0,1,1,0,1,1,0,0,1,1,1,0
3953,,,Voldemort_M0NEY,0,1,1,0,1,1,0,0,1,1,1,0
3954,,,heyyyyitsjojo,0,2,2,0,2,2,0,0,2,0.75,0.833333,0
3955,,,nottetstears,0,2,2,0,2,2,0,0,1,1,1,0
3956,,,blupuddy,9,2,11,12,5,17,0.1,0.060184,1,1,1,8
3957,,,Ltytenswift,0,1,1,0,1,1,0,0,2,0.666667,0.75,0
3958,,,pyrovskyy,7,1,8,7,1,8,0.142857,0.04681,0,0,0,0
3959,,,ksoorotonin,0,1,1,0,1,1,0,0,1,1,1,0
3960,,,LoveTEN16,0,1,1,0,1,1,0,0,1,1,1,0
3961,,,Kittybal199,0,1,1,0,1,1,0,0,1,1,1,0
3962,,,Tennie_001,0,1,1,0,1,1,0,0,1,1,1,0
3963,,,10soIo,0,1,1,0,1,1,0,0,1,1,1,0
3964,,,alexis_jc2000,2,1,3,2,1,3,0.5,0.013374,0,0,0,0
3965,,,suarasangpagi,0,1,1,0,1,1,0,0,1,1,1,0
3966,,,JacobDS96,9,1,10,9,1,10,0.111111,0.060184,0,0,0,0
3967,,,kzy050322,0,1,1,0,1,1,0,0,1,1,1,0
3968,,,satoringo20,0,3,3,0,3,3,0,0,2,0.8,0.875,0
3969,,,AdisTjan,0,1,1,0,1,1,0,0,1,1,1,0
3970,,,mxkaira,0,1,1,0,1,1,0,0,1,1,1,0
3971,,,Ame_Mitsurugi,0,2,2,0,2,2,0,0,1,1,1,0
3972,,,Se_Ri_Min,0,7,7,0,9,9,0,0,2,0.888889,0.9375,0
3973,,,akko_who,0,3,3,0,3,3,0,0,2,0.8,0.875,0
3974,,,Mary89980299,0,1,1,0,1,1,0,0,1,1,1,0
3975,,,yaemikussi,9,1,10,9,1,10,0.111111,0.063679,0,0,0,0
3976,,,yuzu_ranshida,0,1,1,0,1,1,0,0,1,1,1,0
3977,,,Smilenewa,0,1,1,0,1,1,0,0,1,1,1,0
3978,,,YumisukeK,0,1,1,0,1,1,0,0,1,1,1,0
3979,,,graceadampr,0,1,1,0,1,1,0,0,1,1,1,0
3980,,,ponponponpnn,0,3,3,0,3,3,0,0,1,1,1,0
3981,,,Aim4changesc,0,1,1,0,1,1,0,0,1,1,1,0
3982,,,3neetee,0,1,1,0,1,1,0,0,1,1,1,0
3983,,,mcrcspector,1,1,2,1,1,2,0,0.006687,0,0,0,0
3984,,,BlueRendition,3,1,4,4,1,5,0.333333,0.020061,0,0,0,0
3985,,,Djawms42J,0,1,1,0,2,2,0,0,1,1,1,0
3986,,,rossnow77,0,1,1,0,1,1,0,0,1,1,1,0
3987,,,debsails,2,1,3,2,1,3,0.5,0.013374,0,0,0,0
3988,,,darthreshiram,0,1,1,0,1,1,0,0,1,1,1,0
3989,,,loujian3,1,1,2,1,1,2,0,0.006687,0,0,0,0
3990,,,Daerves13,0,1,1,0,1,1,0,0,3,0.5,0.525641,0
3991,,,wdsdtmh,0,1,1,0,1,1,0,0,3,0.5,0.525641,0
3992,,,rachelratz,0,1,1,0,1,1,0,0,3,0.5,0.525641,0
3993,,,Loner6122,0,1,1,0,1,1,0,0,1,1,1,0
3994,,,iVoteChina,1,1,2,1,1,2,0,0.006687,0,0,0,0
3995,,,harryteng,2,1,3,3,2,5,0.5,0.013374,0,0,0,0
3996,,,nekoranpo,0,3,3,0,3,3,0,0,1,1,1,0
3997,,,Jongupshines,3,1,4,3,1,4,0.333333,0.020061,0,0,0,0
3998,,,haluca_0000,0,1,1,0,1,1,0,0,1,1,1,0
3999,,,yuzurubee,0,1,1,0,1,1,0,0,1,1,1,0
4000,,,MarielVGo,0,4,4,0,4,4,0,0,2,0.833333,0.9,0
4001,,,JohnxLee7890,0,1,1,0,1,1,0,0,1,1,1,0
4002,,,bluessluvq,0,4,4,0,4,4,0,0,2,0.75,0.833333,0
4003,,,WWXPatriarch,0,1,1,0,1,1,0,0,1,1,1,0
4004,,,MansberB,0,1,1,0,1,1,0,0,1,1,1,0
4005,,,Shelf_Clarence,1,1,2,1,1,2,0,0.006687,0,0,0,0
4006,,,beshr,4,1,5,4,1,5,0.25,0.048566,0,0,0,0
4007,,,drexelian,0,1,1,0,1,1,0,0,1,1,1,0
4008,,,nate199955,8,1,9,8,1,9,0,0.03168,1,1,1,8
4009,,,llurassi,0,1,1,0,1,1,0,0,1,1,1,0
4010,,,Shiromizukii1,0,1,1,0,1,1,0,0,1,1,1,0
4011,,,wanderinsouI,0,1,1,0,1,1,0,0,1,1,1,0
4012,,,Jack_Beitz,0,1,1,0,1,1,0,0,1,1,1,0
4013,,,urmomizblue_,0,1,1,0,1,1,0,0,1,1,1,0
4014,,,wangxia89905204,0,1,1,0,1,1,0,0,1,1,1,0
4015,,,leikmas,0,1,1,0,2,2,0,0,1,1,1,0
4016,,,deathntaxesprof,9,1,10,10,2,12,0.111111,0.060184,0,0,0,0
4017,,,brigttptri,0,1,1,0,1,1,0,0,1,1,1,0
4018,,,xoJikookox,0,1,1,0,1,1,0,0,1,1,1,0
4019,,,syhirahsm,0,2,2,0,2,2,0,0,1,1,1,0
4020,,,TadashiN_,0,2,2,0,2,2,0,0,1,1,1,0
4021,,,Beanie7,0,1,1,0,1,1,0,0,1,1,1,0
4022,,,b_ambivalence,0,4,4,0,4,4,0,0,2,0.571429,0.625,0
4023,,,y44676644,2,1,3,2,1,3,0.5,0.013374,0,0,0,0
4024,,,sevenrustynails,0,1,1,0,1,1,0,0,1,1,1,0
4025,,,jerfusha,3,1,4,4,2,6,0.333333,0.020061,0,0,0,0
4026,,,richiewertz,0,1,1,0,1,1,0,0,1,1,1,0
4027,,,Aloeclogue,0,1,1,0,1,1,0,0,1,1,1,0
4028,,,bubblysage,0,1,1,0,1,1,0,0,3,0.5,0.525641,0
4029,,,happyangel129,0,1,1,0,1,1,0,0,3,0.5,0.525641,0
4030,,,Delayed_Axel,5,3,8,5,3,8,0.142857,0.033436,3,0.518519,0.559524,56
4031,,,shixundoh,0,1,1,0,1,1,0,0,3,0.5,0.525641,0
4032,,,monastrology,7,1,8,7,1,8,0.142857,0.04681,0,0,0,0
4033,,,kkukkungie,0,1,1,0,1,1,0,0,1,1,1,0
4034,,,yuzuspiration,0,2,2,0,2,2,0,0,1,1,1,0
4035,,,inkiinmyheart,0,1,1,0,1,1,0,0,1,1,1,0
4036,,,WandererOwl,0,1,1,0,1,1,0,0,1,1,1,0
4037,,,ArmyBrat4,0,1,1,0,1,1,0,0,1,1,1,0
4038,,,Haiineko,0,1,1,0,1,1,0,0,1,1,1,0
4039,,,Moka05614162,0,2,2,0,2,2,0,0,1,1,1,0
4040,,,hanyuvx,0,1,1,0,1,1,0,0,1,1,1,0
4041,,,Royalt0326,0,1,1,0,1,1,0,0,1,1,1,0
4042,,,NYMag,3,1,4,3,1,4,0.333333,0.020061,0,0,0,0
4043,,,exactlynet,12,1,13,16,1,17,0.083333,0.080246,0,0,0,0
4044,,,beauandbiebs,0,1,1,0,1,1,0,0,1,1,1,0
4045,,,cartridgepink,0,1,1,0,1,1,0,0,1,1,1,0
4046,,,WrienP,0,2,2,0,3,3,0,0,1,1,1,0
4047,,,czengene_OwO,0,2,2,0,2,2,0,0,1,1,1,0
4048,,,Peggy2612,0,1,1,0,1,1,0,0,1,1,1,0
4049,,,kanasan14005431,0,1,1,0,1,1,0,0,1,1,1,0
4050,,,nbc0711,15,1,16,18,4,22,0.066667,0.114284,0,0,0,0
4051,,,SuddenDig,0,2,2,0,2,2,0,0,1,1,1,0
4052,,,NgaNguyen789,0,1,1,0,1,1,0,0,1,1,1,0
4053,,,hn_ktr_usg,0,1,1,0,1,1,0,0,1,1,1,0
4054,,,Shuu_pa,0,3,3,0,3,3,0,0,1,1,1,0
4055,,,FrancescaLive4,3,2,5,3,2,5,0.25,0.020061,1,1,1,2
4056,,,ani19_,3,1,4,3,1,4,0.333333,0.020061,0,0,0,0
4057,,,Hydrozzlespower,0,3,3,0,3,3,0,0,1,1,1,0
4058,,,FreerEleanor,0,1,1,0,1,1,0,0,1,1,1,0
4059,,,untilnextstop,6,1,7,6,1,7,0.166667,0.040123,0,0,0,0
4060,,,elleryheasd2,0,1,1,0,1,1,0,0,1,1,1,0
4061,,,KaoruJinki,0,1,1,0,1,1,0,0,1,1,1,0
4062,,,apple81yz,0,3,3,0,3,3,0,0,1,1,1,0
4063,,,ROSIExTiffanyco,0,2,2,0,2,2,0,0,1,1,1,0
4064,,,poIitebear,1,1,2,1,1,2,0,0.006687,0,0,0,0
4065,,,eyesbound,3,1,4,3,1,4,0.333333,0.020061,0,0,0,0
4066,,,SweetDepravity,0,1,1,0,1,1,0,0,1,1,1,0
4067,,,rrhh20122015,0,2,2,0,2,2,0,0,1,1,1,0
4068,,,aom2bpon,0,1,1,0,1,1,0,0,1,1,1,0
4069,,,cantilever1217,0,1,1,0,1,1,0,0,1,1,1,0
4070,,,SilxviaJ,0,2,2,0,2,2,0,0,2,0.75,0.833333,0
4071,,,GanbatteShimono,0,1,1,0,1,1,0,0,1,1,1,0
4072,,,mrchunyan,0,1,1,0,1,1,0,0,1,1,1,0
4073,,,MaskedRomancer,0,1,1,0,1,1,0,0,1,1,1,0
4074,,,ninieysharlleys,0,4,4,0,4,4,0,0,2,0.833333,0.9,0
4075,,,sleepingteddybe,0,2,2,0,2,2,0,0,1,1,1,0
4076,,,mtivnho,0,1,1,0,1,1,0,0,1,1,1,0
4077,,,maotaro1229,0,2,2,0,2,2,0,0,1,1,1,0
4078,,,ffkuma,0,1,1,0,1,1,0,0,2,0.666667,0.75,0
4079,,,nowlahh,0,1,1,0,3,3,0,0,2,0.666667,0.75,0
4080,,,sohaiillust,0,2,2,0,2,2,0,0,2,0.75,0.833333,0
4081,,,_lunahime_,0,2,2,0,2,2,0,0,2,0.666667,0.75,0
4082,,,angela2013b,0,1,1,0,1,1,0,0,2,0.666667,0.75,0
4083,,,No2stupid,2,1,3,2,1,3,0.5,0.013374,0,0,0,0
4084,,,dksoulmusic,0,4,4,0,4,4,0,0,2,0.833333,0.9,0
4085,,,bb_vyld,0,2,2,0,8,8,0,0,2,0.75,0.833333,0
4086,,,eden_echo,0,1,1,0,1,1,0,0,2,0.666667,0.75,0
4087,,,LenaHC09,0,1,1,0,1,1,0,0,2,0.666667,0.75,0
4088,,,meg294n,0,1,1,0,1,1,0,0,2,0.666667,0.75,0
4089,,,alwysBWithU,0,2,2,0,2,2,0,0,2,0.75,0.833333,0
4090,,,I57uhiw5lDB0GsD,0,2,2,0,2,2,0,0,2,0.75,0.833333,0
4091,,,obseann,0,1,1,0,1,1,0,0,2,0.666667,0.75,0
4092,,,JKVOC,0,2,2,0,2,2,0,0,2,0.75,0.833333,0
4093,,,cheripiepikachu,0,1,1,0,1,1,0,0,2,0.666667,0.75,0
4094,,,Nectar_Gan,0,2,2,0,2,2,0,0,2,0.75,0.833333,0
4095,,,m1koii,0,1,1,0,1,1,0,0,2,0.666667,0.75,0
4096,,,mimachi,0,1,1,0,1,1,0,0,2,0.666667,0.75,0
4097,,,jiminer_fanyu,0,1,1,0,1,1,0,0,2,0.666667,0.75,0
4098,,,itsdidibitches2,0,1,1,0,1,1,0,0,1,1,1,0
4099,,,lv780317,0,1,1,0,1,1,0,0,1,1,1,0
4100,,,aalifatik,0,2,2,0,2,2,0,0,1,1,1,0
4101,,,L67tu,2,1,3,2,1,3,0.5,0.013374,0,0,0,0
4102,,,hazalsouvenir,0,1,1,0,1,1,0,0,1,1,1,0
4103,,,matsu_miruru,0,1,1,0,1,1,0,0,1,1,1,0
4104,,,svtellie,0,1,1,0,1,1,0,0,1,1,1,0
4105,,,feidanie,0,1,1,0,1,1,0,0,1,1,1,0
4106,,,ennunanaiurov,1,1,2,1,1,2,0,0.006687,0,0,0,0
4107,,,SherinTjiunardi,0,1,1,0,1,1,0,0,1,1,1,0
4108,,,Wincess__,0,1,1,0,1,1,0,0,1,1,1,0
4109,,,itsmarklipasan,0,1,1,0,1,1,0,0,1,1,1,0
4110,,,lst_account,0,2,2,0,2,2,0,0,1,1,1,0
4111,,,beelysis,0,1,1,0,1,1,0,0,1,1,1,0
4112,,,_AutumnPark_,4,1,5,6,3,9,0.25,0.026749,0,0,0,0
4113,,,aestaeticcs_,0,1,1,0,1,1,0,0,1,1,1,0
4114,,,Faii_Sayuri,0,1,1,0,1,1,0,0,1,1,1,0
4115,,,fuyunzhaolu,0,1,1,0,1,1,0,0,1,1,1,0
4116,,,xerxcq,2,8,10,3,11,14,0.111111,0.013374,1,1,1,7
4117,,,tiannu_hua,0,3,3,0,3,3,0,0,1,1,1,0
4118,,,kaorispiral,0,1,1,0,1,1,0,0,1,1,1,0
4119,,,coraline0904,0,1,1,0,1,1,0,0,1,1,1,0
4120,,,onigirimiyass,0,1,1,0,1,1,0,0,1,1,1,0
4121,,,FSJuice7858,0,1,1,0,1,1,0,0,1,1,1,0
4122,,,MHEvansGreen14,4,1,5,4,1,5,0.25,0.109945,0,0,0,0
4123,,,Hahayou15356897,1,1,2,1,1,2,0,0.006687,0,0,0,0
4124,,,HadeanTide,2,1,3,2,1,3,0.5,0.013374,0,0,0,0
4125,,,Mytiger8888,11,1,12,13,3,16,0.090909,0.08174,0,0,0,0
4126,,,spokesmash,0,1,1,0,1,1,0,0,1,1,1,0
4127,,,Katheri48033429,0,1,1,0,1,1,0,0,1,1,1,0
4128,,,txtinyeonjun,10,1,11,10,1,11,0.1,0.150068,0,0,0,0
4129,,,elegant_skaters,0,1,1,0,1,1,0,0,1,1,1,0
4130,,,ProfSunnySingh,0,1,1,0,1,1,0,0,1,1,1,0
4131,,,tashirokouji,0,1,1,0,1,1,0,0,1,1,1,0
4132,,,veautifully_me,0,1,1,0,1,1,0,0,1,1,1,0
4133,,,S0_hannah13,0,3,3,0,3,3,0,0,1,1,1,0
4134,,,Fifi80174521,0,2,2,0,2,2,0,0,1,1,1,0
4135,,,kuroakacoco,0,1,1,0,1,1,0,0,1,1,1,0
4136,,,Katherine_Yuki,0,1,1,0,1,1,0,0,2,0.666667,0.75,0
4137,,,junmon4,0,2,2,0,2,2,0,0,2,0.75,0.833333,0
4138,,,Ila23292685,0,1,1,0,1,1,0,0,2,0.666667,0.75,0
4139,,,YEHET50324566,0,1,1,0,1,1,0,0,2,0.666667,0.75,0
4140,,,s3oiaa,0,1,1,0,1,1,0,0,2,0.666667,0.75,0
4141,,,kawaikunai_mono,0,1,1,0,1,1,0,0,2,0.666667,0.75,0
4142,,,feedthecath,0,1,1,0,1,1,0,0,2,0.666667,0.75,0
4143,,,Y4life1984,0,1,1,0,1,1,0,0,2,0.666667,0.75,0
4144,,,yuuzuuwu,0,1,1,0,1,1,0,0,2,0.666667,0.75,0
4145,,,hydrobladeking,1,1,2,1,1,2,0,0.006687,0,0,0,0
4146,,,DanielYorkLoh,7,1,8,7,1,8,0.142857,0.078258,0,0,0,0
4147,,,kwbtt,0,1,1,0,1,1,0,0,1,1,1,0
4148,,,mu790970usman,0,2,2,0,3,3,0,0,1,1,1,0
4149,,,wglegendspt2,0,1,1,0,1,1,0,0,1,1,1,0
4150,,,maosyoumao,0,1,1,0,1,1,0,0,1,1,1,0
4151,,,eggmegegg,1,1,2,1,1,2,0,0.006687,0,0,0,0
4152,,,fatimaAbuAli1,10,1,11,11,2,13,0.1,0.091945,0,0,0,0
4153,,,vzbvmBx3lH7aI95,0,2,2,0,2,2,0,0,1,1,1,0
4154,,,SongaMomoh,0,1,1,0,1,1,0,0,1,1,1,0
4155,,,yunakoroleva,3,2,5,3,2,5,0.25,0.020061,1,1,1,2
4156,,,MrsDo1288,0,4,4,0,4,4,0,0,1,1,1,0
4157,,,kanonn963,0,1,1,0,1,1,0,0,1,1,1,0
4158,,,miranda_xixc,1,1,2,1,1,2,0,0.006687,0,0,0,0
4159,,,FerrerMafehn,5,1,6,5,1,6,0.2,0.033436,0,0,0,0
4160,,,8U57dqfft96cytF,0,5,5,0,5,5,0,0,1,1,1,0
4161,,,sushimonojoonie,0,1,1,0,1,1,0,0,1,1,1,0
4162,,,hanyuzuruchan,0,4,4,0,4,4,0,0,1,1,1,0
4163,,,_Dechta,2,1,3,2,1,3,0.5,0.013374,0,0,0,0
4164,,,fanyiyi33,19,1,20,25,7,32,0.052632,0.146061,0,0,0,0
4165,,,yennyplanet,1,2,3,1,2,3,0.5,0.006687,1,1,1,0
4166,,,William60378254,7,1,8,8,2,10,0.142857,0.04681,0,0,0,0
4167,,,ShomaGanba,0,1,1,0,1,1,0,0,1,1,1,0
4168,,,hanbintheclouds,0,1,1,0,1,1,0,0,1,1,1,0
4169,,,JennyRa44746734,0,1,1,0,1,1,0,0,1,1,1,0
4170,,,vmkjaan,1,1,2,1,1,2,0,0.006687,0,0,0,0
4171,,,JoshjReynolds2,0,2,2,0,2,2,0,0,1,1,1,0
4172,,,Icesk8r_Whit,0,1,1,0,1,1,0,0,1,1,1,0
4173,,,ia_diego,3,1,4,4,2,6,0.333333,0.020061,0,0,0,0
4174,,,mika244tkuno1,0,1,1,0,1,1,0,0,1,1,1,0
4175,,,finalfantasxx,2,1,3,2,1,3,0.5,0.013374,0,0,0,0
4176,,,lack_of_summer,0,1,1,0,1,1,0,0,1,1,1,0
4177,,,DigitalClusterz,9,1,10,10,2,12,0.111111,0.143381,0,0,0,0
4178,,,yokoyuika1,0,1,1,0,1,1,0,0,1,1,1,0
4179,,,Lovekawaiieh,0,2,2,0,2,2,0,0,1,1,1,0
4180,,,cheolattes,7,1,8,7,1,8,0.142857,0.054992,0,0,0,0
4181,,,yoko21450522,0,1,1,0,1,1,0,0,1,1,1,0
4182,,,willehelmwonka,4,1,5,4,1,5,0.25,0.026749,0,0,0,0
4183,,,cGRNmgQG43SEzDP,0,5,5,0,5,5,0,0,1,1,1,0
4184,,,dd_627,0,1,1,0,1,1,0,0,1,1,1,0
4185,,,konfusedkarrot,0,2,2,0,2,2,0,0,1,1,1,0
4186,,,fleurimins,0,2,2,0,2,2,0,0,1,1,1,0
4187,,,ViralCuts,3,1,4,4,2,6,0.333333,0.020061,0,0,0,0
4188,,,seven_se_ven,0,4,4,0,4,4,0,0,1,1,1,0
4189,,,Svsn2611,6,1,7,7,2,9,0.166667,0.040123,0,0,0,0
4190,,,QueerGang2,0,1,1,0,1,1,0,0,1,1,1,0
4191,,,yeorluvr,0,1,1,0,1,1,0,0,1,1,1,0
4192,,,jcksnjhn,0,2,2,0,2,2,0,0,1,1,1,0
4193,,,YMPAWS,0,4,4,0,5,5,0,0,1,1,1,0
4194,,,yuzuruakgae,0,2,2,0,2,2,0,0,2,0.555556,0.6,0
4195,,,SkyNetPlatform,12,1,13,13,2,15,0.083333,0.094223,0,0,0,0
4196,,,Barbie9404,0,2,2,0,2,2,0,0,1,1,1,0
4197,,,unfoldhigher,4,1,5,4,1,5,0.25,0.026749,0,0,0,0
4198,,,MegFelsing,0,1,1,0,1,1,0,0,1,1,1,0
4199,,,yukiisazuki,1,2,3,1,2,3,0.5,0.006687,1,1,1,0
4200,,,ClairvoyantWave,4,1,5,4,1,5,0.25,0.026749,0,0,0,0
4201,,,baker_jules54,0,1,1,0,1,1,0,0,1,1,1,0
4202,,,nyniushka,0,1,1,0,1,1,0,0,1,1,1,0
4203,,,badnatash,0,1,1,0,1,1,0,0,1,1,1,0
4204,,,DJSspeaks,2,1,3,2,1,3,0.5,0.013374,0,0,0,0
4205,,,rikakihira,1,1,2,1,1,2,0,0.006687,0,0,0,0
4206,,,LOVE_BEER_1126,0,3,3,0,3,3,0,0,1,1,1,0
4207,,,hectorjmbw,1,2,3,1,2,3,0.5,0.006687,1,1,1,0
4208,,,shomasatoanna,0,1,1,0,1,1,0,0,1,1,1,0
4209,,,dlcmh,0,4,4,0,4,4,0,0,1,1,1,0
4210,,,skate_shoma17,0,2,2,0,2,2,0,0,1,1,1,0
4211,,,SilverEyedFufu,2,1,3,2,1,3,0.5,0.013374,0,0,0,0
4212,,,ReenieOnIce,3,1,4,3,1,4,0.333333,0.020061,0,0,0,0
4213,,,pikachusandile8,0,1,1,0,1,1,0,0,1,1,1,0
4214,,,kanaemarimura,0,1,1,0,1,1,0,0,1,1,1,0
4215,,,Enjoythemayoo,0,3,3,0,3,3,0,0,1,1,1,0
4216,,,pocky244love,0,3,3,0,3,3,0,0,2,0.714286,0.8,0
4217,,,Cozy0505,0,1,1,0,1,1,0,0,1,1,1,0
4218,,,anas_erindra,0,2,2,0,2,2,0,0,1,1,1,0
4219,,,verona_pro_sec,0,1,1,0,1,1,0,0,1,1,1,0
4220,,,DJBangHimUpLo,0,1,1,0,1,1,0,0,1,1,1,0
4221,,,QooQoo06971324,0,1,1,0,1,1,0,0,2,0.666667,0.75,0
4222,,,loofishy,2,1,3,2,1,3,0.5,0.013374,0,0,0,0
4223,,,akamebae,0,1,1,0,1,1,0,0,1,1,1,0
4224,,,JlNZHONGXIE,7,5,12,8,6,14,0.090909,0.060787,1,1,1,36
4225,,,Julie_AT1,4,2,6,6,4,10,0.2,0.026749,2,0.555556,0.6,15
4226,,,vilukiki,0,1,1,0,1,1,0,0,2,0.555556,0.6,0
4227,,,SipOfKoKo,4,1,5,5,1,6,0.25,0.026749,0,0,0,0
4228,,,RozhinB_TS,0,1,1,0,1,1,0,0,1,1,1,0
4229,,,MyDCANews,0,3,3,0,3,3,0,0,1,1,1,0
4230,,,blu4getmachine,4,1,5,4,1,5,0.25,0.026749,0,0,0,0
4231,,,tecknode,0,1,1,0,1,1,0,0,1,1,1,0
4232,,,ponyokkuma12,0,2,2,0,2,2,0,0,4,0.372093,0.432292,0
4233,,,SharonSeattle,0,1,1,0,1,1,0,0,4,0.357143,0.394444,0
4234,,,tara29461204,0,1,1,0,1,1,0,0,4,0.357143,0.394444,0
4235,,,JasonnarT,24,1,25,25,1,26,0.041667,0.191939,0,0,0,0
4236,,,Gugu43795262,0,1,1,0,1,1,0,0,1,1,1,0
4237,,,natsuzora_oniku,0,1,1,0,1,1,0,0,1,1,1,0
4238,,,ONY5ZYTdazZiKsA,0,2,2,0,2,2,0,0,1,1,1,0
4239,,,UC1418,0,1,1,0,1,1,0,0,1,1,1,0
4240,,,Coeyuzu2,0,1,1,0,1,1,0,0,1,1,1,0
4241,,,tpGonJ9bnu7IbUr,0,1,1,0,1,1,0,0,1,1,1,0
4242,,,3zud4YevChWrNHH,0,1,1,0,1,1,0,0,1,1,1,0
4243,,,hanyu_941207,0,1,1,0,1,1,0,0,1,1,1,0
4244,,,Hanyurukiaaa,0,1,1,0,2,2,0,0,1,1,1,0
4245,,,csyLAZhixS0ISFN,0,1,1,0,1,1,0,0,1,1,1,0
4246,,,taako1230,0,2,2,0,2,2,0,0,1,1,1,0
4247,,,tow_co,0,1,1,0,1,1,0,0,1,1,1,0
4248,,,Pannnita,0,1,1,0,1,1,0,0,1,1,1,0
4249,,,RLAS19,0,1,1,0,1,1,0,0,1,1,1,0
4250,,,CulhkvCgENm0ZdQ,0,1,1,0,1,1,0,0,1,1,1,0
4251,,,NANASHO15,0,3,3,0,3,3,0,0,1,1,1,0
4252,,,Tsubamedokyoto,0,2,2,0,2,2,0,0,1,1,1,0
4253,,,fssennoga,1,1,2,1,1,2,0,0.006687,0,0,0,0
4254,,,dabydeen,8,1,9,9,1,10,0.125,0.053497,0,0,0,0
4255,,,LeonardoAraiz19,0,1,1,0,1,1,0,0,1,1,1,0
4256,,,summeryuzus,0,7,7,0,7,7,0,0,1,1,1,0
4257,,,WhitloweD,0,1,1,0,1,1,0,0,1,1,1,0
4258,,,prodbyjk97,0,2,2,0,3,3,0,0,1,1,1,0
4259,,,W6HSwiZcwCm4gN7,0,2,2,0,2,2,0,0,1,1,1,0
4260,,,Elyrian_XIII,0,3,3,0,3,3,0,0,1,1,1,0
4261,,,OptimalWin,0,1,1,0,1,1,0,0,1,1,1,0
4262,,,animegaybois,6,1,7,6,1,7,0.166667,0.043617,0,0,0,0
4263,,,bingqiqilin,1,2,3,1,2,3,0.5,0.006687,1,1,1,0
4264,,,AnsisEgle,0,2,2,0,2,2,0,0,1,1,1,0
4265,,,sweetisme3,1,1,2,1,1,2,0,0.006687,0,0,0,0
4266,,,malafunkshun808,22,1,23,24,2,26,0.045455,0.155299,0,0,0,0
4267,,,petitmorimi,0,1,1,0,1,1,0,0,1,1,1,0
4268,,,dzELBOs_0,0,1,1,0,1,1,0,0,1,1,1,0
4269,,,DeniseKSkladany,0,1,1,0,1,1,0,0,1,1,1,0
4270,,,LilyGrace_6610,0,1,1,0,1,1,0,0,1,1,1,0
4271,,,nbcwashington,22,1,23,26,5,31,0.045455,0.160327,0,0,0,0
4272,,,waka__chang,0,1,1,0,1,1,0,0,1,1,1,0
4273,,,2hzUinpFLLFEc96,0,2,2,0,2,2,0,0,3,0.529412,0.592593,0
4274,,,HoneyFairyRoses,0,1,1,0,1,1,0,0,1,1,1,0
4275,,,bluehea56741503,0,1,1,0,1,1,0,0,1,1,1,0
4276,,,hmzero5,0,3,3,0,3,3,0,0,3,0.583333,0.690476,0
4277,,,Succinite15,6,1,7,7,1,8,0.166667,0.0541,0,0,0,0
4278,,,naomima4789,0,3,3,0,3,3,0,0,1,1,1,0
4279,,,Elizabe53836129,0,1,1,0,1,1,0,0,1,1,1,0
4280,,,Monciciiiiii,0,1,1,0,1,1,0,0,1,1,1,0
4281,,,forninexiaojiu,0,1,1,0,1,1,0,0,1,1,1,0
4282,,,x_q_q_,0,1,1,0,1,1,0,0,1,1,1,0
4283,,,beberui216,0,1,1,0,1,1,0,0,1,1,1,0
4284,,,Jx689gVOedB4ODM,0,1,1,0,1,1,0,0,1,1,1,0
4285,,,MachSunday,0,1,1,0,1,1,0,0,1,1,1,0
4286,,,yutakun123,0,1,1,0,1,1,0,0,1,1,1,0
4287,,,Dyune_1207,0,1,1,0,1,1,0,0,1,1,1,0
4288,,,hanan_11721,0,3,3,0,3,3,0,0,1,1,1,0
4289,,,shomakiyon_519,0,1,1,0,1,1,0,0,1,1,1,0
4290,,,honu0223,0,2,2,0,2,2,0,0,1,1,1,0
4291,,,yuma_love_0505,0,1,1,0,1,1,0,0,1,1,1,0
4292,,,stoonhkhk,0,2,2,0,2,2,0,0,1,1,1,0
4293,,,sakumariko,0,1,1,0,1,1,0,0,1,1,1,0
4294,,,shoma_fan,0,4,4,0,4,4,0,0,2,0.7,0.785714,0
4295,,,sako3080,0,3,3,0,3,3,0,0,1,1,1,0
4296,,,Mike_neko111,0,3,3,0,3,3,0,0,1,1,1,0
4297,,,suokjn,0,1,1,0,1,1,0,0,1,1,1,0
4298,,,sakurasouma87,0,1,1,0,1,1,0,0,1,1,1,0
4299,,,perfect_life_69,0,1,1,0,1,1,0,0,1,1,1,0
4300,,,sadao0112,0,1,1,0,1,1,0,0,2,0.666667,0.75,0
4301,,,AyumiTangmen,0,1,1,0,1,1,0,0,2,0.6,0.666667,0
4302,,,__zsxa,0,1,1,0,1,1,0,0,2,0.6,0.666667,0
4303,,,astrdb612,0,1,1,0,1,1,0,0,2,0.6,0.666667,0
4304,,,padaignault,8,1,9,8,1,9,0.125,0.077957,0,0,0,0
4305,,,hs9953,0,1,1,0,1,1,0,0,1,1,1,0
4306,,,hiroooo923,0,3,3,0,3,3,0,0,2,0.714286,0.8,0
4307,,,almondtang,0,1,1,0,1,1,0,0,1,1,1,0
4308,,,TrianaNero,0,1,1,0,1,1,0,0,1,1,1,0
4309,,,datagoodies,0,1,1,0,1,1,0,0,1,1,1,0
4310,,,lgbtqrippr,6,3,9,7,4,11,0.125,0.040123,1,1,1,10
4311,,,WhyRuso_Serious,5,1,6,5,1,6,0.2,0.033436,0,0,0,0
4312,,,milky_milky3,0,1,1,0,1,1,0,0,1,1,1,0
4313,,,haruhar87199821,0,1,1,0,1,1,0,0,1,1,1,0
4314,,,MarchPostings,0,1,1,0,1,1,0,0,1,1,1,0
4315,,,rendozvous,0,1,1,0,1,1,0,0,1,1,1,0
4316,,,kimlipiscool,2,1,3,2,1,3,0.5,0.03434,0,0,0,0
4317,,,gagawulala,3,1,4,3,1,4,0.333333,0.023556,0,0,0,0
4318,,,GracieNG2,0,1,1,0,1,1,0,0,1,1,1,0
4319,,,multi_idols7,0,1,1,0,1,1,0,0,2,0.6,0.666667,0
4320,,,mikrophoriia,0,1,1,0,1,1,0,0,2,0.6,0.666667,0
4321,,,b8keZfAwX71HlcV,0,1,1,0,1,1,0,0,2,0.6,0.666667,0
4322,,,totu_mama,0,1,1,0,1,1,0,0,2,0.6,0.666667,0
4323,,,jan_rhys,12,1,13,12,1,13,0.083333,0.1082,0,0,0,0
4324,,,VikkiMarshall4,0,1,1,0,1,1,0,0,1,1,1,0
4325,,,3bkforever,0,5,5,0,5,5,0,0,2,0.777778,0.857143,0
4326,,,angierrv,0,1,1,0,1,1,0,0,1,1,1,0
4327,,,GenieTango,0,1,1,0,1,1,0,0,1,1,1,0
4328,,,NelliesTrove,0,1,1,0,1,1,0,0,1,1,1,0
4329,,,shioriskate,0,1,1,0,1,1,0,0,1,1,1,0
4330,,,iffers_,0,1,1,0,1,1,0,0,1,1,1,0
4331,,,TheLeninOfLove,0,1,1,0,1,1,0,0,1,1,1,0
4332,,,honhonbonjour,0,1,1,0,1,1,0,0,1,1,1,0
4333,,,WatchTVAnywhere,1,1,2,1,1,2,0,0.006687,0,0,0,0
4334,,,ccming,3,1,4,3,1,4,0.333333,0.020061,0,0,0,0
4335,,,MomMusicMascara,1,1,2,1,1,2,0,0.006687,0,0,0,0
4336,,,RamZar1,7,1,8,7,1,8,0.142857,0.050304,0,0,0,0
4337,,,sachikosksk,0,1,1,0,1,1,0,0,1,1,1,0
4338,,,Lie111Zard,0,1,1,0,1,1,0,0,1,1,1,0
4339,,,Whenthe50930605,0,2,2,0,2,2,0,0,3,0.5,0.633333,0
4340,,,Breaking24_7,0,1,1,0,1,1,0,0,1,1,1,0
4341,,,teawnosugarpls,0,2,2,0,2,2,0,0,1,1,1,0
4342,,,manatweets,3,1,4,4,2,6,0.333333,0.020061,0,0,0,0
4343,,,MohMeh1963,0,1,1,0,1,1,0,0,1,1,1,0
4344,,,toolatebby,4,1,5,4,1,5,0.25,0.026749,0,0,0,0
4345,,,EdoEmmatt,0,1,1,0,1,1,0,0,1,1,1,0
4346,,,FetsKatze,0,1,1,0,1,1,0,0,1,1,1,0
4347,,,area_seven7,0,1,1,0,1,1,0,0,1,1,1,0
4348,,,juliarose2000,2,1,3,2,1,3,0.5,0.013374,0,0,0,0
4349,,,Linear17,0,1,1,0,1,1,0,0,1,1,1,0
4350,,,teassubij,0,1,1,0,1,1,0,0,1,1,1,0
4351,,,ro2_kk,0,2,2,0,2,2,0,0,1,1,1,0
4352,,,kkulfm613,0,1,1,0,1,1,0,0,1,1,1,0
4353,,,JamesWa57477509,14,1,15,16,1,17,0.071429,0.09362,0,0,0,0
4354,,,yatogamist,0,1,1,0,1,1,0,0,1,1,1,0
4355,,,Wumaoson,0,1,1,0,1,1,0,0,1,1,1,0
4356,,,GGTi01,0,1,1,0,1,1,0,0,1,1,1,0
4357,,,go_shoma_,0,1,1,0,1,1,0,0,1,1,1,0
4358,,,enhypen22616099,0,1,1,0,1,1,0,0,1,1,1,0
4359,,,umedeco1,0,3,3,0,3,3,0,0,1,1,1,0
4360,,,jeromeiscruzing,0,1,1,0,1,1,0,0,1,1,1,0
4361,,,winnie191090,0,1,1,0,1,1,0,0,1,1,1,0
4362,,,Ashtern_,0,1,1,0,1,1,0,0,1,1,1,0
4363,,,pooh_san120,0,1,1,0,1,1,0,0,1,1,1,0
4364,,,katiTKYM,1,1,2,1,1,2,0,0.006687,0,0,0,0
4365,,,geekon2wheels,6,1,7,6,1,7,0.166667,0.040123,0,0,0,0
4366,,,SaladZizer,0,1,1,0,1,1,0,0,1,1,1,0
4367,,,moosomnamii,0,2,2,0,2,2,0,0,2,0.75,0.833333,0
4368,,,tsumtsumum,0,1,1,0,1,1,0,0,1,1,1,0
4369,,,lostacxount,0,1,1,0,1,1,0,0,1,1,1,0
4370,,,LathamSm7,0,1,1,0,1,1,0,0,1,1,1,0
4371,,,floweryroads,5,1,6,5,1,6,0.2,0.033436,0,0,0,0
4372,,,addi_chavaj,0,1,1,0,1,1,0,0,1,1,1,0
4373,,,hanyulegacy,0,2,2,0,2,2,0,0,1,1,1,0
4374,,,TrinAugustine,0,1,1,0,1,1,0,0,1,1,1,0
4375,,,yh_ice_rink,0,3,3,0,3,3,0,0,1,1,1,0
4376,,,blazingblades,1,4,5,2,5,7,0.25,0.006687,1,1,1,0
4377,,,dollymad1812,0,3,3,0,3,3,0,0,1,1,1,0
4378,,,junjunlovelaopo,0,2,2,0,2,2,0,0,1,1,1,0
4379,,,FarrahNK,0,1,1,0,1,1,0,0,1,1,1,0
4380,,,MayorofIrvine,6,1,7,6,1,7,0.166667,0.138984,0,0,0,0
4381,,,akiosatsuki,0,1,1,0,1,1,0,0,1,1,1,0
4382,,,xDoktorFlakesx,0,1,1,0,1,1,0,0,1,1,1,0
4383,,,LNightingale33,0,1,1,0,1,1,0,0,1,1,1,0
4384,,,livelargelittle,0,1,1,0,1,1,0,0,1,1,1,0
4385,,,MikeLindblom,4,1,5,4,1,5,0.25,0.026749,0,0,0,0
4386,,,ToriTheBadOne,0,2,2,0,2,2,0,0,1,1,1,0
4387,,,KzGf8,0,2,2,0,2,2,0,0,1,1,1,0
4388,,,lilsaweetiee,1,1,2,1,1,2,0,0.006687,0,0,0,0
4389,,,iteachahs,7,1,8,7,1,8,0.142857,0.04681,0,0,0,0
4390,,,happyevd08,0,1,1,0,1,1,0,0,1,1,1,0
4391,,,polloh54,0,1,1,0,1,1,0,0,1,1,1,0
4392,,,tsukkclouds,0,1,1,0,1,1,0,0,1,1,1,0
4393,,,strwbry97,0,3,3,0,3,3,0,0,1,1,1,0
4394,,,weiwuxiannie,0,1,1,0,1,1,0,0,1,1,1,0
4395,,,rosancruz,1,1,2,1,1,2,0,0.006687,0,0,0,0
4396,,,ernietheattorn3,0,1,1,0,1,1,0,0,1,1,1,0
4397,,,hana_freesia,0,1,1,0,1,1,0,0,1,1,1,0
4398,,,mikefoley2020,4,1,5,4,1,5,0.25,0.026749,0,0,0,0
4399,,,ajisukecat,0,1,1,0,1,1,0,0,1,1,1,0
4400,,,chibitan18,0,1,1,0,1,1,0,0,1,1,1,0
4401,,,surrexi,6,1,7,7,2,9,0.166667,0.040123,0,0,0,0
4402,,,vinuskaey,0,1,1,0,1,1,0,0,1,1,1,0
4403,,,FarajAl61898417,0,3,3,0,3,3,0,0,1,1,1,0
4404,,,TaxianNoticeMe,0,1,1,0,1,1,0,0,1,1,1,0
4405,,,abe_ben,0,1,1,0,1,1,0,0,1,1,1,0
4406,,,0CkhGfpSEz9bLKf,0,4,4,0,4,4,0,0,2,0.833333,0.9,0
4407,,,kimberlykane,4,1,5,4,1,5,0.25,0.026749,0,0,0,0
4408,,,pagudewansuke,0,1,1,0,1,1,0,0,1,1,1,0
4409,,,yibonito13,6,1,7,7,2,9,0.166667,0.040123,0,0,0,0
4410,,,_sayuriiiiii_,0,2,2,0,2,2,0,0,1,1,1,0
4411,,,bashirladann,0,1,1,0,1,1,0,0,1,1,1,0
4412,,,CityMeanOlWorld,0,1,1,0,1,1,0,0,1,1,1,0
4413,,,groovybeatnik,0,1,1,0,1,1,0,0,1,1,1,0
4414,,,mrsjamong,0,1,1,0,1,1,0,0,1,1,1,0
4415,,,Dealing4Meaning,2,1,3,2,1,3,0.5,0.013374,0,0,0,0
4416,,,jinxiejae,0,1,1,0,1,1,0,0,1,1,1,0
4417,,,harperzhang7,3,1,4,3,1,4,0.333333,0.020061,0,0,0,0
4418,,,JlANGCHENGS,0,2,2,0,2,2,0,0,3,0.555556,0.666667,0
4419,,,dlhill53,0,1,1,0,1,1,0,0,1,1,1,0
4420,,,tommy_cubillas,0,1,1,0,1,1,0,0,3,0.5,0.583333,0
4421,,,daehako,0,1,1,0,1,1,0,0,3,0.5,0.583333,0
4422,,,ihkbbss,0,1,1,0,1,1,0,0,3,0.5,0.583333,0
4423,,,chibishonen,0,1,1,0,1,1,0,0,3,0.5,0.583333,0
4424,,,yossheful,0,1,1,0,1,1,0,0,3,0.5,0.583333,0
4425,,,leeMark_says_Hi,0,2,2,0,2,2,0,0,3,0.555556,0.666667,0
4426,,,annmkim,7,1,8,7,1,8,0,0.104237,3,0.5,0.583333,144
4427,,,Waffles4BFast,11,1,12,12,2,14,0.090909,0.096331,0,0,0,0
4428,,,gorachael,6,2,8,8,3,11,0.142857,0.047111,1,1,1,6
4429,,,elephant1417,0,1,1,0,1,1,0,0,1,1,1,0
4430,,,fukura_sparrow,0,1,1,0,1,1,0,0,1,1,1,0
4431,,,chiincauchy,0,1,1,0,1,1,0,0,1,1,1,0
4432,,,syuugetu3,0,1,1,0,1,1,0,0,1,1,1,0
4433,,,kingtrey,0,3,3,0,3,3,0,0,1,1,1,0
4434,,,boti44847165,0,1,1,0,1,1,0,0,1,1,1,0
4435,,,yukarinmom,0,2,2,0,3,3,0,0,1,1,1,0
4436,,,furgusonspasta,0,1,1,0,1,1,0,0,1,1,1,0
4437,,,BassoHannah,0,5,5,0,5,5,0,0,1,1,1,0
4438,,,mimichyeo,0,2,2,0,3,3,0,0,1,1,1,0
4439,,,lavenderkiss,0,2,2,0,2,2,0,0,1,1,1,0
4440,,,william_britt10,15,1,16,16,1,17,0.066667,0.100307,0,0,0,0
4441,,,420weeddad,0,1,1,0,1,1,0,0,1,1,1,0
4442,,,realjigard92x,0,1,1,0,1,1,0,0,1,1,1,0
4443,,,kaoriokubo,0,2,2,0,2,2,0,0,1,1,1,0
4444,,,tyoka20220105,0,1,1,0,1,1,0,0,1,1,1,0
4445,,,bungeeg56985410,0,1,1,0,1,1,0,0,1,1,1,0
4446,,,3llur3,0,2,2,0,2,2,0,0,1,1,1,0
4447,,,DebbiesHotMama,0,1,1,0,1,1,0,0,1,1,1,0
4448,,,aydssha,0,3,3,0,3,3,0,0,1,1,1,0
4449,,,tmy__jp,0,1,1,0,1,1,0,0,1,1,1,0
4450,,,vipeaceful__,0,1,1,0,1,1,0,0,1,1,1,0
4451,,,CAToline_floyd,0,1,1,0,1,1,0,0,1,1,1,0
4452,,,winnetcom2,4,1,5,4,1,5,0.25,0.026749,0,0,0,0
4453,,,smile_fleurs,0,1,1,0,1,1,0,0,1,1,1,0
4454,,,fairygiyuu,0,1,1,0,1,1,0,0,1,1,1,0
4455,,,dosukyo,1,1,2,1,1,2,0,0.006687,0,0,0,0
4456,,,nyayakira,7,1,8,7,1,8,0.142857,0.04681,0,0,0,0
4457,,,DaouAlineMD,0,1,1,0,1,1,0,0,1,1,1,0
4458,,,cleosanysidro,0,1,1,0,1,1,0,0,1,1,1,0
4459,,,niervanAI,0,1,1,0,1,1,0,0,1,1,1,0
4460,,,kpetrson,0,1,1,0,1,1,0,0,1,1,1,0
4461,,,MadjarovaTanya,1,1,2,1,1,2,0,0.006687,0,0,0,0
4462,,,figure03171,0,2,2,0,2,2,0,0,1,1,1,0
4463,,,byemcmuffin,1,1,2,1,1,2,0,0.006687,0,0,0,0
4464,,,LindiEmoungu,4,1,5,4,1,5,0.25,0.026749,0,0,0,0
4465,,,LChamou,0,1,1,0,1,1,0,0,1,1,1,0
4466,,,127Awayz,0,2,2,0,2,2,0,0,1,1,1,0
4467,,,uarmylab,0,2,2,0,2,2,0,0,1,1,1,0
4468,,,susan_field,6,1,7,6,1,7,0.166667,0.040123,0,0,0,0
4469,,,beomslips,0,1,1,0,1,1,0,0,1,1,1,0
4470,,,PolyPoliLive,0,1,1,0,1,1,0,0,1,1,1,0
4471,,,Oregonemom,0,1,1,0,1,1,0,0,1,1,1,0
4472,,,Maria01240860,0,1,1,0,1,1,0,0,1,1,1,0
4473,,,pomp_pomp,0,1,1,0,1,1,0,0,1,1,1,0
4474,,,hoyablooms,0,2,2,0,2,2,0,0,1,1,1,0
4475,,,jventoSLP,10,1,11,11,2,13,0.1,0.122779,0,0,0,0
4476,,,padma810,0,1,1,0,1,1,0,0,1,1,1,0
4477,,,HowToCoachGirls,0,1,1,0,1,1,0,0,1,1,1,0
4478,,,tinadumpacc,0,1,1,0,1,1,0,0,1,1,1,0
4479,,,policehelpp1,0,4,4,0,4,4,0,0,2,0.833333,0.9,0
4480,,,ritzyzoo,0,1,1,0,1,1,0,0,1,1,1,0
4481,,,cloudsunflowers,0,1,1,0,1,1,0,0,1,1,1,0
4482,,,CheliCrochet,0,1,1,0,1,1,0,0,3,0.4,0.472222,0
4483,,,xxmimi_t_xx,0,1,1,0,1,1,0,0,1,1,1,0
4484,,,RawNewsMedia,3,1,4,3,1,4,0.333333,0.025516,0,0,0,0
4485,,,2525nathan,2,2,4,2,2,4,0,0.00792,1,1,1,4
4486,,,anthonyted,13,1,14,14,2,16,0.076923,0.090427,0,0,0,0
4487,,,dream3r7,0,3,3,0,3,3,0,0,1,1,1,0
4488,,,aiSENRH9wnp0vKz,0,1,1,0,1,1,0,0,1,1,1,0
4489,,,donaldmmorrison,0,1,1,0,1,1,0,0,1,1,1,0
4490,,,trangpang,0,1,1,0,1,1,0,0,1,1,1,0
4491,,,newyorker_nb,0,1,1,0,1,1,0,0,1,1,1,0
4492,,,steveswerdlow,0,1,1,0,1,1,0,0,1,1,1,0
4493,,,RitzerBarb,0,1,1,0,1,1,0,0,1,1,1,0
4494,,,BBH__flower,0,1,1,0,2,2,0,0,1,1,1,0
4495,,,dachshund_sk,0,2,2,0,2,2,0,0,1,1,1,0
4496,,,AgricultureEagl,0,1,1,0,1,1,0,0,1,1,1,0
4497,,,betchonai3A4T,0,3,3,0,3,3,0,0,1,1,1,0
4498,,,NewYorker,1,1,2,1,1,2,0,0.006687,0,0,0,0
4499,,,przidnt1,10,1,11,11,2,13,0.1,0.066871,0,0,0,0
4500,,,hanyu_94,0,1,1,0,1,1,0,0,1,1,1,0
4501,,,MOA50_TxT,0,1,1,0,1,1,0,0,1,1,1,0
4502,,,yukimayuciel,0,1,1,0,1,1,0,0,1,1,1,0
4503,,,EvsInThailand,0,1,1,0,1,1,0,0,1,1,1,0
4504,,,sincefxxk,0,1,1,0,1,1,0,0,1,1,1,0
4505,,,megan_k_scheffe,2,1,3,2,1,3,0.5,0.013374,0,0,0,0
4506,,,jmsny_,0,1,1,0,1,1,0,0,1,1,1,0
4507,,,DaveWee1,9,1,10,9,1,10,0.111111,0.060184,0,0,0,0
4508,,,monsterpanda_,0,1,1,0,1,1,0,0,1,1,1,0
4509,,,sironeghi,0,1,1,0,1,1,0,0,1,1,1,0
4510,,,CandyRaid,0,1,1,0,1,1,0,0,1,1,1,0
4511,,,biblio_vijay,0,1,1,0,1,1,0,0,1,1,1,0
4512,,,yourwoodzie,0,2,2,0,2,2,0,0,1,1,1,0
4513,,,aaomamma,0,2,2,0,2,2,0,0,1,1,1,0
4514,,,rikas3lutz,0,1,1,0,1,1,0,0,1,1,1,0
4515,,,hoshishily,0,1,1,0,1,1,0,0,1,1,1,0
4516,,,saenishi,0,1,1,0,1,1,0,0,1,1,1,0
4517,,,Cassi_leighh,6,1,7,6,1,7,0.166667,0.097173,0,0,0,0
4518,,,dancerdude_83,14,2,16,14,2,16,0.066667,0.125068,1,1,1,19
4519,,,huntingfield728,0,1,1,0,1,1,0,0,1,1,1,0
4520,,,gusu_tianzixiao,0,1,1,0,1,1,0,0,1,1,1,0
4521,,,Sarah_Fadhil,0,1,1,0,1,1,0,0,1,1,1,0
4522,,,Andy20_04,0,1,1,0,1,1,0,0,1,1,1,0
4523,,,icarusman_joon,0,3,3,0,3,3,0,0,2,0.8,0.875,0
4524,,,dillydely,0,1,1,0,1,1,0,0,2,0.666667,0.75,0
4525,,,Hyssterica,0,1,1,0,1,1,0,0,2,0.666667,0.75,0
4526,,,maaktnietsuit,0,1,1,0,1,1,0,0,2,0.666667,0.75,0
4527,,,daynal,3,4,7,4,5,9,0.166667,0.020061,2,0.8,0.875,8
4528,,,_clee17,0,2,2,0,2,2,0,0,2,0.75,0.833333,0
4529,,,uno1rn12,0,2,2,0,2,2,0,0,2,0.75,0.833333,0
4530,,,brettashtonsj,0,1,1,0,1,1,0,0,2,0.666667,0.75,0
4531,,,no_tomato_miiko,0,3,3,0,3,3,0,0,2,0.8,0.875,0
4532,,,deborelli,11,1,12,11,1,12,0.090909,0.080547,0,0,0,0
4533,,,profgalloway,0,1,1,0,1,1,0,0,1,1,1,0
4534,,,LuthLandon,0,2,2,0,2,2,0,0,1,1,1,0
4535,,,hidamari_1217,0,2,2,0,2,2,0,0,1,1,1,0
4536,,,momota_momonta,0,1,1,0,1,1,0,0,1,1,1,0
4537,,,wxscnYFRNB7BMHf,0,1,1,0,1,1,0,0,1,1,1,0
4538,,,walwal79,0,1,1,0,1,1,0,0,1,1,1,0
4539,,,hiyilinglaozu,7,2,9,7,2,9,0.125,0.04681,1,1,1,6
4540,,,ko13_mi,0,1,1,0,1,1,0,0,2,0.666667,0.75,0
4541,,,maronu,0,1,1,0,1,1,0,0,2,0.666667,0.75,0
4542,,,luckycolorado,0,1,1,0,1,1,0,0,2,0.666667,0.75,0
4543,,,kitkerts,0,1,1,0,1,1,0,0,2,0.666667,0.75,0
4544,,,clarice_willow,6,1,7,6,1,7,0.166667,0.040123,0,0,0,0
4545,,,justinabauers,0,1,1,0,1,1,0,0,1,1,1,0
4546,,,diodio0013tw,0,2,2,0,2,2,0,0,1,1,1,0
4547,,,lemon_melon0705,0,3,3,0,3,3,0,0,1,1,1,0
4548,,,can33484183,3,1,4,3,1,4,0.333333,0.037533,0,0,0,0
4549,,,xiUwUmin_,0,1,1,0,1,1,0,0,1,1,1,0
4550,,,yuzurustoesocks,0,1,1,0,1,1,0,0,1,1,1,0
4551,,,daifukutabesugi,0,2,2,0,2,2,0,0,1,1,1,0
4552,,,okomegohanmochi,0,3,3,0,3,3,0,0,2,0.8,0.875,0
4553,,,Molivermade,0,1,1,0,1,1,0,0,1,1,1,0
4554,,,624lovebot,5,1,6,5,1,6,0.2,0.043918,0,0,0,0
4555,,,ada_gu23,0,1,1,0,1,1,0,0,1,1,1,0
4556,,,TresTaotastic,0,1,1,0,1,1,0,0,1,1,1,0
4557,,,twskth,1,1,2,1,1,2,0,0.006687,0,0,0,0
4558,,,alionastheme,5,1,6,5,1,6,0.2,0.033436,0,0,0,0
4559,,,ogurimikko1,0,1,1,0,1,1,0,0,1,1,1,0
4560,,,takaramaru55,0,1,1,0,1,1,0,0,1,1,1,0
4561,,,kajikatsui,0,1,1,0,1,1,0,0,1,1,1,0
4562,,,le47269563,5,1,6,5,1,6,0.2,0.03693,0,0,0,0
4563,,,urmykoo,0,1,1,0,1,1,0,0,1,1,1,0
4564,,,NAOMUSICAT,0,1,1,0,1,1,0,0,1,1,1,0
4565,,,mayo8739,0,2,2,0,2,2,0,0,1,1,1,0
4566,,,keep_smiling_m,0,2,2,0,2,2,0,0,1,1,1,0
4567,,,uno_minia,0,1,1,0,1,1,0,0,1,1,1,0
4568,,,polarslowmotion,0,1,1,0,1,1,0,0,1,1,1,0
4569,,,Laa7s,0,1,1,0,1,1,0,0,1,1,1,0
4570,,,emi2309,0,1,1,0,1,1,0,0,1,1,1,0
4571,,,myrayesenia1,0,1,1,0,1,1,0,0,1,1,1,0
4572,,,izuki51766599,0,3,3,0,3,3,0,0,1,1,1,0
4573,,,hamwithfear,1,1,2,1,1,2,0,0.006687,0,0,0,0
4574,,,Arrow252525,14,1,15,14,1,15,0.071429,0.096347,0,0,0,0
4575,,,yuzusskates,0,3,3,0,3,3,0,0,1,1,1,0
4576,,,na2bbo,0,1,1,0,1,1,0,0,1,1,1,0
4577,,,tytylalaty,0,1,1,0,1,1,0,0,1,1,1,0
4578,,,Maryana29983592,0,1,1,0,1,1,0,0,1,1,1,0
4579,,,susie70lfc,0,4,4,0,4,4,0,0,3,0.514286,0.583333,0
4580,,,cannella4037,0,1,1,0,1,1,0,0,1,1,1,0
4581,,,yukkie610,0,1,1,0,1,1,0,0,1,1,1,0
4582,,,bluepeter77,0,2,2,0,2,2,0,0,1,1,1,0
4583,,,twi_tkmk,0,1,1,0,1,1,0,0,1,1,1,0
4584,,,yuzurisa_marin,0,1,1,0,1,1,0,0,1,1,1,0
4585,,,21016hongbin,16,1,17,16,1,17,0.0625,0.163483,0,0,0,0
4586,,,jung_hoeesucc,0,1,1,0,1,1,0,0,1,1,1,0
4587,,,SoumyadipIndia,0,1,1,0,1,1,0,0,1,1,1,0
4588,,,sazaksha,0,1,1,0,1,1,0,0,1,1,1,0
4589,,,SugataYen,0,1,1,0,1,1,0,0,1,1,1,0
4590,,,shoumaring,0,2,2,0,2,2,0,0,1,1,1,0
4591,,,alwaysaskfree,0,1,1,0,1,1,0,0,1,1,1,0
4592,,,jd_zyx_k,2,1,3,2,1,3,0,0.00792,1,1,1,2
4593,,,yuyuyuyuzuru,1,3,4,1,3,4,0.333333,0.006687,1,1,1,0
4594,,,CupcakeMrs1,4,7,11,4,7,11,0.1,0.035544,2,0.875,0.928571,35
4595,,,hisapiyoko,0,2,2,0,2,2,0,0,2,0.75,0.833333,0
4596,,,petricat666,4,1,5,4,1,5,0.25,0.026749,0,0,0,0
4597,,,kariclo88,0,2,2,0,2,2,0,0,1,1,1,0
4598,,,witQsrBWxnqubIq,0,1,1,0,1,1,0,0,1,1,1,0
4599,,,fuku196926,0,1,1,0,1,1,0,0,1,1,1,0
4600,,,yibosbaozi,4,1,5,5,2,7,0.25,0.026749,0,0,0,0
4601,,,vividviolet3513,0,1,1,0,1,1,0,0,1,1,1,0
4602,,,tatn,50,1,51,53,4,57,0.02,0.341346,0,0,0,0
4603,,,yuzurika_711,0,1,1,0,1,1,0,0,1,1,1,0
4604,,,299hntb,0,2,2,0,2,2,0,0,1,1,1,0
4605,,,LianSuiHua1,0,1,1,0,1,1,0,0,1,1,1,0
4606,,,misora_ji,0,1,1,0,1,1,0,0,1,1,1,0
4607,,,lycheeskate,0,1,1,0,1,1,0,0,1,1,1,0
4608,,,ermsunderscore,2,1,3,2,1,3,0.5,0.013374,0,0,0,0
4609,,,kobacchi_7,0,1,1,0,1,1,0,0,1,1,1,0
4610,,,sarahcbogen,11,1,12,11,1,12,0.090909,0.121098,0,0,0,0
4611,,,ukEzUY1tJbVVfou,0,1,1,0,1,1,0,0,1,1,1,0
4612,,,deyacho,0,2,2,0,2,2,0,0,1,1,1,0
4613,,,noroton3,0,1,1,0,1,1,0,0,1,1,1,0
4614,,,17amy15,0,1,1,0,1,1,0,0,1,1,1,0
4615,,,talisa_ahn,16,1,17,16,1,17,0.0625,0.106994,0,0,0,0
4616,,,piggly_pufff,0,1,1,0,1,1,0,0,1,1,1,0
4617,,,mayuleaf4F1102,0,3,3,0,3,3,0,0,1,1,1,0
4618,,,suzuya_su,0,1,1,0,1,1,0,0,1,1,1,0
4619,,,maimaim0c0,0,3,3,0,3,3,0,0,1,1,1,0
4620,,,dayinjoon,0,1,1,0,1,1,0,0,1,1,1,0
4621,,,NickiHazelett10,1,1,2,1,1,2,0,0.006687,0,0,0,0
4622,,,PoLikesMango,3,1,4,3,1,4,0.333333,0.020061,0,0,0,0
4623,,,ToepickTrips,12,4,16,12,4,16,0.066667,0.080246,2,0.8,0.875,44
4624,,,yu_yukouta_km,0,1,1,0,1,1,0,0,3,0.5,0.566667,0
4625,,,mi39tanaka,0,2,2,0,2,2,0,0,3,0.545455,0.638889,0
4626,,,178slow,0,1,1,0,1,1,0,0,3,0.5,0.566667,0
4627,,,shokolate_cake,0,1,1,0,1,1,0,0,3,0.5,0.566667,0
4628,,,Pegasus_1217,0,2,2,0,2,2,0,0,3,0.545455,0.638889,0
4629,,,kimichanchi,0,1,1,0,1,1,0,0,3,0.5,0.566667,0
4630,,,yukurahiroko,0,1,1,0,1,1,0,0,2,0.666667,0.75,0
4631,,,_betterleee,0,6,6,0,7,7,0,0,2,0.8,0.875,0
4632,,,jOQmPI3yrZ9b0RI,0,2,2,0,2,2,0,0,2,0.75,0.833333,0
4633,,,lesbianofnine,5,1,6,5,1,6,0.2,0.033436,0,0,0,0
4634,,,bamboo3715_sk,0,2,2,0,2,2,0,0,1,1,1,0
4635,,,e_r_syo,0,2,2,0,2,2,0,0,1,1,1,0
4636,,,CourtneyMcCask3,10,1,11,10,1,11,0.1,0.066871,0,0,0,0
4637,,,_kaoring,0,2,2,0,2,2,0,0,1,1,1,0
4638,,,luvjoiners,0,1,1,0,1,1,0,0,1,1,1,0
4639,,,ILODY,0,2,2,0,2,2,0,0,1,1,1,0
4640,,,layna_skate,0,1,1,0,1,1,0,0,1,1,1,0
4641,,,oilyscallop,76,3,79,79,4,83,0.012987,0.707545,1,1,1,272
4642,,,le_petit_pontFS,2,3,5,2,3,5,0.25,0.013374,2,0.666667,0.75,4
4643,,,nayotake_skt,0,4,4,0,4,4,0,0,2,0.75,0.833333,0
4644,,,tigerlily4lo,0,5,5,0,5,5,0,0,2,0.777778,0.857143,0
4645,,,soraneko_033,0,3,3,0,3,3,0,0,2,0.714286,0.8,0
4646,,,PsU96Xc9YMHM2Xn,0,2,2,0,2,2,0,0,2,0.666667,0.75,0
4647,,,yoko_tomi,0,1,1,0,1,1,0,0,2,0.6,0.666667,0
4648,,,ma_ringo1,0,3,3,0,3,3,0,0,2,0.714286,0.8,0
4649,,,shoomacaron,0,4,4,0,5,5,0,0,2,0.75,0.833333,0
4650,,,deryfrenia,0,1,1,0,1,1,0,0,2,0.6,0.666667,0
4651,,,hilulu2626,0,1,1,0,1,1,0,0,2,0.6,0.666667,0
4652,,,nanohananahachi,0,3,3,0,3,3,0,0,2,0.714286,0.8,0
4653,,,hitNmiss_figure,0,1,1,0,1,1,0,0,2,0.6,0.666667,0
4654,,,MayuJae,0,4,4,0,4,4,0,0,2,0.75,0.833333,0
4655,,,kamilia_adriana,0,3,3,0,3,3,0,0,2,0.714286,0.8,0
4656,,,usashico,0,1,1,0,1,1,0,0,2,0.6,0.666667,0
4657,,,momo0mon,0,1,1,0,1,1,0,0,2,0.6,0.666667,0
4658,,,s_toma7,0,2,2,0,2,2,0,0,2,0.666667,0.75,0
4659,,,momoyuu_999,0,2,2,0,2,2,0,0,2,0.666667,0.75,0
4660,,,Mo_c_hachi_o,0,1,1,0,1,1,0,0,2,0.6,0.666667,0
4661,,,b0BOqBSLiFzUlNj,0,3,3,0,3,3,0,0,2,0.666667,0.75,0
4662,,,_amun_ezo,0,3,3,0,3,3,0,0,2,0.714286,0.8,0
4663,,,tamapa_,0,2,2,0,2,2,0,0,2,0.666667,0.75,0
4664,,,ayako_f,0,2,2,0,3,3,0,0,2,0.666667,0.75,0
4665,,,koriraroy,0,1,1,0,1,1,0,0,2,0.6,0.666667,0
4666,,,figure_joe,0,3,3,0,3,3,0,0,3,0.571429,0.666667,0
4667,,,NmgIrUUlzNJo4bI,0,2,2,0,2,2,0,0,2,0.666667,0.75,0
4668,,,kou_pen_xiang,0,1,1,0,1,1,0,0,2,0.6,0.666667,0
4669,,,piccolino110,0,2,2,0,2,2,0,0,2,0.666667,0.75,0
4670,,,shomagnifique,0,2,2,0,2,2,0,0,2,0.666667,0.75,0
4671,,,meru62575818,0,2,2,0,2,2,0,0,3,0.538462,0.619048,0
4672,,,AY99241355,0,3,3,0,3,3,0,0,2,0.714286,0.8,0
4673,,,riko28924203,0,2,2,0,2,2,0,0,2,0.666667,0.75,0
4674,,,damiiiin,0,2,2,0,2,2,0,0,2,0.666667,0.75,0
4675,,,spica_tyty_fgs,0,2,2,0,2,2,0,0,2,0.666667,0.75,0
4676,,,b_uno19,0,3,3,0,3,3,0,0,2,0.714286,0.8,0
4677,,,yukiskate1,0,2,2,0,2,2,0,0,2,0.666667,0.75,0
4678,,,ayupoo13,0,3,3,0,3,3,0,0,2,0.714286,0.8,0
4679,,,marugon4444,0,3,3,0,3,3,0,0,2,0.714286,0.8,0
4680,,,waflanagan,0,1,1,0,1,1,0,0,2,0.6,0.666667,0
4681,,,wakuwaku_smile,0,1,1,0,1,1,0,0,2,0.6,0.666667,0
4682,,,misa_haruko,0,1,1,0,1,1,0,0,2,0.6,0.666667,0
4683,,,saruru40,0,2,2,0,2,2,0,0,2,0.666667,0.75,0
4684,,,ehusan,0,1,1,0,1,1,0,0,2,0.6,0.666667,0
4685,,,miffy21ts,0,2,2,0,2,2,0,0,2,0.666667,0.75,0
4686,,,hinoxnatsu,0,4,4,0,4,4,0,0,2,0.75,0.833333,0
4687,,,mtmako,0,2,2,0,2,2,0,0,2,0.666667,0.75,0
4688,,,hanappo,0,1,1,0,1,1,0,0,2,0.6,0.666667,0
4689,,,ValerSharyl,1,1,2,1,1,2,0,0.006687,0,0,0,0
4690,,,skink_Luvr14,16,1,17,16,1,17,0.0625,0.117477,0,0,0,0
4691,,,acoshoma_53,0,4,4,0,4,4,0,0,1,1,1,0
4692,,,mayo_momo1520,0,1,1,0,1,1,0,0,1,1,1,0
4693,,,v44_0o,0,2,2,0,2,2,0,0,1,1,1,0
4694,,,banana_no_kawa,0,4,4,0,4,4,0,0,2,0.75,0.833333,0
4695,,,fsk8tomo,0,2,2,0,2,2,0,0,1,1,1,0
4696,,,ma_s_svoyage,0,2,2,0,2,2,0,0,1,1,1,0
4697,,,y_east0217,0,3,3,0,3,3,0,0,1,1,1,0
4698,,,bria_110,0,2,2,0,2,2,0,0,1,1,1,0
4699,,,RomiRomi_77,0,1,1,0,1,1,0,0,1,1,1,0
4700,,,rockerskating,27,3,30,32,8,40,0.034483,0.199984,2,0.75,0.833333,90
4701,,,HynS__,0,1,1,0,1,1,0,0,3,0.5,0.583333,0
4702,,,n_o_n__shoma,0,1,1,0,1,1,0,0,3,0.5,0.583333,0
4703,,,murasakipm,0,1,1,0,1,1,0,0,3,0.5,0.583333,0
4704,,,momo_ju8,0,1,1,0,1,1,0,0,3,0.5,0.583333,0
4705,,,UGLYBLOO,0,1,1,0,1,1,0,0,3,0.5,0.583333,0
4706,,,wato2024,0,1,1,0,1,1,0,0,3,0.5,0.583333,0
4707,,,chocoramolover,2,1,3,2,1,3,0,0.00792,3,0.5,0.583333,8
4708,,,lovebythemoon_1,0,1,1,0,1,1,0,0,3,0.5,0.583333,0
4709,,,hman_yuzuru,0,1,1,0,1,1,0,0,3,0.5,0.583333,0
4710,,,ms_emmalyon,4,1,5,4,1,5,0.25,0.026749,0,0,0,0
4711,,,spacklegeek,0,1,1,0,1,1,0,0,1,1,1,0
4712,,,uyuzo,0,1,1,0,1,1,0,0,1,1,1,0
4713,,,tsukitoji__sk,0,2,2,0,2,2,0,0,1,1,1,0
4714,,,HanyuBees,0,1,1,0,1,1,0,0,1,1,1,0
4715,,,NathanCoulter,6,1,7,6,1,7,0.166667,0.040123,0,0,0,0
4716,,,paaako34,0,2,2,0,2,2,0,0,1,1,1,0
4717,,,Victori34859351,0,1,1,0,1,1,0,0,1,1,1,0
4718,,,anniewat07,0,1,1,0,1,1,0,0,1,1,1,0
4719,,,77momo2,0,1,1,0,1,1,0,0,1,1,1,0
4720,,,madmax47930464,9,1,10,11,3,14,0.111111,0.08115,0,0,0,0
4721,,,maikariii,0,1,1,0,1,1,0,0,1,1,1,0
4722,,,naaakskaten_25,0,1,1,0,1,1,0,0,1,1,1,0
4723,,,AlteregosAlt,29,1,30,29,1,30,0.034483,0.348455,0,0,0,0
4724,,,igigasiga,0,4,4,0,4,4,0,0,2,0.833333,0.9,0
4725,,,Rayapinociiii,0,1,1,0,1,1,0,0,1,1,1,0
4726,,,sunmoon46655631,0,1,1,0,1,1,0,0,1,1,1,0
4727,,,96ooozSink,0,2,2,0,2,2,0,0,1,1,1,0
4728,,,PureForest92,0,1,1,0,1,1,0,0,1,1,1,0
4729,,,1OxKokZxKoMTetp,0,1,1,0,1,1,0,0,1,1,1,0
4730,,,harryisnotasian,0,3,3,0,3,3,0,0,1,1,1,0
4731,,,4T3A4F4Lo4S,0,1,1,0,1,1,0,0,1,1,1,0
4732,,,janijovi,0,1,1,0,1,1,0,0,1,1,1,0
4733,,,shuno1217,0,2,2,0,2,2,0,0,1,1,1,0
4734,,,jiangmanting,0,1,1,0,1,1,0,0,1,1,1,0
4735,,,nonoji_bb_fs,0,3,3,0,3,3,0,0,1,1,1,0
4736,,,manakatellme,0,1,1,0,1,1,0,0,1,1,1,0
4737,,,bumblebun,0,1,1,0,1,1,0,0,1,1,1,0
4738,,,chiyoyoyo3,0,1,1,0,1,1,0,0,1,1,1,0
4739,,,naa_cream,0,1,1,0,1,1,0,0,1,1,1,0
4740,,,awan_1406,0,1,1,0,1,1,0,0,1,1,1,0
4741,,,nohohon_5,0,1,1,0,1,1,0,0,1,1,1,0
4742,,,Atomatwlp,0,2,2,0,2,2,0,0,1,1,1,0
4743,,,yuni__ko,0,2,2,0,2,2,0,0,1,1,1,0
4744,,,ajijyu,0,1,1,0,1,1,0,0,1,1,1,0
4745,,,ky100709t,0,1,1,0,1,1,0,0,1,1,1,0
4746,,,kandemo,0,1,1,0,1,1,0,0,1,1,1,0
4747,,,3rdeditionmm,0,1,1,0,1,1,0,0,1,1,1,0
4748,,,k_ai_d,0,1,1,0,1,1,0,0,1,1,1,0
4749,,,youcanrunwithme,0,1,1,0,1,1,0,0,1,1,1,0
4750,,,schacos1,0,1,1,0,1,1,0,0,1,1,1,0
4751,,,alteregobae,0,1,1,0,1,1,0,0,1,1,1,0
4752,,,crownedhyune,0,1,1,0,1,1,0,0,1,1,1,0
4753,,,yk8321114,0,1,1,0,1,1,0,0,1,1,1,0
4754,,,juno_odamaki,0,1,1,0,1,1,0,0,1,1,1,0
4755,,,sheolly_m,0,1,1,0,1,1,0,0,1,1,1,0
4756,,,karukaruyanka,0,1,1,0,1,1,0,0,1,1,1,0
4757,,,chisa_aya1217,0,1,1,0,1,1,0,0,1,1,1,0
4758,,,reaohohonskate,0,1,1,0,1,1,0,0,1,1,1,0
4759,,,formobear,0,1,1,0,1,1,0,0,1,1,1,0
4760,,,ReelInequality,0,1,1,0,1,1,0,0,1,1,1,0
4761,,,kuon_takamiya,0,1,1,0,1,1,0,0,1,1,1,0
4762,,,kmvmsb,0,1,1,0,1,1,0,0,1,1,1,0
4763,,,yuikomizuhara,0,1,1,0,1,1,0,0,1,1,1,0
4764,,,winterlemonz,0,1,1,0,1,1,0,0,1,1,1,0
4765,,,PSYCHMH,0,1,1,0,1,1,0,0,1,1,1,0
4766,,,dopilthinker,38,1,39,40,3,43,0.026316,0.262293,0,0,0,0
4767,,,789k789,0,1,1,0,1,1,0,0,1,1,1,0
4768,,,sheela014,0,1,1,0,1,1,0,0,1,1,1,0
4769,,,illuminationkey,0,1,1,0,1,1,0,0,1,1,1,0
4770,,,kaishenwuliu,0,1,1,0,1,1,0,0,1,1,1,0
4771,,,chiharu2122,0,1,1,0,1,1,0,0,1,1,1,0
4772,,,ysmrkwfs,0,1,1,0,1,1,0,0,1,1,1,0
4773,,,itezayamaneko,0,2,2,0,2,2,0,0,3,0.510638,0.534722,0
4774,,,butterc70795250,0,1,1,0,1,1,0,0,1,1,1,0
4775,,,asleepmiao,0,1,1,0,1,1,0,0,1,1,1,0
4776,,,onlyonemao,0,1,1,0,1,1,0,0,1,1,1,0
4777,,,lilionsofa,0,1,1,0,1,1,0,0,1,1,1,0
4778,,,megumi08142,0,1,1,0,1,1,0,0,1,1,1,0
4779,,,FlowersHumunes,0,1,1,0,1,1,0,0,1,1,1,0
4780,,,sctmb2O14,0,1,1,0,1,1,0,0,1,1,1,0
4781,,,suhoswish,0,1,1,0,1,1,0,0,1,1,1,0
4782,,,shkozo,0,1,1,0,1,1,0,0,1,1,1,0
4783,,,YRxrv,0,1,1,0,1,1,0,0,1,1,1,0
4784,,,Jkentner8,6,1,7,6,1,7,0.166667,0.040123,0,0,0,0
4785,,,89hkD6dOBNxc7Tl,0,1,1,0,1,1,0,0,1,1,1,0
4786,,,Miranda_unokos,0,1,1,0,1,1,0,0,1,1,1,0
4787,,,kaIayagain,92,1,93,92,1,93,0.01087,0.642404,0,0,0,0
4788,,,ugachan,0,1,1,0,1,1,0,0,1,1,1,0
4789,,,aunnokokyus,0,5,5,0,6,6,0,0,1,1,1,0
4790,,,shyara07,0,1,1,0,1,1,0,0,1,1,1,0
4791,,,FSkate0222,0,1,1,0,1,1,0,0,1,1,1,0
4792,,,isora40,0,1,1,0,1,1,0,0,1,1,1,0
4793,,,arar58_shonniko,0,1,1,0,1,1,0,0,1,1,1,0
4794,,,kanako_55,0,1,1,0,1,1,0,0,1,1,1,0
4795,,,4u_ftms,0,1,1,0,1,1,0,0,1,1,1,0
4796,,,monaca_bellucci,0,1,1,0,1,1,0,0,1,1,1,0
4797,,,PakiageMail,0,1,1,0,1,1,0,0,1,1,1,0
4798,,,shoma24sayako,0,2,2,0,2,2,0,0,1,1,1,0
4799,,,shomauno1111111,0,1,1,0,1,1,0,0,1,1,1,0
4800,,,mika_gretel,0,1,1,0,1,1,0,0,1,1,1,0
4801,,,oneskatingfan,0,1,1,0,1,1,0,0,1,1,1,0
4802,,,kaycanadagoose,0,2,2,0,2,2,0,0,2,0.75,0.833333,0
4803,,,hitsuji_one,0,2,2,0,2,2,0,0,1,1,1,0
4804,,,mitsu3t,0,1,1,0,1,1,0,0,1,1,1,0
4805,,,209yoyotte,0,2,2,0,2,2,0,0,2,0.75,0.833333,0
4806,,,RULI_2caClover,0,1,1,0,1,1,0,0,1,1,1,0
4807,,,JaguarDoII,0,1,1,0,1,1,0,0,1,1,1,0
4808,,,tokyo1005,0,1,1,0,1,1,0,0,1,1,1,0
4809,,,snsurcdtsu,0,2,2,0,2,2,0,0,2,0.75,0.833333,0
4810,,,misashomt,0,1,1,0,1,1,0,0,1,1,1,0
4811,,,rosewine443,0,1,1,0,1,1,0,0,1,1,1,0
4812,,,osen1217,0,3,3,0,3,3,0,0,1,1,1,0
4813,,,hinata0402take,0,2,2,0,2,2,0,0,1,1,1,0
4814,,,piaoakino,0,2,2,0,2,2,0,0,1,1,1,0
4815,,,momo88918102,0,1,1,0,1,1,0,0,1,1,1,0
4816,,,ar11adne,0,1,1,0,1,1,0,0,1,1,1,0
4817,,,yomochu,0,1,1,0,1,1,0,0,1,1,1,0
4818,,,jeondrwn,0,1,1,0,1,1,0,0,1,1,1,0
4819,,,SkyJuice_Sunny,0,2,2,0,2,2,0,0,1,1,1,0
4820,,,m_shadow_m,0,1,1,0,1,1,0,0,1,1,1,0
4821,,,kaya_mtk,0,1,1,0,1,1,0,0,1,1,1,0
4822,,,nichirin1497,0,2,2,0,2,2,0,0,1,1,1,0
4823,,,xzsoIo,4,1,5,4,1,5,0.25,0.026749,0,0,0,0
4824,,,rbwkpop,0,2,2,0,2,2,0,0,1,1,1,0
4825,,,sowmiyashok,0,1,1,0,1,1,0,0,1,1,1,0
4826,,,emelizabethe,1,1,2,1,1,2,0,0.006687,0,0,0,0
4827,,,filthymeeks,1,1,2,1,1,2,0,0.006687,0,0,0,0
4828,,,itachiIuv,0,1,1,0,1,1,0,0,1,1,1,0
4829,,,mywang999,0,1,1,0,1,1,0,0,1,1,1,0
4830,,,PurpleSyf,0,1,1,0,1,1,0,0,1,1,1,0
4831,,,YuzuWakasama,0,1,1,0,1,1,0,0,1,1,1,0
4832,,,hayleejeanie,1,1,2,1,1,2,0,0.006687,0,0,0,0
4833,,,eddiemikus,4,1,5,5,2,7,0.25,0.033737,0,0,0,0
4834,,,Louishimon,1,2,3,1,2,3,0.5,0.006687,1,1,1,0
4835,,,DNA_Bethylation,1,1,2,1,1,2,0,0.006687,0,0,0,0
4836,,,InboundIke,4,1,5,4,1,5,0.25,0.026749,0,0,0,0
4837,,,still_liberal,0,1,1,0,1,1,0,0,1,1,1,0
4838,,,ChBaker801,0,1,1,0,1,1,0,0,1,1,1,0
4839,,,retrohtk,0,1,1,0,1,1,0,0,1,1,1,0
4840,,,AbigailWhitake1,1,1,2,1,1,2,0,0.006687,0,0,0,0
4841,,,gremlinluvr,2,1,3,2,1,3,0.5,0.013374,0,0,0,0
4842,,,yumeMasquerade,0,1,1,0,1,1,0,0,1,1,1,0
4843,,,maggiehendricks,1,2,3,2,3,5,0.5,0.006687,1,1,1,0
4844,,,SLCPaladin,1,1,2,1,1,2,0,0.006687,0,0,0,0
4845,,,hiekachu,1,1,2,1,1,2,0,0.006687,0,0,0,0
4846,,,greybo62,1,1,2,1,1,2,0,0.006687,0,0,0,0
4847,,,neontreat,3,1,4,3,1,4,0.333333,0.120216,0,0,0,0
4848,,,elitejean,4,5,9,5,6,11,0.125,0.032203,2,0.642857,0.722222,43.5
4849,,,RandyRexy55,4,1,5,4,1,5,0.25,0.026749,0,0,0,0
4850,,,ilikespurs,0,1,1,0,1,1,0,0,1,1,1,0
4851,,,mamaduck68,0,1,1,0,1,1,0,0,1,1,1,0
4852,,,misery9,0,1,1,0,1,1,0,0,1,1,1,0
4853,,,eduk8101,2,1,3,2,1,3,0.5,0.013374,0,0,0,0
4854,,,VanessaS911,0,1,1,0,1,1,0,0,1,1,1,0
4855,,,yourloyalknight,15,1,16,19,2,21,0.066667,0.100307,0,0,0,0
4856,,,_bubblejungle,0,1,1,0,3,3,0,0,1,1,1,0
4857,,,ShowM3Starlight,0,2,2,0,2,2,0,0,1,1,1,0
4858,,,s0rakyu,0,1,1,0,1,1,0,0,1,1,1,0
4859,,,Miti27050084,0,2,2,0,2,2,0,0,1,1,1,0
4860,,,deforested777,0,1,1,0,1,1,0,0,1,1,1,0
4861,,,mikumduar,0,1,1,0,1,1,0,0,1,1,1,0
4862,,,hissperia,2,1,3,2,1,3,0.5,0.013374,0,0,0,0
4863,,,andy55andy55,0,4,4,0,5,5,0,0,1,1,1,0
4864,,,Colie2183,1,1,2,1,1,2,0,0.006687,0,0,0,0
4865,,,ehmessbeewhy,6,1,7,6,1,7,0.166667,0.040123,0,0,0,0
4866,,,carolinaleo66,0,1,1,0,1,1,0,0,1,1,1,0
4867,,,kylecalatrava,0,1,1,0,1,1,0,0,1,1,1,0
4868,,,hengdianhawkeye,0,1,1,0,1,1,0,0,1,1,1,0
4869,,,M4SH101,0,1,1,0,1,1,0,0,1,1,1,0
4870,,,LiNafied,0,1,1,0,1,1,0,0,1,1,1,0
4871,,,karinosaiai,8,1,9,9,1,10,0.125,0.053497,0,0,0,0
4872,,,gdpeacemnusone,0,1,1,0,1,1,0,0,1,1,1,0
4873,,,AGPharmac,0,2,2,0,2,2,0,0,1,1,1,0
4874,,,walkinginsnow,0,1,1,0,1,1,0,0,1,1,1,0
4875,,,catPhoeNYX,0,1,1,0,1,1,0,0,1,1,1,0
4876,,,tokocha1,0,2,2,0,2,2,0,0,1,1,1,0
4877,,,Katealynn12,2,1,3,2,1,3,0.5,0.013374,0,0,0,0
4878,,,BetterBethBB,0,1,1,0,1,1,0,0,1,1,1,0
4879,,,RaginYak,0,1,1,0,1,1,0,0,1,1,1,0
4880,,,orangesrgd,0,2,2,0,2,2,0,0,1,1,1,0
4881,,,EcoTradeoff,4,1,5,4,1,5,0.25,0.058197,0,0,0,0
4882,,,gahmiko,9,5,14,9,6,15,0.076923,0.060184,1,1,1,32
4883,,,nekosisne,0,1,1,0,1,1,0,0,1,1,1,0
4884,,,Soo_rebel,0,1,1,0,1,1,0,0,1,1,1,0
4885,,,viqueenSue,2,2,4,2,2,4,0.333333,0.013374,1,1,1,1
4886,,,huiiiistarry,0,1,1,0,1,1,0,0,1,1,1,0
4887,,,RebeccaKaplan6,3,1,4,3,1,4,0.333333,0.02705,0,0,0,0
4888,,,AntifreezeT,0,1,1,0,1,1,0,0,1,1,1,0
4889,,,ncit_julia,0,1,1,0,1,1,0,0,1,1,1,0
4890,,,do0coffe,0,2,2,0,3,3,0,0,1,1,1,0
4891,,,lindawill5,1,1,2,1,1,2,0,0.006687,0,0,0,0
4892,,,letitia1680,0,3,3,0,3,3,0,0,3,0.461538,0.555556,0
4893,,,yuzuyunting,5,1,6,5,1,6,0.2,0.033436,0,0,0,0
4894,,,SOULXOL_,0,1,1,0,1,1,0,0,1,1,1,0
4895,,,k1ka1der,0,2,2,0,2,2,0,0,1,1,1,0
4896,,,teomeetsevil,0,2,2,0,2,2,0,0,1,1,1,0
4897,,,pointerest1045,0,1,1,0,1,1,0,0,1,1,1,0
4898,,,hi_MU_ra,0,1,1,0,1,1,0,0,1,1,1,0
4899,,,VOAStevenson,5,1,6,7,3,10,0.2,0.033436,0,0,0,0
4900,,,1242847,0,1,1,0,1,1,0,0,1,1,1,0
4901,,,s_norkmaiden,0,1,1,0,1,1,0,0,1,1,1,0
4902,,,dbradl84,5,1,6,6,1,7,0.2,0.033436,0,0,0,0
4903,,,knightrose21,0,2,2,0,2,2,0,0,1,1,1,0
4904,,,selinaxagwu,0,1,1,0,1,1,0,0,1,1,1,0
4905,,,cdelacruzzz,3,1,4,3,1,4,0.333333,0.020061,0,0,0,0
4906,,,madisonfayeeee,0,2,2,0,2,2,0,0,1,1,1,0
4907,,,DEVILM4NZ,3,1,4,3,1,4,0.333333,0.020061,0,0,0,0
4908,,,fortunate_auri,0,1,1,0,1,1,0,0,1,1,1,0
4909,,,DariielaMR,0,2,2,0,2,2,0,0,1,1,1,0
4910,,,bakagi,1,1,2,1,1,2,0,0.006687,0,0,0,0
4911,,,ViaClove,0,1,1,0,1,1,0,0,2,0.666667,0.75,0
4912,,,al1enbabeyyy,4,1,5,4,1,5,0.25,0.026749,0,0,0,0
4913,,,5ug4rplum3l3gy,0,1,1,0,1,1,0,0,1,1,1,0
4914,,,regina980626,0,1,1,0,1,1,0,0,1,1,1,0
4915,,,milezaharries,0,2,2,0,2,2,0,0,1,1,1,0
4916,,,dbsovereign1,0,1,1,0,1,1,0,0,1,1,1,0
4917,,,_STAY_0325,6,3,9,7,4,11,0.125,0.040123,1,1,1,10
4918,,,williamkakabake,2,1,3,2,1,3,0.5,0.013374,0,0,0,0
4919,,,missogr238,0,1,1,0,1,1,0,0,1,1,1,0
4920,,,szn_baseball,2,1,3,2,1,3,0.5,0.013374,0,0,0,0
4921,,,vicharity,1,1,2,1,1,2,0,0.006687,0,0,0,0
4922,,,lansemeiguihua1,8,1,9,8,1,9,0.125,0.067474,0,0,0,0
4923,,,ejlazar,0,1,1,0,1,1,0,0,1,1,1,0
4924,,,almightyuzu,0,1,1,0,1,1,0,0,1,1,1,0
4925,,,Eyes0fDiamond,0,1,1,0,1,1,0,0,1,1,1,0
4926,,,TAKellywriter,2,1,3,2,1,3,0.5,0.013374,0,0,0,0
4927,,,RTong86,0,1,1,0,1,1,0,0,2,0.6,0.666667,0
4928,,,haesoonified,0,3,3,0,3,3,0,0,2,0.714286,0.8,0
4929,,,Rrrrr0A0,0,1,1,0,1,1,0,0,2,0.6,0.666667,0
4930,,,roxi_pop_30,0,1,1,0,1,1,0,0,2,0.6,0.666667,0
4931,,,xifeng1842,5,1,6,5,1,6,0.2,0.054401,0,0,0,0
4932,,,lisa_b1962,0,1,1,0,1,1,0,0,1,1,1,0
4933,,,Rie77558135,0,1,1,0,1,1,0,0,1,1,1,0
4934,,,markr3ncart,0,1,1,0,1,1,0,0,1,1,1,0
4935,,,LLLai321,4,1,5,4,1,5,0.25,0.026749,0,0,0,0
4936,,,soph_sauce,0,1,1,0,1,1,0,0,1,1,1,0
4937,,,HellOneUnex,0,1,1,0,1,1,0,0,1,1,1,0
4938,,,hongyuep_,0,2,2,0,2,2,0,0,1,1,1,0
4939,,,bluefIames,20,1,21,22,1,23,0.05,0.133743,0,0,0,0
4940,,,ADVv2FTjK3PsnA2,0,3,3,0,4,4,0,0,1,1,1,0
4941,,,butterflyrainin,0,1,1,0,1,1,0,0,1,1,1,0
4942,,,glamama,0,1,1,0,1,1,0,0,1,1,1,0
4943,,,RiskAlert,0,1,1,0,1,1,0,0,1,1,1,0
4944,,,MXIMC,0,3,3,0,3,3,0,0,1,1,1,0
4945,,,mari021702,0,1,1,0,1,1,0,0,1,1,1,0
4946,,,kariniwa_,0,2,2,0,2,2,0,0,1,1,1,0
4947,,,sk8ingymfan,0,2,2,0,2,2,0,0,1,1,1,0
4948,,,fullmoon_arrow,0,1,1,0,1,1,0,0,1,1,1,0
4949,,,shamonoir,0,1,1,0,1,1,0,0,1,1,1,0
4950,,,jessieMajump,0,1,1,0,1,1,0,0,1,1,1,0
4951,,,nikukyu211,0,2,2,0,2,2,0,0,1,1,1,0
4952,,,harusk8y,0,1,1,0,1,1,0,0,1,1,1,0
4953,,,132achoo,0,7,7,0,12,12,0,0,1,1,1,0
4954,,,sambal_maniac,0,2,2,0,2,2,0,0,1,1,1,0
4955,,,surreality1002,0,1,1,0,2,2,0,0,1,1,1,0
4956,,,goatlovepink,0,1,1,0,1,1,0,0,1,1,1,0
4957,,,seoleluna,0,1,1,0,1,1,0,0,1,1,1,0
4958,,,FitKiwi,1,1,2,1,1,2,0,0.006687,0,0,0,0
4959,,,CherylEdgerly,0,1,1,0,1,1,0,0,1,1,1,0
4960,,,hji38350271,0,1,1,0,1,1,0,0,1,1,1,0
4961,,,pottsanndpans,0,1,1,0,1,1,0,0,1,1,1,0
4962,,,dritaehenes,0,1,1,0,1,1,0,0,1,1,1,0
4963,,,Thedreamisallon,1,1,2,1,1,2,0,0.006687,0,0,0,0
4964,,,bopu2015,1,1,2,1,1,2,0,0.006687,0,0,0,0
4965,,,baileykuert,7,1,8,7,1,8,0.142857,0.04681,0,0,0,0
4966,,,butterflye1207,0,1,1,0,1,1,0,0,1,1,1,0
4967,,,snowyhare00,0,1,1,0,1,1,0,0,1,1,1,0
4968,,,nakaji85074985,0,1,1,0,1,1,0,0,1,1,1,0
4969,,,hyungwonstea,0,1,1,0,1,1,0,0,1,1,1,0
4970,,,yukiyanagi1234,0,1,1,0,1,1,0,0,1,1,1,0
4971,,,squid1864_,0,1,1,0,1,1,0,0,1,1,1,0
4972,,,taeIuvi,0,1,1,0,1,1,0,0,1,1,1,0
4973,,,EddieBala4,0,1,1,0,1,1,0,0,1,1,1,0
4974,,,RitaShertick,0,1,1,0,1,1,0,0,1,1,1,0
4975,,,Tony_Sacto,0,1,1,0,1,1,0,0,1,1,1,0
4976,,,LynthasLzCorner,1,1,2,1,1,2,0,0.006687,0,0,0,0
4977,,,chwoweee,4,1,5,4,1,5,0.25,0.026749,0,0,0,0
4978,,,cherryburat,0,1,1,0,1,1,0,0,1,1,1,0
4979,,,zhoucelcel,0,1,1,0,1,1,0,0,1,1,1,0
4980,,,birdiewings02,0,1,1,0,1,1,0,0,1,1,1,0
4981,,,hthecuties,0,1,1,0,1,1,0,0,1,1,1,0
4982,,,20142018gold,0,1,1,0,1,1,0,0,1,1,1,0
4983,,,Kurokogugu,0,1,1,0,1,1,0,0,1,1,1,0
4984,,,PattyRWy,0,1,1,0,1,1,0,0,1,1,1,0
4985,,,twosunsmeet,0,1,1,0,1,1,0,0,1,1,1,0
4986,,,otonawl,0,2,2,0,2,2,0,0,1,1,1,0
4987,,,DGitlitz,0,2,2,0,2,2,0,0,1,1,1,0
4988,,,momococo_y,0,1,1,0,1,1,0,0,1,1,1,0
4989,,,wonderyinci,0,1,1,0,1,1,0,0,1,1,1,0
4990,,,Grizfan1956,0,1,1,0,1,1,0,0,1,1,1,0
4991,,,Cookies8888,0,4,4,0,4,4,0,0,2,0.833333,0.9,0
4992,,,sunkissedtyong,0,1,1,0,1,1,0,0,1,1,1,0
4993,,,Julia_Mousey,1,1,2,1,1,2,0,0.006687,0,0,0,0
4994,,,xmytime_jjk,0,2,2,0,2,2,0,0,1,1,1,0
4995,,,kazenado,4,1,5,4,1,5,0.25,0.047714,0,0,0,0
4996,,,ifantast,0,1,1,0,1,1,0,0,1,1,1,0
4997,,,missiongirl4,2,1,3,2,1,3,0.5,0.013374,0,0,0,0
4998,,,miruru1207yuzu,0,1,1,0,1,1,0,0,1,1,1,0
4999,,,PCLong1,1,1,2,1,1,2,0,0.006687,0,0,0,0
5000,,,iamtulayyy,6,2,8,6,2,8,0.142857,0.040123,1,1,1,5
5001,,,privateofficer,3,1,4,3,1,4,0.333333,0.020061,0,0,0,0
5002,,,aylyninthedark,0,1,1,0,1,1,0,0,1,1,1,0
5003,,,Craden924,0,1,1,0,1,1,0,0,1,1,1,0
5004,,,mateale1968,2,2,4,3,3,6,0.333333,0.013374,1,1,1,1
5005,,,adsugagloss,0,1,1,0,1,1,0,0,1,1,1,0
5006,,,alexiyasss,1,1,2,1,1,2,0,0.006687,0,0,0,0
5007,,,bb5sbnbk,2,1,3,2,1,3,0.5,0.013374,0,0,0,0
5008,,,rransama,0,1,1,0,1,1,0,0,1,1,1,0
5009,,,onlymedal,2,1,3,2,1,3,0.5,0.013374,0,0,0,0
5010,,,seaviewgo_h,0,1,1,0,1,1,0,0,1,1,1,0
5011,,,Freepaperclips,9,1,10,10,1,11,0.111111,0.08115,0,0,0,0
5012,,,karinkarin1207,0,1,1,0,1,1,0,0,1,1,1,0
5013,,,VideSulizan,0,4,4,0,5,5,0,0,2,0.833333,0.9,0
5014,,,tk227tn_skate,0,1,1,0,1,1,0,0,1,1,1,0
5015,,,bronii_chan,1,1,2,1,1,2,0,0.006687,0,0,0,0
5016,,,isodeltair,6,2,8,6,2,8,0.142857,0.048304,1,1,1,8
5017,,,EdwardTravers17,0,1,1,0,1,1,0,0,2,0.666667,0.75,0
5018,,,madeline_sneed,0,1,1,0,1,1,0,0,2,0.666667,0.75,0
5019,,,Cartisma_,3,1,4,3,1,4,0,0.01188,2,0.666667,0.75,6
5020,,,iFFn3M8F4nOQUsa,0,1,1,0,1,1,0,0,2,0.666667,0.75,0
5021,,,chelseaauthor,3,1,4,3,1,4,0.333333,0.020061,0,0,0,0
5022,,,krbic10,0,1,1,0,1,1,0,0,1,1,1,0
5023,,,Cinny43419477,2,1,3,2,1,3,0.5,0.013374,0,0,0,0
5024,,,gimmehavit,0,1,1,0,1,1,0,0,1,1,1,0
5025,,,rexlapisanti,4,1,5,4,1,5,0.25,0.026749,0,0,0,0
5026,,,PhyddleDD,0,1,1,0,1,1,0,0,1,1,1,0
5027,,,Barkleysbuddy,0,1,1,0,1,1,0,0,1,1,1,0
5028,,,requiemoftenchi,0,1,1,0,1,1,0,0,1,1,1,0
5029,,,Resonant_Waves,3,1,4,3,1,4,0.333333,0.020061,0,0,0,0
5030,,,LizBradbury,0,1,1,0,1,1,0,0,1,1,1,0
5031,,,shamiinanana,0,1,1,0,1,1,0,0,1,1,1,0
5032,,,liqian_ren,7,1,8,8,1,9,0.142857,0.04681,0,0,0,0
5033,,,__Naba__,0,1,1,0,2,2,0,0,1,1,1,0
5034,,,idkthisadumpacc,0,2,2,0,2,2,0,0,1,1,1,0
5035,,,6ROKU_SATOSHI,0,1,1,0,1,1,0,0,1,1,1,0
5036,,,SVixen14,0,1,1,0,1,1,0,0,1,1,1,0
5037,,,moymoonlight,0,1,1,0,1,1,0,0,1,1,1,0
5038,,,linda156713,0,2,2,0,2,2,0,0,2,0.75,0.833333,0
5039,,,suzuyapt,0,1,1,0,1,1,0,0,1,1,1,0
5040,,,juanitosuh,0,1,1,0,1,1,0,0,1,1,1,0
5041,,,ca1127b1,0,1,1,0,1,1,0,0,1,1,1,0
5042,,,svnghoonies,6,2,8,7,2,9,0.142857,0.040123,1,1,1,5
5043,,,yqnanx,0,2,2,0,3,3,0,0,2,0.75,0.833333,0
5044,,,Hugh_Jashole1,0,1,1,0,1,1,0,0,2,0.666667,0.75,0
5045,,,CreatedGay,0,1,1,0,1,1,0,0,2,0.666667,0.75,0
5046,,,matt_treiber,3,1,4,3,1,4,0.333333,0.020061,0,0,0,0
5047,,,naosweetie,0,1,1,0,1,1,0,0,1,1,1,0
5048,,,poeticbluesun,0,1,1,0,1,1,0,0,1,1,1,0
5049,,,mimireacts,1,1,2,1,1,2,0,0.006687,0,0,0,0
5050,,,cute_kei,0,1,1,0,1,1,0,0,1,1,1,0
5051,,,Susabits,0,1,1,0,1,1,0,0,1,1,1,0
5052,,,yoonteok,0,3,3,0,3,3,0,0,1,1,1,0
5053,,,interaksyon,2,1,3,2,1,3,0.5,0.013374,0,0,0,0
5054,,,moanikeala1l0oI,0,1,1,0,1,1,0,0,3,0.5,0.514493,0
5055,,,hello_world2008,20,1,21,20,1,21,0.05,0.133743,0,0,0,0
5056,,,0314ksm,0,1,1,0,1,1,0,0,1,1,1,0
5057,,,succulentfries,0,1,1,0,1,1,0,0,1,1,1,0
5058,,,mrSatias,0,1,1,0,1,1,0,0,1,1,1,0
5059,,,lwjjongin,0,1,1,0,1,1,0,0,1,1,1,0
5060,,,sungfilez,0,1,1,0,1,1,0,0,1,1,1,0
5061,,,DynamiteKnees,0,1,1,0,1,1,0,0,1,1,1,0
5062,,,stanfordccsre,0,1,1,0,1,1,0,0,1,1,1,0
5063,,,nathan_joon7,0,1,1,0,1,1,0,0,1,1,1,0
5064,,,fivepennyplease,0,1,1,0,1,1,0,0,1,1,1,0
5065,,,_going_myway_,0,1,1,0,1,1,0,0,1,1,1,0
5066,,,Incohunnie,0,3,3,0,3,3,0,0,2,0.714286,0.8,0
5067,,,iandrealvarez,0,1,1,0,1,1,0,0,1,1,1,0
5068,,,KarenOl80067932,0,1,1,0,1,1,0,0,1,1,1,0
5069,,,Sisterwriter,0,2,2,0,2,2,0,0,1,1,1,0
5070,,,flouerpetal,0,2,2,0,2,2,0,0,1,1,1,0
5071,,,jwycity,0,1,1,0,1,1,0,0,1,1,1,0
5072,,,nemonademouth,0,1,1,0,1,1,0,0,1,1,1,0
5073,,,Milagro54102766,0,2,2,0,2,2,0,0,1,1,1,0
5074,,,8huei,0,1,1,0,1,1,0,0,1,1,1,0
5075,,,haoeishi,0,1,1,0,1,1,0,0,1,1,1,0
5076,,,ilyydannii,0,1,1,0,1,1,0,0,1,1,1,0
5077,,,albertthrower3,2,1,3,2,1,3,0.5,0.013374,0,0,0,0
5078,,,cuntdancy,0,1,1,0,1,1,0,0,1,1,1,0
5079,,,tasque__manager,1,1,2,1,1,2,0,0.006687,0,0,0,0
5080,,,Alisa1005_91,0,1,1,0,1,1,0,0,1,1,1,0
5081,,,hyunejft,0,1,1,0,1,1,0,0,1,1,1,0
5082,,,KameSamaYesung,0,1,1,0,1,1,0,0,1,1,1,0
5083,,,dewdewhong,0,1,1,0,1,1,0,0,1,1,1,0
5084,,,_mrkfs,0,1,1,0,1,1,0,0,1,1,1,0
5085,,,kozumekitsune,0,1,1,0,1,1,0,0,1,1,1,0
5086,,,Yewoo12,0,1,1,0,1,1,0,0,1,1,1,0
5087,,,blu_lucia23,0,1,1,0,1,1,0,0,1,1,1,0
5088,,,borderjaeyun,0,1,1,0,1,1,0,0,1,1,1,0
5089,,,tofutabi,0,1,1,0,1,1,0,0,1,1,1,0
5090,,,sepulchrallyme,5,2,7,5,2,7,0.166667,0.040424,1,1,1,5
5091,,,soobcheolie,0,1,1,0,1,1,0,0,2,0.666667,0.75,0
5092,,,alexis_ingrid74,0,2,2,0,2,2,0,0,2,0.75,0.833333,0
5093,,,cancesiis,0,1,1,0,1,1,0,0,2,0.666667,0.75,0
5094,,,tesstrob,5,1,6,5,1,6,0.2,0.033436,0,0,0,0
5095,,,FatmaSya24,0,1,1,0,1,1,0,0,1,1,1,0
5096,,,stayhealthy_yuz,0,1,1,0,1,1,0,0,1,1,1,0
5097,,,gusudilf,6,1,7,6,1,7,0.166667,0.040123,0,0,0,0
5098,,,AntoineRoth,0,1,1,0,1,1,0,0,1,1,1,0
5099,,,tsurune1001,0,1,1,0,1,1,0,0,1,1,1,0
5100,,,birb_jaybird,0,1,1,0,1,1,0,0,1,1,1,0
5101,,,YangLi30851271,0,2,2,0,2,2,0,0,1,1,1,0
5102,,,jillywithit,5,1,6,5,1,6,0.2,0.033436,0,0,0,0
5103,,,BadJewishBoy,0,1,1,0,1,1,0,0,1,1,1,0
5104,,,Ricardo_Freire,0,1,1,0,1,1,0,0,1,1,1,0
5105,,,hidayahpouzai_,0,1,1,0,1,1,0,0,1,1,1,0
5106,,,petit_pache,2,1,3,2,1,3,0.5,0.013374,0,0,0,0
5107,,,dbjoy0705,0,1,1,0,1,1,0,0,1,1,1,0
5108,,,elReplicant,2,1,3,2,1,3,0.5,0.013374,0,0,0,0
5109,,,h4anyu,0,1,1,0,1,1,0,0,1,1,1,0
5110,,,padparadshan,0,2,2,0,2,2,0,0,1,1,1,0
5111,,,RockTalkFM,6,1,7,7,2,9,0.166667,0.040123,0,0,0,0
5112,,,miyamiyamore,0,1,1,0,1,1,0,0,1,1,1,0
5113,,,twistoforanges,1,1,2,1,1,2,0,0.006687,0,0,0,0
5114,,,HuiPeng12,2,1,3,2,1,3,0.5,0.013374,0,0,0,0
5115,,,tiruru0803,0,1,1,0,1,1,0,0,1,1,1,0
5116,,,tkc5691,0,1,1,0,1,1,0,0,1,1,1,0
5117,,,leafmeal0n3,0,1,1,0,1,1,0,0,1,1,1,0
5118,,,lgresassoc,0,1,1,0,1,1,0,0,1,1,1,0
5119,,,MikaelChriste16,0,1,1,0,1,1,0,0,1,1,1,0
5120,,,_RossxX_,0,1,1,0,1,1,0,0,1,1,1,0
5121,,,kochtucky,0,1,1,0,1,1,0,0,1,1,1,0
5122,,,aveyri1,0,1,1,0,1,1,0,0,1,1,1,0
5123,,,Iovesickjmn,0,1,1,0,1,1,0,0,1,1,1,0
5124,,,ungsimoun,7,1,8,7,1,8,0.142857,0.04681,0,0,0,0
5125,,,hottosauce,0,1,1,0,1,1,0,0,1,1,1,0
5126,,,harukasaku,0,2,2,0,3,3,0,0,1,1,1,0
5127,,,ofcismy,0,1,1,0,1,1,0,0,1,1,1,0
5128,,,V0REKUN,0,1,1,0,1,1,0,0,1,1,1,0
5129,,,MelianaMS,0,1,1,0,1,1,0,0,1,1,1,0
5130,,,mhb_ct,1,1,2,1,1,2,0,0.006687,0,0,0,0
5131,,,mattobrienmusic,19,1,20,21,1,22,0.052632,0.144527,0,0,0,0
5132,,,terriblue51,0,1,1,0,1,1,0,0,1,1,1,0
5133,,,lumpy_poof,0,2,2,0,2,2,0,0,1,1,1,0
5134,,,jdnsc,0,1,1,0,1,1,0,0,1,1,1,0
5135,,,asnyexe,0,1,1,0,1,1,0,0,1,1,1,0
5136,,,Nicole64254691,0,3,3,0,3,3,0,0,1,1,1,0
5137,,,flckringhope,0,1,1,0,1,1,0,0,1,1,1,0
5138,,,enigmaticevee,0,1,1,0,1,1,0,0,1,1,1,0
5139,,,shanemichael70,0,1,1,0,1,1,0,0,1,1,1,0
5140,,,CoralReef84,0,1,1,0,2,2,0,0,1,1,1,0
5141,,,tgcfculture,0,1,1,0,1,1,0,0,1,1,1,0
5142,,,papawu1,0,1,1,0,1,1,0,0,1,1,1,0
5143,,,97an_an,0,1,1,0,1,1,0,0,1,1,1,0
5144,,,sannbower,0,1,1,0,1,1,0,0,1,1,1,0
5145,,,sammyridgers1,5,2,7,5,2,7,0.166667,0.033436,1,1,1,4
5146,,,AsAmNews,2,1,3,3,2,5,0.5,0.013374,0,0,0,0
5147,,,schmingal,1,1,2,1,1,2,0,0.006687,0,0,0,0
5148,,,Imawwefan1Go,1,1,2,1,1,2,0,0.006687,0,0,0,0
5149,,,tritaxrunnsocc1,5,1,6,5,1,6,0.2,0.03693,0,0,0,0
5150,,,lee_looch,0,1,1,0,1,1,0,0,1,1,1,0
5151,,,ale_weus,0,1,1,0,1,1,0,0,1,1,1,0
5152,,,damalemo,0,1,1,0,1,1,0,0,1,1,1,0
5153,,,politelypeachy,3,5,8,3,6,9,0.142857,0.020061,1,1,1,8
5154,,,mayoo12859357,0,1,1,0,1,1,0,0,2,0.555556,0.6,0
5155,,,AveryDreamLance,0,1,1,0,1,1,0,0,2,0.555556,0.6,0
5156,,,gusuPuppy,0,3,3,0,3,3,0,0,1,1,1,0
5157,,,MADinSTL,0,1,1,0,1,1,0,0,1,1,1,0
5158,,,jimodestruction,0,1,1,0,1,1,0,0,1,1,1,0
5159,,,ilylululullaby,0,1,1,0,1,1,0,0,1,1,1,0
5160,,,otonalhaven,0,2,2,0,2,2,0,0,1,1,1,0
5161,,,ariesmxxn,0,1,1,0,1,1,0,0,1,1,1,0
5162,,,EarthTiger_98,0,4,4,0,4,4,0,0,1,1,1,0
5163,,,JeanieUSA,9,1,10,9,1,10,0.111111,0.060184,0,0,0,0
5164,,,vanessa412a,0,1,1,0,1,1,0,0,1,1,1,0
5165,,,changguich,1,1,2,1,1,2,0,0.006687,0,0,0,0
5166,,,Mivia1,5,2,7,5,2,7,0.166667,0.033436,1,1,1,4
5167,,,devoteepjm,0,1,1,0,1,1,0,0,2,0.666667,0.75,0
5168,,,markalarcio,0,1,1,0,1,1,0,0,2,0.666667,0.75,0
5169,,,antoinedrowning,0,1,1,0,1,1,0,0,2,0.666667,0.75,0
5170,,,ralazuzu,0,1,1,0,1,1,0,0,2,0.666667,0.75,0
5171,,,YUNAKlM,1,1,2,1,1,2,0,0.006687,0,0,0,0
5172,,,Kimalysong,5,1,6,6,1,7,0.2,0.033436,0,0,0,0
5173,,,spookfessor,0,1,1,0,1,1,0,0,1,1,1,0
5174,,,TranscendDual,0,1,1,0,1,1,0,0,1,1,1,0
5175,,,MandyNabu,0,1,1,0,2,2,0,0,1,1,1,0
5176,,,Seraphine_W23,0,1,1,0,1,1,0,0,1,1,1,0
5177,,,cattiekit,0,1,1,0,2,2,0,0,1,1,1,0
5178,,,winewolveselena,0,2,2,0,2,2,0,0,1,1,1,0
5179,,,Sweet_Jimin_n,0,1,1,0,1,1,0,0,1,1,1,0
5180,,,HopeLoveLaughMA,11,1,12,11,1,12,0.090909,0.073559,0,0,0,0
5181,,,litlovbirs,0,1,1,0,1,1,0,0,1,1,1,0
5182,,,haechanknowless,0,2,2,0,2,2,0,0,1,1,1,0
5183,,,stayujins,0,1,1,0,1,1,0,0,1,1,1,0
5184,,,lilacvinyl004,0,1,1,0,1,1,0,0,1,1,1,0
5185,,,ayliahdr,0,1,1,0,1,1,0,0,1,1,1,0
5186,,,vert51,0,1,1,0,1,1,0,0,1,1,1,0
5187,,,arney_twt,0,1,1,0,1,1,0,0,1,1,1,0
5188,,,KikuskaSimnova,0,1,1,0,1,1,0,0,1,1,1,0
5189,,,ririlvsjm,0,1,1,0,1,1,0,0,1,1,1,0
5190,,,Diah_Padmarani,0,1,1,0,1,1,0,0,1,1,1,0
5191,,,Alli20696241,0,1,1,0,1,1,0,0,1,1,1,0
5192,,,aizawaloved,0,1,1,0,1,1,0,0,1,1,1,0
5193,,,achumu_miya,0,1,1,0,1,1,0,0,1,1,1,0
5194,,,Codrus21,0,1,1,0,1,1,0,0,1,1,1,0
5195,,,1271994yh,0,1,1,0,1,1,0,0,1,1,1,0
5196,,,killua11111,0,1,1,0,1,1,0,0,1,1,1,0
5197,,,BaltRhein,0,1,1,0,1,1,0,0,1,1,1,0
5198,,,joelmeares,0,1,1,0,1,1,0,0,1,1,1,0
5199,,,withskyzk,0,1,1,0,1,1,0,0,1,1,1,0
5200,,,0HehJLie7cUlO71,0,1,1,0,1,1,0,0,1,1,1,0
5201,,,pettymern_,0,1,1,0,1,1,0,0,1,1,1,0
5202,,,satylsohot,5,1,6,5,1,6,0.2,0.033436,0,0,0,0
5203,,,jeanine_scott,0,1,1,0,1,1,0,0,1,1,1,0
5204,,,Yeeyee53285356,0,1,1,0,1,1,0,0,1,1,1,0
5205,,,margin_forex,0,1,1,0,1,1,0,0,1,1,1,0
5206,,,one2prosper,0,1,1,0,1,1,0,0,1,1,1,0
5207,,,ichisoarz,0,1,1,0,1,1,0,0,2,0.6,0.666667,0
5208,,,yurinaru87,0,1,1,0,1,1,0,0,2,0.6,0.666667,0
5209,,,ZachMottl,0,1,1,0,1,1,0,0,2,0.6,0.666667,0
5210,,,holdincourt,0,1,1,0,1,1,0,0,2,0.6,0.666667,0
5211,,,filmcuntress,5,1,6,6,2,8,0.2,0.03889,0,0,0,0
5212,,,SparksAphrodite,1,1,2,1,1,2,0,0.006687,0,0,0,0
5213,,,bardnut,8,1,9,8,1,9,0.125,0.053497,0,0,0,0
5214,,,ArthurK87423142,0,1,1,0,1,1,0,0,1,1,1,0
5215,,,7SHhgrdJgdWrSop,0,2,2,0,2,2,0,0,1,1,1,0
5216,,,DJD81553730,0,1,1,0,1,1,0,0,1,1,1,0
5217,,,2701Anubis,0,1,1,0,1,1,0,0,1,1,1,0
5218,,,mirukawa310,0,2,2,0,2,2,0,0,1,1,1,0
5219,,,ValArgen,0,1,1,0,1,1,0,0,1,1,1,0
5220,,,ElleNewland,1,1,2,1,1,2,0,0.006687,0,0,0,0
5221,,,raasperry,0,1,1,0,1,1,0,0,1,1,1,0
5222,,,haus_of_wu,0,1,1,0,1,1,0,0,1,1,1,0
5223,,,Utesince84,0,1,1,0,1,1,0,0,1,1,1,0
5224,,,sarahjaeleiber,1,1,2,1,1,2,0,0.006687,0,0,0,0
5225,,,tdzwilewski,3,1,4,3,1,4,0.333333,0.020061,0,0,0,0
5226,,,worldpeace435,0,1,1,0,1,1,0,0,1,1,1,0
5227,,,Shibii473,0,1,1,0,1,1,0,0,1,1,1,0
5228,,,DireWolfBarb,0,1,1,0,2,2,0,0,1,1,1,0
5229,,,Jiho_99,2,1,3,2,1,3,0.5,0.013374,0,0,0,0
5230,,,verodianeth,0,1,1,0,1,1,0,0,1,1,1,0
5231,,,preciousjiyang,0,1,1,0,1,1,0,0,1,1,1,0
5232,,,LofLoser,0,1,1,0,1,1,0,0,1,1,1,0
5233,,,ThisismeNNana,0,1,1,0,1,1,0,0,1,1,1,0
5234,,,Lbr789Er,0,1,1,0,1,1,0,0,1,1,1,0
5235,,,_justazza_,0,1,1,0,1,1,0,0,1,1,1,0
5236,,,BrendaKatapodis,0,1,1,0,1,1,0,0,1,1,1,0
5237,,,DeleThrones,0,1,1,0,1,1,0,0,1,1,1,0
5238,,,faerytale_,0,2,2,0,3,3,0,0,1,1,1,0
5239,,,lizditz,0,2,2,0,2,2,0,0,1,1,1,0
5240,,,wyibosh,0,1,1,0,1,1,0,0,1,1,1,0
5241,,,StellaBeat,0,2,2,0,2,2,0,0,1,1,1,0
5242,,,dbs1128,0,1,1,0,1,1,0,0,1,1,1,0
5243,,,kat0nice,0,1,1,0,1,1,0,0,1,1,1,0
5244,,,yunawasrobbed14,0,1,1,0,1,1,0,0,1,1,1,0
5245,,,nianjiu10651635,0,1,1,0,1,1,0,0,1,1,1,0
5246,,,area_lcsw,7,1,8,8,1,9,0.142857,0.083559,0,0,0,0
5247,,,miharasmission,0,2,2,0,2,2,0,0,1,1,1,0
5248,,,Ibushi_Hanyuism,0,2,2,0,3,3,0,0,1,1,1,0
5249,,,Mango_The_Sheep,0,1,1,0,1,1,0,0,1,1,1,0
5250,,,eDYLuxJL8eOl68q,0,1,1,0,1,1,0,0,1,1,1,0
5251,,,TheAdvocateMag,3,1,4,3,1,4,0.333333,0.020061,0,0,0,0
5252,,,chrokusu,0,1,1,0,1,1,0,0,1,1,1,0
5253,,,youdaimiyu1,0,1,1,0,1,1,0,0,1,1,1,0
5254,,,cestleiden,2,1,3,2,1,3,0.5,0.048317,0,0,0,0
5255,,,wiItedflower,10,2,12,10,2,12,0.090909,0.066871,1,1,1,9
5256,,,Dwayne_Venzen_C,0,4,4,0,4,4,0,0,2,0.666667,0.75,0
5257,,,trashcandyfreak,2,2,4,2,2,4,0.333333,0.068498,1,1,1,17
5258,,,Tellythecairn,3,1,4,3,1,4,0.333333,0.078015,0,0,0,0
5259,,,BDuB859_622,0,1,1,0,1,1,0,0,1,1,1,0
5260,,,edbott,4,1,5,4,1,5,0.25,0.032203,0,0,0,0
5261,,,ElizaWallace27,0,1,1,0,1,1,0,0,1,1,1,0
5262,,,nunu_suya,0,1,1,0,1,1,0,0,1,1,1,0
5263,,,fairyjunii,4,1,5,4,1,5,0.25,0.026749,0,0,0,0
5264,,,PollyannaRabbit,0,1,1,0,1,1,0,0,1,1,1,0
5265,,,crystalpear1954,0,1,1,0,1,1,0,0,1,1,1,0
5266,,,jfandko,2,1,3,2,1,3,0.5,0.013374,0,0,0,0
5267,,,LAArtsOnlinecom,0,1,1,0,1,1,0,0,1,1,1,0
5268,,,YuzuPooh17,0,1,1,0,1,1,0,0,3,0.5,0.514493,0
5269,,,xciepie,0,1,1,0,1,1,0,0,3,0.5,0.514493,0
5270,,,tensIesbiangf,0,1,1,0,1,1,0,0,3,0.5,0.514493,0
5271,,,mi6zez,0,1,1,0,1,1,0,0,3,0.5,0.514493,0
5272,,,Emiri161cm,0,2,2,0,2,2,0,0,3,0.510638,0.534722,0
5273,,,akarnold,3,1,4,3,1,4,0.333333,0.020061,0,0,0,0
5274,,,2Mo0FRAS0qpHhI4,0,1,1,0,1,1,0,0,1,1,1,0
5275,,,ralucutzagy,0,1,1,0,1,1,0,0,1,1,1,0
5276,,,gfeinholtz,0,1,1,0,2,2,0,0,1,1,1,0
5277,,,CutcliffMiller,3,1,4,3,1,4,0.333333,0.020061,0,0,0,0
5278,,,DaryaSmbd,0,1,1,0,1,1,0,0,1,1,1,0
5279,,,SportsCrazee,0,1,1,0,1,1,0,0,1,1,1,0
5280,,,CappyVaVoom,2,1,3,2,1,3,0.5,0.013374,0,0,0,0
5281,,,Kamdokht,0,1,1,0,1,1,0,0,1,1,1,0
5282,,,savannahskeath,0,1,1,0,1,1,0,0,1,1,1,0
5283,,,iriskkwok,1,1,2,1,1,2,0,0.006687,0,0,0,0
5284,,,godgirl4bama,1,1,2,1,1,2,0,0.006687,0,0,0,0
5285,,,dorubakkinya,0,2,2,0,2,2,0,0,2,0.666667,0.75,0
5286,,,purpledalmation,0,1,1,0,1,1,0,0,2,0.6,0.666667,0
5287,,,bernkastelers,0,1,1,0,2,2,0,0,2,0.6,0.666667,0
5288,,,lychee8489,0,1,1,0,1,1,0,0,2,0.6,0.666667,0
5289,,,startorialist,0,1,1,0,1,1,0,0,1,1,1,0
5290,,,4Aforlife,0,2,2,0,2,2,0,0,1,1,1,0
5291,,,yukilattee,0,3,3,0,4,4,0,0,1,1,1,0
5292,,,bnkfortyeight,4,2,6,5,2,7,0,0.01584,1,1,1,8
5293,,,siena_axel,0,1,1,0,1,1,0,0,1,1,1,0
5294,,,topmark_yuran,0,2,2,0,2,2,0,0,1,1,1,0
5295,,,firebird104,0,1,1,0,1,1,0,0,1,1,1,0
5296,,,emumeetllama,1,1,2,1,1,2,0,0.006687,0,0,0,0
5297,,,FOXXXXFIRE5,6,1,7,7,2,9,0.166667,0.051032,0,0,0,0
5298,,,AngelJo84317699,0,2,2,0,2,2,0,0,1,1,1,0
5299,,,GHQ2000,0,1,1,0,1,1,0,0,1,1,1,0
5300,,,prssdpnini,0,1,1,0,1,1,0,0,1,1,1,0
5301,,,techjunkiejh,2,1,3,2,1,3,0.5,0.013374,0,0,0,0
5302,,,GavlikMary,0,1,1,0,1,1,0,0,1,1,1,0
5303,,,Iilacsapphic,3,1,4,3,1,4,0.333333,0.075185,0,0,0,0
5304,,,NathanWurtzel,0,1,1,0,1,1,0,0,1,1,1,0
5305,,,cottonxmz,9,1,10,10,2,12,0.111111,0.060184,0,0,0,0
5306,,,The_Awesome_A,3,1,4,3,1,4,0.333333,0.020061,0,0,0,0
5307,,,queenbee8162,0,1,1,0,1,1,0,0,1,1,1,0
5308,,,QyILMgpVQJQ109j,2,1,3,3,2,5,0.5,0.016869,0,0,0,0
5309,,,JASWFS42,7,2,9,7,2,9,0.125,0.055759,1,1,1,8
5310,,,Winterbearlovee,2,1,3,2,1,3,0,0.00792,2,0.666667,0.75,4
5311,,,Phyllis17570617,0,3,3,0,3,3,0,0,2,0.8,0.875,0
5312,,,flywithirish,0,1,1,0,1,1,0,0,2,0.666667,0.75,0
5313,,,kimasabe,1,2,3,1,2,3,0.5,0.006687,2,0.666667,0.75,0
5314,,,CecilBrown18,0,1,1,0,1,1,0,0,3,0.5,0.611111,0
5315,,,debyuen,3,1,4,3,1,4,0.333333,0.020061,0,0,0,0
5316,,,WhereIsYasmin,0,1,1,0,1,1,0,0,1,1,1,0
5317,,,squi_hobi,0,1,1,0,1,1,0,0,1,1,1,0
5318,,,moshimarker,1,2,3,1,2,3,0.5,0.006687,1,1,1,0
5319,,,mafomuhahaha,1,1,2,1,1,2,0,0.006687,0,0,0,0
5320,,,KyleOrkmansen,3,1,4,3,1,4,0.333333,0.030544,0,0,0,0
5321,,,dean_pho_love16,0,1,1,0,1,1,0,0,1,1,1,0
5322,,,CindyDamschrod1,2,1,3,2,1,3,0.5,0.023857,0,0,0,0
5323,,,googiefriend,4,1,5,4,1,5,0.25,0.037231,0,0,0,0
5324,,,melnlord,0,1,1,0,1,1,0,0,1,1,1,0
5325,,,js07073,0,1,1,0,1,1,0,0,1,1,1,0
5326,,,Hildtom1,0,1,1,0,1,1,0,0,1,1,1,0
5327,,,fatoulogy,0,1,1,0,1,1,0,0,1,1,1,0
5328,,,StayCalmBeKind1,0,1,1,0,1,1,0,0,1,1,1,0
5329,,,CB_Sweetheart,2,1,3,2,1,3,0.5,0.013374,0,0,0,0
5330,,,diorjjgks,0,1,1,0,1,1,0,0,1,1,1,0
5331,,,leoeli_brainrot,11,1,12,13,3,16,0.090909,0.077053,0,0,0,0
5332,,,helenthevet,9,1,10,10,1,11,0.111111,0.060184,0,0,0,0
5333,,,sariceydi,0,1,1,0,1,1,0,0,1,1,1,0
5334,,,MarlowNYC,0,1,1,0,1,1,0,0,1,1,1,0
5335,,,OLLGum2,0,1,1,0,1,1,0,0,1,1,1,0
5336,,,fan_jazzfan6912,0,1,1,0,1,1,0,0,1,1,1,0
5337,,,jmarine,0,1,1,0,1,1,0,0,1,1,1,0
5338,,,SassyGma6,0,1,1,0,1,1,0,0,1,1,1,0
5339,,,LiteratiGeek,1,1,2,1,1,2,0,0.006687,0,0,0,0
5340,,,Add_Whoa_Uh,6,1,7,6,1,7,0.166667,0.040123,0,0,0,0
5341,,,NewGuardsRising,0,1,1,0,1,1,0,0,1,1,1,0
5342,,,alexthezombie8,0,1,1,0,1,1,0,0,1,1,1,0
5343,,,Thee_LB53,0,2,2,0,2,2,0,0,1,1,1,0
5344,,,eleanor8510,0,1,1,0,1,1,0,0,1,1,1,0
5345,,,Lullabyeol1,0,1,1,0,1,1,0,0,1,1,1,0
5346,,,Foxmental_X,1,1,2,1,1,2,0,0.006687,0,0,0,0
5347,,,rustyybrain,2,1,3,2,1,3,0.5,0.013374,0,0,0,0
5348,,,pixitannies,0,2,2,0,2,2,0,0,1,1,1,0
5349,,,roseazeneth22,0,1,1,0,1,1,0,0,1,1,1,0
5350,,,beethovensRemix,0,1,1,0,1,1,0,0,1,1,1,0
5351,,,exostalker4,0,1,1,0,1,1,0,0,1,1,1,0
5352,,,RonDC27,15,1,16,21,1,22,0.066667,0.198674,0,0,0,0
5353,,,joonsplantitas,0,1,1,0,1,1,0,0,1,1,1,0
5354,,,4WYiboDi,0,2,2,0,8,8,0,0,2,0.666667,0.75,0
5355,,,sungharin,0,2,2,0,2,2,0,0,1,1,1,0
5356,,,jha1MCHRov3FQLx,0,1,1,0,1,1,0,0,1,1,1,0
5357,,,IESportsRadio,0,2,2,0,2,2,0,0,1,1,1,0
5358,,,Seeyouln,0,1,1,0,1,1,0,0,1,1,1,0
5359,,,officialkblaize,0,6,6,0,6,6,0,0,2,0.875,0.928571,0
5360,,,mang0m0,0,3,3,0,3,3,0,0,1,1,1,0
5361,,,Sujuan_Ba,0,1,1,0,1,1,0,0,1,1,1,0
5362,,,masaruobasama,0,1,1,0,1,1,0,0,1,1,1,0
5363,,,Christinamn24,3,1,4,3,1,4,0.333333,0.042169,0,0,0,0
5364,,,56chiro104,0,1,1,0,1,1,0,0,1,1,1,0
5365,,,mlsensus,1,1,2,1,1,2,0,0.006687,0,0,0,0
5366,,,JimCordell,1,1,2,1,1,2,0,0.006687,0,0,0,0
5367,,,coochieconsumr,3,1,4,3,1,4,0.333333,0.020061,0,0,0,0
5368,,,PsyxhCnA,0,1,1,0,1,1,0,0,1,1,1,0
5369,,,yooncitos,0,1,1,0,1,1,0,0,1,1,1,0
5370,,,morganemilyg,2,1,3,2,1,3,0.5,0.013374,0,0,0,0
5371,,,247sportscard,1,1,2,1,1,2,0,0.006687,0,0,0,0
5372,,,CeOrav3yX4MEwoz,0,2,2,0,2,2,0,0,1,1,1,0
5373,,,LauraPhillips99,0,1,1,0,1,1,0,0,1,1,1,0
5374,,,MichelleFait,1,1,2,1,1,2,0,0.006687,0,0,0,0
5375,,,indiedocsf,1,1,2,1,1,2,0,0.006687,0,0,0,0
5376,,,mimi_kinmikan,0,2,2,0,2,2,0,0,1,1,1,0
5377,,,TomVargheseJr,0,1,1,0,1,1,0,0,1,1,1,0
5378,,,neelyvegaslaw,0,1,1,0,1,1,0,0,1,1,1,0
5379,,,niemingjueee,5,3,8,5,3,8,0.142857,0.033436,1,1,1,8
5380,,,NoaGamboa,0,4,4,0,4,4,0,0,2,0.75,0.833333,0
5381,,,OifutaA,0,1,1,0,1,1,0,0,2,0.6,0.666667,0
5382,,,bethlevin,0,2,2,0,2,2,0,0,2,0.666667,0.75,0
5383,,,Mykiwitwit,0,1,1,0,1,1,0,0,1,1,1,0
5384,,,B1xing,0,1,1,0,1,1,0,0,1,1,1,0
5385,,,albeck2130,0,2,2,0,2,2,0,0,1,1,1,0
5386,,,05y1bb,0,1,1,0,1,1,0,0,1,1,1,0
5387,,,Alex_The_Army,0,1,1,0,1,1,0,0,1,1,1,0
5388,,,uhhyuta,0,1,1,0,1,1,0,0,1,1,1,0
5389,,,dohertybm,7,1,8,7,1,8,0.142857,0.04681,0,0,0,0
5390,,,susansvete,0,1,1,0,1,1,0,0,1,1,1,0
5391,,,fkvchi,0,2,2,0,2,2,0,0,1,1,1,0
5392,,,GabeShepperd,0,2,2,0,2,2,0,0,1,1,1,0
5393,,,LydWalkerR5,1,1,2,1,1,2,0,0.006687,0,0,0,0
5394,,,GDW37,11,1,12,13,1,14,0.090909,0.077053,0,0,0,0
5395,,,Seamuskitty,0,1,1,0,1,1,0,0,1,1,1,0
5396,,,dubujinki21,0,1,1,0,1,1,0,0,1,1,1,0
5397,,,kkp_063,0,1,1,0,1,1,0,0,1,1,1,0
5398,,,jhsbesos,0,1,1,0,1,1,0,0,1,1,1,0
5399,,,frandershgoldst,0,1,1,0,1,1,0,0,1,1,1,0
5400,,,Paulaexe2,0,2,2,0,4,4,0,0,1,1,1,0
5401,,,usa_partisan,0,1,1,0,1,1,0,0,1,1,1,0
5402,,,ichigomilky5,0,2,2,0,2,2,0,0,1,1,1,0
5403,,,theblairb1tch,2,1,3,2,1,3,0.5,0.013374,0,0,0,0
5404,,,genshiiiiiiiiin,0,1,1,0,1,1,0,0,1,1,1,0
5405,,,aceyoungeunz,0,1,1,0,1,1,0,0,1,1,1,0
5406,,,folklrejk,6,1,7,6,1,7,0.166667,0.057594,0,0,0,0
5407,,,muchoseok,0,3,3,0,3,3,0,0,1,1,1,0
5408,,,ReturnOfKing217,0,1,1,0,1,1,0,0,1,1,1,0
5409,,,TheSilverFox_,1,1,2,1,1,2,0,0.006687,0,0,0,0
5410,,,cbleck,3,1,4,3,1,4,0.333333,0.020061,0,0,0,0
5411,,,HeliDarling,0,1,1,0,1,1,0,0,1,1,1,0
5412,,,MEJim9,0,2,2,0,2,2,0,0,1,1,1,0
5413,,,mauvePD,5,1,6,5,1,6,0.2,0.033436,0,0,0,0
5414,,,qlee50,0,1,1,0,1,1,0,0,1,1,1,0
5415,,,kylecmuse,2,1,3,2,1,3,0.5,0.013374,0,0,0,0
5416,,,catterown,0,2,2,0,2,2,0,0,1,1,1,0
5417,,,anyashcohen,2,1,3,3,2,5,0.5,0.013374,0,0,0,0
5418,,,yuzumai1207,0,1,1,0,1,1,0,0,1,1,1,0
5419,,,HalLawton1,0,1,1,0,1,1,0,0,1,1,1,0
5420,,,jcofield1231,0,1,1,0,1,1,0,0,1,1,1,0
5421,,,peachteajw,0,1,1,0,1,1,0,0,1,1,1,0
5422,,,xcarianna,0,1,1,0,1,1,0,0,1,1,1,0
5423,,,tompaine44,0,1,1,0,1,1,0,0,1,1,1,0
5424,,,aniyuzuh,2,1,3,2,1,3,0.5,0.013374,0,0,0,0
5425,,,ari_sandy18,0,1,1,0,1,1,0,0,1,1,1,0
5426,,,Maluhia808,0,1,1,0,1,1,0,0,1,1,1,0
5427,,,runrunhyuzu,0,1,1,0,1,1,0,0,1,1,1,0
5428,,,nayeonffw,0,1,1,0,1,1,0,0,1,1,1,0
5429,,,anyagron,4,1,5,5,2,7,0.25,0.030243,0,0,0,0
5430,,,emmalisa45,0,1,1,0,1,1,0,0,1,1,1,0
5431,,,ljall00,0,1,1,0,1,1,0,0,1,1,1,0
5432,,,PoloPersonGwen,1,2,3,1,2,3,0.5,0.006687,1,1,1,0
5433,,,imyjimmy,2,1,3,2,1,3,0.5,0.013374,0,0,0,0
5434,,,rjrabbit2001,0,1,1,0,1,1,0,0,1,1,1,0
5435,,,blissfulleo_,0,1,1,0,1,1,0,0,1,1,1,0
5436,,,seenemsaw,0,1,1,0,1,1,0,0,2,0.666667,0.75,0
5437,,,ange1cake_,3,1,4,3,1,4,0.333333,0.020061,0,0,0,0
5438,,,oasisjo1009,0,1,1,0,1,1,0,0,1,1,1,0
5439,,,MissMakatz18,0,1,1,0,1,1,0,0,1,1,1,0
5440,,,505tz,2,1,3,2,1,3,0.5,0.013374,0,0,0,0
5441,,,sag52,0,1,1,0,1,1,0,0,1,1,1,0
5442,,,kutakinee,0,1,1,0,1,1,0,0,1,1,1,0
5443,,,kish_alice,0,1,1,0,1,1,0,0,1,1,1,0
5444,,,OTsmXxv5cC1kj88,0,1,1,0,1,1,0,0,1,1,1,0
5445,,,SammyCSCS,1,1,2,1,1,2,0,0.006687,0,0,0,0
5446,,,kitkiti,2,1,3,2,1,3,0.5,0.013374,0,0,0,0
5447,,,Rose55193,0,1,1,0,1,1,0,0,1,1,1,0
5448,,,uyenmpv,5,1,6,6,1,7,0.2,0.033436,0,0,0,0
5449,,,verwandlung1915,0,1,1,0,1,1,0,0,1,1,1,0
5450,,,tlayoalli,0,1,1,0,1,1,0,0,1,1,1,0
5451,,,lorofnorcal,0,1,1,0,1,1,0,0,1,1,1,0
5452,,,Southernbami,1,1,2,1,1,2,0,0.006687,0,0,0,0
5453,,,sophieskates09,0,1,1,0,1,1,0,0,1,1,1,0
5454,,,NatashaPerez24,6,1,7,7,1,8,0.166667,0.040123,0,0,0,0
5455,,,wolf_hopper,0,1,1,0,1,1,0,0,1,1,1,0
5456,,,RippleJanis,0,1,1,0,1,1,0,0,1,1,1,0
5457,,,pasadenamama,0,1,1,0,1,1,0,0,1,1,1,0
5458,,,yuzufanat1c,0,1,1,0,2,2,0,0,1,1,1,0
5459,,,SUCardinalRule,0,1,1,0,1,1,0,0,1,1,1,0
5460,,,demons_sight,1,1,2,1,1,2,0,0.006687,0,0,0,0
5461,,,konomis68,0,1,1,0,1,1,0,0,1,1,1,0
5462,,,helogicV_G,0,1,1,0,1,1,0,0,1,1,1,0
5463,,,jennyobrien42,0,1,1,0,1,1,0,0,1,1,1,0
5464,,,FlyHigh_AndFree,0,1,1,0,1,1,0,0,1,1,1,0
5465,,,61signs,0,1,1,0,1,1,0,0,1,1,1,0
5466,,,FriedasMom7,0,1,1,0,1,1,0,0,1,1,1,0
5467,,,AndreaLLegarrea,0,1,1,0,1,1,0,0,1,1,1,0
5468,,,teeami_,0,1,1,0,1,1,0,0,1,1,1,0
5469,,,ayotunde005_,0,1,1,0,1,1,0,0,1,1,1,0
5470,,,willeyhhfixeu,0,1,1,0,1,1,0,0,1,1,1,0
5471,,,RuthSas,0,1,1,0,1,1,0,0,1,1,1,0
5472,,,mkposh,0,3,3,0,3,3,0,0,1,1,1,0
5473,,,johnxuxi,7,1,8,7,1,8,0.142857,0.04681,0,0,0,0
5474,,,JRRRulfo,0,2,2,0,2,2,0,0,1,1,1,0
5475,,,kingtaehyunged,0,1,1,0,1,1,0,0,1,1,1,0
5476,,,yoongisliltoes,0,1,1,0,1,1,0,0,1,1,1,0
5477,,,MEMrunner,0,1,1,0,1,1,0,0,1,1,1,0
5478,,,jkxugh,0,1,1,0,1,1,0,0,1,1,1,0
5479,,,omarkurdi20,3,1,4,3,1,4,0.333333,0.029351,0,0,0,0
5480,,,Dpullen66,1,1,2,1,1,2,0,0.006687,0,0,0,0
5481,,,cymaronet,0,1,1,0,1,1,0,0,1,1,1,0
5482,,,soulhealer_jay,4,1,5,4,1,5,0.25,0.03493,0,0,0,0
5483,,,nitabbrown,0,1,1,0,1,1,0,0,1,1,1,0
5484,,,eni_yae,0,1,1,0,1,1,0,0,1,1,1,0
5485,,,JustOutTV,3,1,4,3,1,4,0.333333,0.020061,0,0,0,0
5486,,,raspuxin,0,1,1,0,1,1,0,0,1,1,1,0
5487,,,moberzan,0,1,1,0,1,1,0,0,1,1,1,0
5488,,,tgyutistt,0,1,1,0,1,1,0,0,1,1,1,0
5489,,,km6527,0,1,1,0,1,1,0,0,1,1,1,0
5490,,,LifeOnTheBeach7,2,1,3,2,1,3,0.5,0.013374,0,0,0,0
5491,,,notasingleidea1,0,1,1,0,1,1,0,0,1,1,1,0
5492,,,fairygyuwon,2,1,3,2,1,3,0.5,0.013374,0,0,0,0
5493,,,kr31133,0,1,1,0,1,1,0,0,1,1,1,0
5494,,,winwin_nsfw,0,1,1,0,1,1,0,0,1,1,1,0
5495,,,brocolli_muffin,0,1,1,0,1,1,0,0,1,1,1,0
5496,,,rdaehn,8,1,9,8,1,9,0.125,0.060486,0,0,0,0
5497,,,bmaher0846,0,1,1,0,1,1,0,0,1,1,1,0
5498,,,TheLonester,0,1,1,0,1,1,0,0,1,1,1,0
5499,,,crystalmmrs,2,3,5,2,3,5,0.25,0.013374,1,1,1,2
5500,,,donna_moskal,0,1,1,0,1,1,0,0,1,1,1,0
5501,,,yysalummitedu,0,1,1,0,1,1,0,0,1,1,1,0
5502,,,rondetta7513,0,1,1,0,1,1,0,0,1,1,1,0
5503,,,ForesterBF,1,1,2,1,1,2,0,0.006687,0,0,0,0
5504,,,sandyhamada,2,1,3,2,1,3,0.5,0.013374,0,0,0,0
5505,,,xz7KQRe9oTeb7Yg,0,1,1,0,1,1,0,0,1,1,1,0
5506,,,annalynnmartino,6,1,7,7,1,8,0.166667,0.040123,0,0,0,0
5507,,,scholezforum,0,5,5,0,5,5,0,0,1,1,1,0
5508,,,rwschaeferiii,0,1,1,0,2,2,0,0,1,1,1,0
5509,,,sempiternels,0,2,2,0,2,2,0,0,1,1,1,0
5510,,,iCLeo_,0,1,1,0,1,1,0,0,1,1,1,0
5511,,,NicolaTenerelli,0,1,1,0,1,1,0,0,1,1,1,0
5512,,,vanek_jen,2,1,3,2,1,3,0.5,0.013374,0,0,0,0
5513,,,andrewngyyc,0,1,1,0,1,1,0,0,1,1,1,0
5514,,,adrifur,2,1,3,2,1,3,0.5,0.013374,0,0,0,0
5515,,,namtaejiyong,0,1,1,0,1,1,0,0,1,1,1,0
5516,,,TWiseheart,11,1,12,11,1,12,0.090909,0.097234,0,0,0,0
5517,,,KitchenMarques,0,2,2,0,2,2,0,0,1,1,1,0
5518,,,hell_ocaust,0,1,1,0,1,1,0,0,1,1,1,0
5519,,,MarilynNull,0,1,1,0,1,1,0,0,1,1,1,0
5520,,,bokutofu,0,1,1,0,1,1,0,0,1,1,1,0
5521,,,SUMlK0,6,2,8,8,3,11,0.142857,0.050606,1,1,1,7
5522,,,sba1211,0,1,1,0,1,1,0,0,1,1,1,0
5523,,,wildlifer22,0,1,1,0,1,1,0,0,1,1,1,0
5524,,,franster23,0,1,1,0,1,1,0,0,1,1,1,0
5525,,,alberte15411571,4,2,6,5,3,8,0.2,0.026749,1,1,1,3
5526,,,MyraDSirois1,0,1,1,0,1,1,0,0,2,0.666667,0.75,0
5527,,,JackBuckman3,0,1,1,0,1,1,0,0,2,0.666667,0.75,0
5528,,,GrepaKeppa,9,1,10,11,3,14,0.111111,0.060184,0,0,0,0
5529,,,Ken58198,0,1,1,0,1,1,0,0,1,1,1,0
5530,,,whsdd123,0,1,1,0,1,1,0,0,2,0.666667,0.75,0
5531,,,TheoryCriticism,0,1,1,0,1,1,0,0,2,0.666667,0.75,0
5532,,,ma_nyc7,0,2,2,0,2,2,0,0,2,0.75,0.833333,0
5533,,,MateusWMD,6,1,7,6,1,7,0.166667,0.040123,0,0,0,0
5534,,,slimchick1900,0,1,1,0,1,1,0,0,1,1,1,0
5535,,,BrazeauMarie,0,1,1,0,1,1,0,0,1,1,1,0
5536,,,ana_captures,0,1,1,0,1,1,0,0,1,1,1,0
5537,,,rameeksims,24,1,25,33,7,40,0.041667,0.160491,0,0,0,0
5538,,,fly__yuzu,0,2,2,0,2,2,0,0,1,1,1,0
5539,,,bakugay_catsuki,5,1,6,5,1,6,0.2,0.033436,0,0,0,0
5540,,,OnweK,0,1,1,0,1,1,0,0,1,1,1,0
5541,,,ladyndewgreen88,0,1,1,0,1,1,0,0,1,1,1,0
5542,,,whitecrystal001,0,4,4,0,4,4,0,0,1,1,1,0
5543,,,headlandfash,0,1,1,0,1,1,0,0,1,1,1,0
5544,,,mentallyilljew,1,1,2,1,1,2,0,0.006687,0,0,0,0
5545,,,butleriano,8,1,9,8,1,9,0.125,0.053497,0,0,0,0
5546,,,ikateufel,0,7,7,0,7,7,0,0,1,1,1,0
5547,,,1015_cookie,0,1,1,0,1,1,0,0,1,1,1,0
5548,,,olayinkaoluyemi,0,2,2,0,2,2,0,0,1,1,1,0
5549,,,diminiepuff,0,5,5,0,5,5,0,0,3,0.5,0.575758,0
5550,,,NewsJunkie60,0,1,1,0,1,1,0,0,1,1,1,0
5551,,,dandeliondani18,0,1,1,0,1,1,0,0,1,1,1,0
5552,,,belovedmaraclea,0,1,1,0,1,1,0,0,1,1,1,0
5553,,,walf_,3,1,4,3,1,4,0.333333,0.020061,0,0,0,0
5554,,,ErvinGotti1,0,1,1,0,1,1,0,0,1,1,1,0
5555,,,Dalocoengineer,0,1,1,0,1,1,0,0,1,1,1,0
5556,,,Rusihans12,2,1,3,2,1,3,0.5,0.013374,0,0,0,0
5557,,,pamelarwhouston,0,1,1,0,1,1,0,0,1,1,1,0
5558,,,njmike731,0,7,7,0,7,7,0,0,1,1,1,0
5559,,,Kalaax008,0,1,1,0,1,1,0,0,1,1,1,0
5560,,,pattihaze,0,1,1,0,1,1,0,0,1,1,1,0
5561,,,CNN,51,1,52,57,7,64,0.019608,0.400446,0,0,0,0
5562,,,Local4Sports,13,1,14,19,7,26,0.076923,0.086933,0,0,0,0
5563,,,nellhuggins,0,1,1,0,1,1,0,0,1,1,1,0
5564,,,jft66354447,0,1,1,0,1,1,0,0,1,1,1,0
5565,,,AlcideLaVassar,0,1,1,0,1,1,0,0,1,1,1,0
5566,,,Masky_Jay_Hoody,0,1,1,0,1,1,0,0,1,1,1,0
5567,,,DoctorLindaB,0,1,1,0,1,1,0,0,1,1,1,0
5568,,,lovelyprkjm95,0,1,1,0,1,1,0,0,1,1,1,0
5569,,,TsukiHeKaiwa,1,2,3,1,2,3,0.5,0.006687,1,1,1,0
5570,,,hockeydocs,0,1,1,0,1,1,0,0,1,1,1,0
5571,,,kinzzsmith,0,1,1,0,1,1,0,0,1,1,1,0
5572,,,goldenaspen,0,1,1,0,1,1,0,0,1,1,1,0
5573,,,JamesJurovic,1,1,2,1,1,2,0,0.006687,0,0,0,0
5574,,,AlexDonovan13,1,1,2,1,1,2,0,0.006687,0,0,0,0
5575,,,holidayinnitto,1,1,2,1,1,2,0,0.006687,0,0,0,0
5576,,,SetsukoWinches1,4,1,5,4,1,5,0.25,0.026749,0,0,0,0
5577,,,GeorgeTimberl11,0,1,1,0,1,1,0,0,1,1,1,0
5578,,,donna_spackman,0,1,1,0,1,1,0,0,1,1,1,0
5579,,,Angelwings96701,0,4,4,0,5,5,0,0,2,0.666667,0.75,0
5580,,,MsSunnySideUp,1,1,2,1,1,2,0,0.006687,0,0,0,0
5581,,,NBCDFW,2,1,3,6,5,11,0.5,0.013374,0,0,0,0
5582,,,BarbiesAllEx,1,1,2,1,1,2,0,0.006687,0,0,0,0
5583,,,nynormie,1,1,2,2,2,4,0,0.006687,0,0,0,0
5584,,,VoXevangeline,3,1,4,3,1,4,0.333333,0.020061,0,0,0,0
5585,,,chaunceyath,0,1,1,0,1,1,0,0,1,1,1,0
5586,,,PRKJYJK_,0,1,1,0,1,1,0,0,1,1,1,0
5587,,,earlgreyrose,0,3,3,0,3,3,0,0,5,0.452055,0.506061,0
5588,,,phenriqdrawing,0,1,1,0,1,1,0,0,1,1,1,0
5589,,,eleahrose_,2,1,3,2,1,3,0.5,0.013374,0,0,0,0
5590,,,NickofTime925,0,1,1,0,1,1,0,0,1,1,1,0
5591,,,collinfans,3,1,4,3,1,4,0.333333,0.023556,0,0,0,0
5592,,,JParkins10,0,1,1,0,1,1,0,0,1,1,1,0
5593,,,RobynKanter,4,1,5,4,1,5,0.25,0.026749,0,0,0,0
5594,,,wanchanlovely,0,2,2,0,2,2,0,0,1,1,1,0
5595,,,Democracy_Spot,0,1,1,0,1,1,0,0,1,1,1,0
5596,,,alatus_ara,0,1,1,0,1,1,0,0,1,1,1,0
5597,,,KennyDreadfuls,3,1,4,3,1,4,0.333333,0.020061,0,0,0,0
5598,,,ken_garrison,0,1,1,0,1,1,0,0,1,1,1,0
5599,,,mdtucker120,0,1,1,0,1,1,0,0,1,1,1,0
5600,,,mortgageconsult,1,1,2,1,1,2,0,0.006687,0,0,0,0
5601,,,apileofcranes,1,1,2,1,1,2,0,0.006687,0,0,0,0
5602,,,izzymedbery,2,1,3,2,1,3,0.5,0.013374,0,0,0,0
5603,,,stantjaden,0,1,1,0,1,1,0,0,1,1,1,0
5604,,,AspenInstSports,4,1,5,4,1,5,0.25,0.026749,0,0,0,0
5605,,,L4NAV1TA,0,1,1,0,1,1,0,0,1,1,1,0
5606,,,KateMThomp,0,1,1,0,1,1,0,0,1,1,1,0
5607,,,FascismDefeat,0,1,1,0,1,1,0,0,1,1,1,0
5608,,,PennyRishi,1,1,2,1,1,2,0,0.006687,0,0,0,0
5609,,,MB12762107,6,1,7,7,1,8,0.166667,0.040123,0,0,0,0
5610,,,halimnita,0,1,1,0,1,1,0,0,1,1,1,0
5611,,,MikeBurz,0,1,1,0,1,1,0,0,1,1,1,0
5612,,,DemocryCovenant,0,1,1,0,1,1,0,0,1,1,1,0
5613,,,loonatlma,1,1,2,1,1,2,0,0.006687,0,0,0,0
5614,,,SunWuKong,4,1,5,4,1,5,0.25,0.026749,0,0,0,0
5615,,,J6Nasty,0,1,1,0,1,1,0,0,1,1,1,0
5616,,,1naturalzeta,0,1,1,0,1,1,0,0,1,1,1,0
5617,,,kariimins,0,1,1,0,1,1,0,0,1,1,1,0
5618,,,EricJHovland,1,1,2,1,1,2,0,0.006687,0,0,0,0
5619,,,Kim4isTech,5,1,6,5,1,6,0.2,0.033436,0,0,0,0
5620,,,BienenSchoolNU,0,1,1,0,1,1,0,0,1,1,1,0
5621,,,lipkinlip,0,1,1,0,1,1,0,0,1,1,1,0
5622,,,kxtie06__,0,1,1,0,1,1,0,0,1,1,1,0
5623,,,lovelybunkoo,0,2,2,0,2,2,0,0,3,0.555556,0.666667,0
5624,,,jaoIimns,0,1,1,0,1,1,0,0,3,0.466667,0.52381,0
5625,,,ipeachukai,0,1,1,0,1,1,0,0,3,0.466667,0.52381,0
5626,,,das_varun99,0,1,1,0,1,1,0,0,1,1,1,0
5627,,,thedailybeast,7,1,8,8,2,10,0.142857,0.04681,0,0,0,0
5628,,,mhookrob,0,1,1,0,1,1,0,0,1,1,1,0
5629,,,dkavanaugh,0,1,1,0,1,1,0,0,1,1,1,0
5630,,,hoe_seoktrash,0,1,1,0,1,1,0,0,1,1,1,0
5631,,,lilyyyscottt,0,2,2,0,2,2,0,0,1,1,1,0
5632,,,ElliottJwejwe1,0,1,1,0,1,1,0,0,1,1,1,0
5633,,,hunter121378,3,1,4,3,1,4,0.333333,0.020061,0,0,0,0
5634,,,111000111_twtt,0,3,3,0,3,3,0,0,1,1,1,0
5635,,,rcswift,0,1,1,0,1,1,0,0,1,1,1,0
5636,,,woodmally1979,1,1,2,1,1,2,0,0.006687,0,0,0,0
5637,,,JenniferEWatts,5,1,6,6,2,8,0.2,0.033436,0,0,0,0
5638,,,RaniSapra,6,1,7,6,1,7,0.166667,0.040123,0,0,0,0
5639,,,ieatwhitecats,0,1,1,0,1,1,0,0,1,1,1,0
5640,,,Xagent0024,0,1,1,0,1,1,0,0,1,1,1,0
5641,,,parkersdjh,0,1,1,0,1,1,0,0,1,1,1,0
5642,,,KevinWhatcom,0,1,1,0,1,1,0,0,1,1,1,0
5643,,,BELAlREE,0,1,1,0,1,1,0,0,1,1,1,0
5644,,,smartelephant3,4,1,5,4,1,5,0.25,0.026749,0,0,0,0
5645,,,kathiefoko,0,1,1,0,1,1,0,0,1,1,1,0
5646,,,lpbradley,0,1,1,0,1,1,0,0,1,1,1,0
5647,,,glrush13,9,1,10,9,1,10,0.111111,0.063679,0,0,0,0
5648,,,CahoonMetzgerS,0,3,3,0,3,3,0,0,1,1,1,0
5649,,,5fabmeows,0,1,1,0,1,1,0,0,1,1,1,0
5650,,,moghilemear13,0,2,2,0,2,2,0,0,1,1,1,0
5651,,,dks1soo,0,3,3,0,3,3,0,0,1,1,1,0
5652,,,bunkync88,0,1,1,0,1,1,0,0,1,1,1,0
5653,,,kollin_with_a_k,2,1,3,2,1,3,0.5,0.013374,0,0,0,0
5654,,,TracyConnor,0,1,1,0,1,1,0,0,1,1,1,0
5655,,,VABVOX,4,1,5,4,1,5,0.25,0.026749,0,0,0,0
5656,,,luckyginnie3,0,2,2,0,2,2,0,0,1,1,1,0
5657,,,sunoorous,0,1,1,0,1,1,0,0,1,1,1,0
5658,,,firajja,0,2,2,0,2,2,0,0,1,1,1,0
5659,,,ryujinsbeloved,1,1,2,1,1,2,0,0.006687,0,0,0,0
5660,,,rjbeeth,0,1,1,0,1,1,0,0,1,1,1,0
5661,,,ChampGoff,0,1,1,0,1,1,0,0,1,1,1,0
5662,,,CityofTustin,1,1,2,1,1,2,0,0.006687,0,0,0,0
5663,,,AnielkaEla,0,1,1,0,1,1,0,0,1,1,1,0
5664,,,SallythePitBull,0,1,1,0,1,1,0,0,1,1,1,0
5665,,,KellyArola,0,1,1,0,1,1,0,0,1,1,1,0
5666,,,kpfallon,2,1,3,2,1,3,0.5,0.013374,0,0,0,0
5667,,,redheadyogi,0,1,1,0,1,1,0,0,1,1,1,0
5668,,,yoongsbesmol,0,3,3,0,3,3,0,0,2,0.8,0.875,0
5669,,,BlackGargoyle1,0,1,1,0,1,1,0,0,1,1,1,0
5670,,,PamelaFalk,0,1,1,0,1,1,0,0,1,1,1,0
5671,,,mghnmuffin,0,1,1,0,1,1,0,0,1,1,1,0
5672,,,ColeDavis84,5,1,6,5,1,6,0.2,0.033436,0,0,0,0
5673,,,wakabbyy,0,1,1,0,1,1,0,0,1,1,1,0
5674,,,JimTragos,0,1,1,0,1,1,0,0,1,1,1,0
5675,,,RedeSetTweet,0,1,1,0,1,1,0,0,1,1,1,0
5676,,,yuzuchuuu,0,2,2,0,2,2,0,0,1,1,1,0
5677,,,WAndyKnight1,5,1,6,5,1,6,0.2,0.054401,0,0,0,0
5678,,,Mark738eis,0,2,2,0,2,2,0,0,1,1,1,0
5679,,,Farbetteer,0,1,1,0,1,1,0,0,1,1,1,0
5680,,,SkyHawk56v8,0,2,2,0,2,2,0,0,1,1,1,0
5681,,,nebulaeeeee,0,2,2,0,2,2,0,0,2,0.75,0.833333,0
5682,,,suho_bunny_jm,0,1,1,0,1,1,0,0,1,1,1,0
5683,,,BengalsBabyYoda,7,1,8,8,1,9,0.142857,0.060787,0,0,0,0
5684,,,FakePols,0,1,1,0,2,2,0,0,1,1,1,0
5685,,,an6elinaaa,0,1,1,0,1,1,0,0,1,1,1,0
5686,,,YunkiShadow12,0,1,1,0,1,1,0,0,1,1,1,0
5687,,,anii19987,0,1,1,0,1,1,0,0,1,1,1,0
5688,,,brstock,0,1,1,0,1,1,0,0,1,1,1,0
5689,,,Saintsfan5348,0,1,1,0,1,1,0,0,1,1,1,0
5690,,,alttkoyaa,0,2,2,0,2,2,0,0,1,1,1,0
5691,,,KomokaStarfish,0,1,1,0,1,1,0,0,1,1,1,0
5692,,,micklovesmick,11,1,12,13,3,16,0.090909,0.073559,0,0,0,0
5693,,,_Louis_Duong,0,1,1,0,1,1,0,0,1,1,1,0
5694,,,OdaTaketa,0,1,1,0,1,1,0,0,1,1,1,0
5695,,,TakeDownCCP_,0,1,1,0,1,1,0,0,1,1,1,0
5696,,,Tough2Shake,0,1,1,0,1,1,0,0,2,0.6,0.666667,0
5697,,,tammivmp,0,1,1,0,1,1,0,0,1,1,1,0
5698,,,DaisyTheGrey,3,1,4,3,1,4,0.333333,0.020061,0,0,0,0
5699,,,scarasluttt,0,1,1,0,1,1,0,0,1,1,1,0
5700,,,nerysinchina,0,1,1,0,1,1,0,0,1,1,1,0
5701,,,inumakiluvrr,3,1,4,3,1,4,0.333333,0.020061,0,0,0,0
5702,,,mingipinky03,0,1,1,0,1,1,0,0,1,1,1,0
5703,,,amoobrasil,0,1,1,0,1,1,0,0,1,1,1,0
5704,,,d732928,0,1,1,0,1,1,0,0,1,1,1,0
5705,,,AlolanSnowy,0,2,2,0,2,2,0,0,1,1,1,0
5706,,,hBAHroX4b7Pt5Nz,0,1,1,0,1,1,0,0,1,1,1,0
5707,,,ashleyshoo,0,1,1,0,1,1,0,0,2,0.6,0.666667,0
5708,,,ozantm,1,1,2,1,1,2,0,0.006687,0,0,0,0
5709,,,lasagna4short,6,1,7,7,2,9,0.166667,0.040123,0,0,0,0
5710,,,Joyce31205671,0,1,1,0,1,1,0,0,1,1,1,0
5711,,,Deacon_0107,0,1,1,0,1,1,0,0,1,1,1,0
5712,,,TynnaDemellier,0,1,1,0,1,1,0,0,1,1,1,0
5713,,,AnotherMeiko,0,1,1,0,1,1,0,0,1,1,1,0
5714,,,Doehawk1993,0,1,1,0,1,1,0,0,1,1,1,0
5715,,,KimZicafoose,1,1,2,1,1,2,0,0.006687,0,0,0,0
5716,,,IVEsoob,2,1,3,2,1,3,0.5,0.013374,0,0,0,0
5717,,,surfbro26,0,1,1,0,1,1,0,0,1,1,1,0
5718,,,evelynfabis64,0,1,1,0,1,1,0,0,2,0.666667,0.75,0
5719,,,BllBriss,0,1,1,0,1,1,0,0,2,0.666667,0.75,0
5720,,,___mogwai___,0,3,3,0,3,3,0,0,2,0.8,0.875,0
5721,,,ShannonDowney,0,1,1,0,1,1,0,0,2,0.666667,0.75,0
5722,,,d6Oj2I4YMvwsne5,0,1,1,0,1,1,0,0,2,0.666667,0.75,0
5723,,,Trips50058709,0,1,1,0,1,1,0,0,1,1,1,0
5724,,,rebellegrrl,0,1,1,0,1,1,0,0,1,1,1,0
5725,,,Sapphire1294,6,1,7,6,1,7,0.166667,0.040123,0,0,0,0
5726,,,cheonsajmn,0,1,1,0,1,1,0,0,1,1,1,0
5727,,,dearkillua,0,1,1,0,1,1,0,0,1,1,1,0
5728,,,LarryWoods16,0,1,1,0,1,1,0,0,1,1,1,0
5729,,,cranevl,0,1,1,0,1,1,0,0,1,1,1,0
5730,,,kaelspears,0,2,2,0,2,2,0,0,1,1,1,0
5731,,,hummingsylph,0,1,1,0,1,1,0,0,1,1,1,0
5732,,,stephmassengill,0,1,1,0,1,1,0,0,1,1,1,0
5733,,,shebaaaaaaaaA,0,1,1,0,1,1,0,0,1,1,1,0
5734,,,JJSedonaross,0,2,2,0,2,2,0,0,1,1,1,0
5735,,,baylegabriella,0,1,1,0,1,1,0,0,1,1,1,0
5736,,,TsengJennifer,1,1,2,1,1,2,0,0.006687,0,0,0,0
5737,,,loudrthqnbombs,22,1,23,23,1,24,0.045455,0.157239,0,0,0,0
5738,,,ethicallslut,0,1,1,0,1,1,0,0,1,1,1,0
5739,,,jixouves,0,1,1,0,1,1,0,0,1,1,1,0
5740,,,BloodworthCare,0,1,1,0,1,1,0,0,1,1,1,0
5741,,,FeliceLHarwood,0,1,1,0,1,1,0,0,1,1,1,0
5742,,,lovely1boot,0,1,1,0,1,1,0,0,1,1,1,0
5743,,,chooch0188,0,1,1,0,1,1,0,0,1,1,1,0
5744,,,ltyisjaehyuns,0,2,2,0,2,2,0,0,3,0.5,0.595238,0
5745,,,sweetyuzu,3,1,4,3,1,4,0,0.018121,1,1,1,6
5746,,,HeadlineZooo,0,1,1,0,2,2,0,0,1,1,1,0
5747,,,huihuilin77,0,1,1,0,1,1,0,0,1,1,1,0
5748,,,DonMaryEllen1,0,1,1,0,1,1,0,0,1,1,1,0
5749,,,ChenniYou,0,1,1,0,1,1,0,0,1,1,1,0
5750,,,questiss121,0,2,2,0,2,2,0,0,1,1,1,0
5751,,,xx_haro_xx,0,1,1,0,1,1,0,0,1,1,1,0
5752,,,kamemarunaja,0,2,2,0,2,2,0,0,2,0.75,0.833333,0
5753,,,joni_theobald,2,1,3,2,1,3,0.5,0.013374,0,0,0,0
5754,,,cloudberria_,0,1,1,0,1,1,0,0,1,1,1,0
5755,,,freudianslipups,1,1,2,1,1,2,0,0.006687,0,0,0,0
5756,,,AndreaJaeger9,6,1,7,6,1,7,0.166667,0.040123,0,0,0,0
5757,,,5h09un,0,1,1,0,1,1,0,0,1,1,1,0
5758,,,Wang_Yilisha,0,2,2,0,2,2,0,0,1,1,1,0
5759,,,metaspinster,0,1,1,0,1,1,0,0,1,1,1,0
5760,,,vanjaluna1,0,1,1,0,1,1,0,0,1,1,1,0
5761,,,DianaGeraghty,2,1,3,2,1,3,0.5,0.013374,0,0,0,0
5762,,,sjohn866,0,2,2,0,2,2,0,0,1,1,1,0
5763,,,saltybuttcombo,2,1,3,2,1,3,0.5,0.013374,0,0,0,0
5764,,,yasmineiliana,5,1,6,5,1,6,0.2,0.033436,0,0,0,0
5765,,,ShiGeBianTai,0,2,2,0,2,2,0,0,1,1,1,0
5766,,,AngelJeonghan4,0,2,2,0,2,2,0,0,2,0.75,0.833333,0
5767,,,burberry_yuzu,0,1,1,0,1,1,0,0,1,1,1,0
5768,,,Itasanders,0,1,1,0,1,1,0,0,1,1,1,0
5769,,,flying_potato3,14,1,15,16,1,17,0.071429,0.09362,0,0,0,0
5770,,,Patricia112451,0,1,1,0,2,2,0,0,1,1,1,0
5771,,,XiaopengPark,0,1,1,0,1,1,0,0,1,1,1,0
5772,,,L_Javier_Puga,0,1,1,0,1,1,0,0,1,1,1,0
5773,,,Yuzubijj,0,3,3,0,3,3,0,0,1,1,1,0
5774,,,penagin0129,0,4,4,0,7,7,0,0,1,1,1,0
5775,,,mommasay1,0,1,1,0,1,1,0,0,1,1,1,0
5776,,,huggingChoso,0,1,1,0,1,1,0,0,1,1,1,0
5777,,,dcgatl,0,1,1,0,1,1,0,0,1,1,1,0
5778,,,BrianWongOPR,0,1,1,0,1,1,0,0,1,1,1,0
5779,,,ideas_inkwell,0,1,1,0,1,1,0,0,1,1,1,0
5780,,,ETmBQP4y2rYALkW,0,4,4,0,4,4,0,0,1,1,1,0
5781,,,llayyxd,0,1,1,0,1,1,0,0,1,1,1,0
5782,,,NancyMugele,5,1,6,5,1,6,0.2,0.052714,0,0,0,0
5783,,,done_with_fs,5,3,8,6,4,10,0.142857,0.040424,1,1,1,10
5784,,,SQHPROTECTOR,0,2,2,0,2,2,0,0,1,1,1,0
5785,,,jams_loves_,0,2,2,0,2,2,0,0,1,1,1,0
5786,,,Jaceofspades171,2,1,3,2,1,3,0.5,0.013374,0,0,0,0
5787,,,xingqiust,4,2,6,4,2,6,0.2,0.026749,1,1,1,3
5788,,,Margaret_ADuffy,0,1,1,0,1,1,0,0,1,1,1,0
5789,,,marckeepper,0,1,1,0,1,1,0,0,1,1,1,0
5790,,,BrendaBurricht1,0,1,1,0,1,1,0,0,1,1,1,0
5791,,,xxxTtimexxx,0,1,1,0,1,1,0,0,1,1,1,0
5792,,,evgenesis_,0,1,1,0,1,1,0,0,1,1,1,0
5793,,,RoomeSoph,0,3,3,0,3,3,0,0,1,1,1,0
5794,,,yinhew1,2,1,3,2,1,3,0.5,0.013374,0,0,0,0
5795,,,fishytao,0,1,1,0,1,1,0,0,1,1,1,0
5796,,,DeborahNeo,2,1,3,2,1,3,0.5,0.013374,0,0,0,0
5797,,,vircar2,0,1,1,0,1,1,0,0,1,1,1,0
5798,,,Annalis06431060,0,1,1,0,1,1,0,0,1,1,1,0
5799,,,bcsalvador,6,3,9,7,3,10,0.125,0.040123,1,1,1,10
5800,,,sjfankellyanne,0,1,1,0,1,1,0,0,1,1,1,0
5801,,,Tyrone0711,0,1,1,0,1,1,0,0,1,1,1,0
5802,,,cooky_tklove,1,1,2,1,1,2,0,0.006687,0,0,0,0
5803,,,LiaShiekh,0,1,1,0,1,1,0,0,2,0.6,0.666667,0
5804,,,MaryDil29664033,0,1,1,0,1,1,0,0,2,0.6,0.666667,0
5805,,,pookoo_2000,0,1,1,0,2,2,0,0,2,0.6,0.666667,0
5806,,,annetignon,0,1,1,0,1,1,0,0,2,0.6,0.666667,0
5807,,,jiwoolix,7,1,8,7,1,8,0.142857,0.04681,0,0,0,0
5808,,,NE__Adfifty,0,1,1,0,1,1,0,0,1,1,1,0
5809,,,YvetteMerial,0,1,1,0,1,1,0,0,1,1,1,0
5810,,,dorothystella7,0,2,2,0,2,2,0,0,1,1,1,0
5811,,,samjunipero,7,1,8,8,1,9,0.142857,0.04681,0,0,0,0
5812,,,zhansosmioo,0,1,1,0,1,1,0,0,1,1,1,0
5813,,,ByerlyErin,0,1,1,0,1,1,0,0,1,1,1,0
5814,,,dmcwriter,0,1,1,0,2,2,0,0,1,1,1,0
5815,,,VinnieFerri,0,1,1,0,1,1,0,0,1,1,1,0
5816,,,Mae_xyn,0,1,1,0,1,1,0,0,1,1,1,0
5817,,,nerdsforyang,4,1,5,5,2,7,0.25,0.026749,0,0,0,0
5818,,,Trusogirlboss,10,1,11,10,1,11,0.1,0.066871,0,0,0,0
5819,,,NevaresLinda,0,1,1,0,1,1,0,0,1,1,1,0
5820,,,SarcasmvsHumor,0,1,1,0,1,1,0,0,1,1,1,0
5821,,,jesusiturrald10,0,1,1,0,1,1,0,0,1,1,1,0
5822,,,ubervaper,0,1,1,0,1,1,0,0,1,1,1,0
5823,,,LA_homstad,0,1,1,0,1,1,0,0,1,1,1,0
5824,,,JulieNelson58,0,1,1,0,1,1,0,0,1,1,1,0
5825,,,KyoongAeint,0,1,1,0,1,1,0,0,1,1,1,0
5826,,,chimnayeon,0,1,1,0,1,1,0,0,1,1,1,0
5827,,,piperhudsburn,5,1,6,5,1,6,0.2,0.033436,0,0,0,0
5828,,,JessieL08310703,0,1,1,0,1,1,0,0,1,1,1,0
5829,,,05Phatty,0,1,1,0,1,1,0,0,1,1,1,0
5830,,,ritaloooc69,0,1,1,0,1,1,0,0,1,1,1,0
5831,,,catspecter,0,1,1,0,1,1,0,0,1,1,1,0
5832,,,megmaggio88,6,1,7,6,1,7,0.166667,0.047111,0,0,0,0
5833,,,suptmoran,0,2,2,0,2,2,0,0,2,0.75,0.833333,0
5834,,,LoveNOLA4ever,0,1,1,0,1,1,0,0,1,1,1,0
5835,,,inthenameofarmy,0,1,1,0,1,1,0,0,1,1,1,0
5836,,,hanyuzuonice,0,1,1,0,1,1,0,0,1,1,1,0
5837,,,2CrestedLizard,5,1,6,5,1,6,0.2,0.033436,0,0,0,0
5838,,,sailorgirl4life,0,1,1,0,1,1,0,0,1,1,1,0
5839,,,sleepystarslumi,0,1,1,0,1,1,0,0,1,1,1,0
5840,,,HeatherThomasAF,0,1,1,0,1,1,0,0,1,1,1,0
5841,,,corypuga,0,1,1,0,1,1,0,0,1,1,1,0
5842,,,WenzCheng,8,2,10,8,2,10,0.111111,0.070968,1,1,1,10
5843,,,mynameisBethS,0,1,1,0,1,1,0,0,2,0.666667,0.75,0
5844,,,Christo36841352,0,2,2,0,2,2,0,0,2,0.666667,0.75,0
5845,,,lshishani1,0,1,1,0,1,1,0,0,2,0.666667,0.75,0
5846,,,ajgets1,0,1,1,0,1,1,0,0,2,0.666667,0.75,0
5847,,,HayatAlvi,2,1,3,2,1,3,0.5,0.013374,0,0,0,0
5848,,,nidula_b,0,1,1,0,1,1,0,0,1,1,1,0
5849,,,UhhhFelix,5,1,6,5,1,6,0.2,0.03693,0,0,0,0
5850,,,pegsuepensacola,0,1,1,0,1,1,0,0,1,1,1,0
5851,,,realmcc1,0,1,1,0,1,1,0,0,1,1,1,0
5852,,,Andrea_51544005,0,1,1,0,1,1,0,0,1,1,1,0
5853,,,theeeasternsun,1,2,3,1,2,3,0.5,0.006687,1,1,1,0
5854,,,MoJoviSPN,2,1,3,2,1,3,0.5,0.013374,0,0,0,0
5855,,,goyu4u,0,3,3,0,3,3,0,0,2,0.666667,0.75,0
5856,,,KotakeSteven,6,1,7,6,1,7,0.166667,0.040123,0,0,0,0
5857,,,ladyzhazarr,0,1,1,0,1,1,0,0,1,1,1,0
5858,,,Vladimi33598314,0,1,1,0,1,1,0,0,1,1,1,0
5859,,,BrightWinCat,0,2,2,0,2,2,0,0,1,1,1,0
5860,,,acr_vy0,0,1,1,0,1,1,0,0,1,1,1,0
5861,,,marjowil5775,0,1,1,0,1,1,0,0,1,1,1,0
5862,,,drumr54,5,1,6,5,1,6,0.2,0.033436,0,0,0,0
5863,,,CSchiesari,0,1,1,0,1,1,0,0,1,1,1,0
5864,,,aramisotelo,0,2,2,0,2,2,0,0,1,1,1,0
5865,,,LNR913,0,2,2,0,2,2,0,0,1,1,1,0
5866,,,lukaswish,0,1,1,0,1,1,0,0,1,1,1,0
5867,,,pppiiip,0,1,1,0,1,1,0,0,1,1,1,0
5868,,,11AliveNews,11,1,12,11,1,12,0.090909,0.073559,0,0,0,0
5869,,,pianoma41148362,0,1,1,0,1,1,0,0,1,1,1,0
5870,,,paulybriana,0,1,1,0,1,1,0,0,1,1,1,0
5871,,,Sylvia_nc,0,1,1,0,1,1,0,0,1,1,1,0
5872,,,QueenieEsther6,0,3,3,0,3,3,0,0,1,1,1,0
5873,,,AndrewBinkley2,0,2,2,0,2,2,0,0,1,1,1,0
5874,,,noinluv,0,1,1,0,1,1,0,0,1,1,1,0
5875,,,Iumiharem,0,1,1,0,1,1,0,0,1,1,1,0
5876,,,dvieriu,0,1,1,0,1,1,0,0,1,1,1,0
5877,,,ivinsvip,0,5,5,0,5,5,0,0,2,0.777778,0.857143,0
5878,,,cuntysanas,10,1,11,10,1,11,0.1,0.066871,0,0,0,0
5879,,,dapherneener,0,1,1,0,1,1,0,0,1,1,1,0
5880,,,AshtenSmith12,0,1,1,0,1,1,0,0,1,1,1,0
5881,,,KathyHebditch,0,1,1,0,1,1,0,0,1,1,1,0
5882,,,y2knju,0,1,1,0,1,1,0,0,1,1,1,0
5883,,,chrisinfdl,0,1,1,0,1,1,0,0,1,1,1,0
5884,,,In_Yujin,0,2,2,0,2,2,0,0,1,1,1,0
5885,,,FAlRYUZU,0,2,2,0,2,2,0,0,1,1,1,0
5886,,,leanmacc2022,0,1,1,0,1,1,0,0,1,1,1,0
5887,,,bielmenthusiast,0,8,8,0,8,8,0.035714,0,2,0.785714,0.863636,0
5888,,,NightEmperious,7,1,8,7,1,8,0.142857,0.04681,0,0,0,0
5889,,,ShuraSnake,0,1,1,0,1,1,0,0,1,1,1,0
5890,,,jcarlosroguz,0,1,1,0,1,1,0,0,1,1,1,0
5891,,,Aqeesya1122L,0,1,1,0,1,1,0,0,1,1,1,0
5892,,,mhroseman,0,1,1,0,1,1,0,0,1,1,1,0
5893,,,KenSoroka,0,1,1,0,1,1,0,0,1,1,1,0
5894,,,plaintruthiness,2,1,3,2,1,3,0.5,0.013374,0,0,0,0
5895,,,speedy_hen,0,1,1,0,1,1,0,0,1,1,1,0
5896,,,VictoriaDeG1M,1,1,2,1,1,2,0,0.006687,0,0,0,0
5897,,,CNNInternatDesk,1,1,2,1,1,2,0,0.006687,0,0,0,0
5898,,,maynardisold,14,1,15,15,1,16,0.071429,0.110324,0,0,0,0
5899,,,StewartTVNews,0,1,1,0,1,1,0,0,1,1,1,0
5900,,,kathlee73732050,0,1,1,0,1,1,0,0,1,1,1,0
5901,,,pixie725,0,1,1,0,1,1,0,0,1,1,1,0
5902,,,MarcyPrince8,0,1,1,0,1,1,0,0,1,1,1,0
5903,,,beckola01,0,1,1,0,2,2,0,0,1,1,1,0
5904,,,Rikas_3A,0,1,1,0,1,1,0,0,1,1,1,0
5905,,,chom1827,0,2,2,0,2,2,0,0,1,1,1,0
5906,,,MarieAnn4One,0,1,1,0,1,1,0,0,1,1,1,0
5907,,,JRChantengco,0,1,1,0,1,1,0,0,1,1,1,0
5908,,,helenmag,0,1,1,0,1,1,0,0,1,1,1,0
5909,,,TheNatorade,9,1,10,11,1,12,0.111111,0.060184,0,0,0,0
5910,,,jordanajemison,0,24,24,0,62,62,0,0,3,0.626667,0.737589,0
5911,,,Bluegirl2700,0,1,1,0,1,1,0,0,1,1,1,0
5912,,,3sal3loop,0,2,2,0,2,2,0,0,1,1,1,0
5913,,,hplem,0,1,1,0,1,1,0,0,1,1,1,0
5914,,,_AmandaR__,0,2,2,0,2,2,0,0,2,0.75,0.833333,0
5915,,,chu_chul,0,1,1,0,1,1,0,0,1,1,1,0
5916,,,bjm398,8,1,9,9,1,10,0.125,0.053497,0,0,0,0
5917,,,wj93224929,0,1,1,0,1,1,0,0,1,1,1,0
5918,,,toplop_black,0,1,1,0,1,1,0,0,1,1,1,0
5919,,,LoriBKohn,0,1,1,0,2,2,0,0,1,1,1,0
5920,,,Sunnytwotethat,0,1,1,0,1,1,0,0,1,1,1,0
5921,,,eats_patty,0,1,1,0,1,1,0,0,1,1,1,0
5922,,,kevinCanWait9,0,2,2,0,2,2,0,0,1,1,1,0
5923,,,deesbarbara,6,1,7,7,2,9,0.166667,0.040123,0,0,0,0
5924,,,ItWasACoup,0,1,1,0,1,1,0,0,1,1,1,0
5925,,,Vvlvl_,0,2,2,0,2,2,0,0,1,1,1,0
5926,,,rushambuzabless,0,1,1,0,1,1,0,0,1,1,1,0
5927,,,wmzhang2008,0,1,1,0,1,1,0,0,1,1,1,0
5928,,,radiantgirl,0,2,2,0,2,2,0,0,1,1,1,0
5929,,,amyfanale,12,1,13,14,2,16,0.083333,0.087234,0,0,0,0
5930,,,UzielSeraphus,0,1,1,0,1,1,0,0,1,1,1,0
5931,,,hzeprpl,1,1,2,1,1,2,0,0.006687,0,0,0,0
5932,,,ChouIp,0,1,1,0,1,1,0,0,3,0.5,0.525641,0
5933,,,notiflorida,0,1,1,0,1,1,0,0,3,0.5,0.525641,0
5934,,,PatrickKerin1,0,1,1,0,1,1,0,0,3,0.5,0.525641,0
5935,,,ShengX_Gu,0,1,1,0,1,1,0,0,3,0.5,0.525641,0
5936,,,BowiesNana,0,1,1,0,1,1,0,0,3,0.5,0.525641,0
5937,,,Phoozba1,0,1,1,0,1,1,0,0,3,0.5,0.525641,0
5938,,,CBSNews,3,1,4,3,1,4,0.333333,0.020061,0,0,0,0
5939,,,linda91711,0,1,1,0,1,1,0,0,1,1,1,0
5940,,,Tatessharp,0,1,1,0,1,1,0,0,1,1,1,0
5941,,,myamacka,0,1,1,0,1,1,0,0,1,1,1,0
5942,,,redboybroken,0,1,1,0,1,1,0,0,1,1,1,0
5943,,,Beijo11,0,1,1,0,1,1,0,0,1,1,1,0
5944,,,MJedlicka,0,1,1,0,1,1,0,0,1,1,1,0
5945,,,corsalick,0,2,2,0,2,2,0,0,1,1,1,0
5946,,,Christi56528529,4,1,5,4,1,5,0.25,0.040725,0,0,0,0
5947,,,purrmonsta,0,1,1,0,1,1,0,0,1,1,1,0
5948,,,shelbyman350,0,1,1,0,1,1,0,0,1,1,1,0
5949,,,MakeARainPinbal,2,1,3,2,1,3,0.5,0.013374,0,0,0,0
5950,,,YepDemocracy,0,1,1,0,1,1,0,0,1,1,1,0
5951,,,VictorY_Wong,4,1,5,4,1,5,0.25,0.026749,0,0,0,0
5952,,,Crushian_Reborn,0,1,1,0,1,1,0,0,1,1,1,0
5953,,,SoneBlink_,0,3,3,0,3,3,0,0,2,0.8,0.875,0
5954,,,lapham923,0,2,2,0,2,2,0,0,1,1,1,0
5955,,,carylgronwall,12,1,13,13,2,15,0.083333,0.090728,0,0,0,0
5956,,,ByamugishaChri8,0,1,1,0,1,1,0,0,1,1,1,0
5957,,,myfavyuta,0,1,1,0,1,1,0,0,1,1,1,0
5958,,,mariada17318379,0,1,1,0,1,1,0,0,1,1,1,0
5959,,,gabieefairy,0,1,1,0,1,1,0,0,1,1,1,0
5960,,,littlefrog661,0,1,1,0,1,1,0,0,1,1,1,0
5961,,,Hollaworldwide,0,2,2,0,2,2,0,0,6,0.366667,0.437121,0
5962,,,marykueppers,4,1,5,5,2,7,0.25,0.026749,0,0,0,0
5963,,,AAdamari2001,0,1,1,0,1,1,0,0,1,1,1,0
5964,,,Wolvie6797,0,1,1,0,1,1,0,0,1,1,1,0
5965,,,namud1mples,0,1,1,0,1,1,0,0,1,1,1,0
5966,,,EXYPROTECT,3,1,4,3,1,4,0.333333,0.020061,0,0,0,0
5967,,,RickDunwoodie,0,2,2,0,2,2,0,0,1,1,1,0
5968,,,MurikSam,0,1,1,0,1,1,0,0,1,1,1,0
5969,,,NatureStephanie,5,1,6,5,1,6,0.2,0.033436,0,0,0,0
5970,,,doktorgrlfriend,0,1,1,0,1,1,0,0,1,1,1,0
5971,,,mrsrptrs,0,2,2,0,2,2,0,0,1,1,1,0
5972,,,MintyBabee,0,1,1,0,1,1,0,0,1,1,1,0
5973,,,no2hitting,0,1,1,0,1,1,0,0,1,1,1,0
5974,,,thebreadlord,3,1,4,3,1,4,0.333333,0.058498,0,0,0,0
5975,,,xIce_Baby,11,3,14,11,3,14,0.076923,0.073559,1,1,1,20
5976,,,ReadyToRelax,0,1,1,0,1,1,0,0,1,1,1,0
5977,,,voices4hillary,9,1,10,9,1,10,0.111111,0.060184,0,0,0,0
5978,,,weepelt,0,2,2,0,2,2,0,0,2,0.571429,0.625,0
5979,,,QuicheMolle,0,1,1,0,1,1,0,0,1,1,1,0
5980,,,tricia1250,0,1,1,0,1,1,0,0,1,1,1,0
5981,,,sunrunner11,0,1,1,0,1,1,0,0,1,1,1,0
5982,,,notrluca,0,2,2,0,2,2,0,0,2,0.625,0.7,0
5983,,,tchrisyank,0,2,2,0,2,2,0,0,1,1,1,0
5984,,,yourmom_chan,0,1,1,0,1,1,0,0,1,1,1,0
5985,,,_caatjoy,6,1,7,6,1,7,0.166667,0.040123,0,0,0,0
5986,,,gmann1970,0,2,2,0,2,2,0,0,1,1,1,0
5987,,,RealDaniHensley,0,1,1,0,1,1,0,0,1,1,1,0
5988,,,evertvankuijk,0,1,1,0,1,1,0,0,1,1,1,0
5989,,,Bound2021,0,1,1,0,1,1,0,0,1,1,1,0
5990,,,notComey,1,1,2,2,2,4,0,0.006687,0,0,0,0
5991,,,nathanwcurls,5,1,6,5,1,6,0.2,0.116632,0,0,0,0
5992,,,PimMaiden,0,1,1,0,1,1,0,0,1,1,1,0
5993,,,avoid_mars,0,1,1,0,1,1,0,0,1,1,1,0
5994,,,hihizeun,0,2,2,0,2,2,0,0,1,1,1,0
5995,,,CarolineMv13,4,1,5,4,1,5,0.25,0.026749,0,0,0,0
5996,,,Anthonyvaxxed,0,1,1,0,1,1,0,0,1,1,1,0
5997,,,CharlotteOnder1,0,2,2,0,2,2,0,0,1,1,1,0
5998,,,cnni,9,1,10,13,5,18,0.111111,0.075695,0,0,0,0
5999,,,blevisimo,0,1,1,0,1,1,0,0,1,1,1,0
6000,,,JerrylCom,10,1,11,11,1,12,0.1,0.078258,0,0,0,0
6001,,,stimm2462,0,1,1,0,2,2,0,0,1,1,1,0
6002,,,alli_cat1401,0,1,1,0,1,1,0,0,1,1,1,0
6003,,,Jeffsix11,0,1,1,0,1,1,0,0,1,1,1,0
6004,,,hippiechickcath,0,1,1,0,1,1,0,0,1,1,1,0
6005,,,DAKearns,0,1,1,0,1,1,0,0,1,1,1,0
6006,,,ihrtyuzu,0,1,1,0,1,1,0,0,1,1,1,0
6007,,,WorldTravelDiva,0,1,1,0,1,1,0,0,1,1,1,0
6008,,,mhp_1776,0,1,1,0,1,1,0,0,1,1,1,0
6009,,,RobertPaul1,1,1,2,1,1,2,0,0.006687,0,0,0,0
6010,,,ZackeryDaley,3,1,4,3,1,4,0.333333,0.020061,0,0,0,0
6011,,,paulamc45,0,1,1,0,1,1,0,0,1,1,1,0
6012,,,kegan1492,0,1,1,0,1,1,0,0,1,1,1,0
6013,,,RheemTyler,1,1,2,1,1,2,0,0.006687,0,0,0,0
6014,,,KelseyEsterline,2,1,3,2,1,3,0.5,0.013374,0,0,0,0
6015,,,jonfollett,0,1,1,0,1,1,0,0,1,1,1,0
6016,,,jalopezmaymi,1,1,2,1,1,2,0,0.006687,0,0,0,0
6017,,,noxignature,2,1,3,2,1,3,0.5,0.013374,0,0,0,0
6018,,,BlueView802,0,1,1,0,1,1,0,0,1,1,1,0
6019,,,mdrich,4,1,5,4,1,5,0.25,0.026749,0,0,0,0
6020,,,Wenican,0,1,1,0,1,1,0,0,1,1,1,0
6021,,,Meidas_Damon,0,1,1,0,1,1,0,0,1,1,1,0
6022,,,NancyLeclerc9,0,2,2,0,2,2,0,0,1,1,1,0
6023,,,xxihateinstagr1,0,1,1,0,1,1,0,0,1,1,1,0
6024,,,ADagostinoTV,3,1,4,3,1,4,0.333333,0.020061,0,0,0,0
6025,,,MegMcCalhoun,0,1,1,0,1,1,0,0,1,1,1,0
6026,,,pmharland1066,0,2,2,0,2,2,0,0,1,1,1,0
6027,,,vhsfilmz,3,1,4,3,1,4,0.333333,0.020061,0,0,0,0
6028,,,Ilikedemocracy2,0,1,1,0,1,1,0,0,1,1,1,0
6029,,,Siadasha,0,1,1,0,1,1,0,0,1,1,1,0
6030,,,sam63b,0,1,1,0,1,1,0,0,1,1,1,0
6031,,,DLo5705,0,1,1,0,1,1,0,0,1,1,1,0
6032,,,policylady,0,1,1,0,1,1,0,0,1,1,1,0
6033,,,sydieboy,10,1,11,10,1,11,0.1,0.066871,0,0,0,0
6034,,,ajcruz14th_aj,0,1,1,0,1,1,0,0,1,1,1,0
6035,,,dpoignon,0,1,1,0,1,1,0,0,1,1,1,0
6036,,,fwdcrocblu,0,1,1,0,1,1,0,0,1,1,1,0
6037,,,Monnica888,0,1,1,0,1,1,0,0,1,1,1,0
6038,,,bowes1911,0,1,1,0,1,1,0,0,1,1,1,0
6039,,,frances_price,0,1,1,0,1,1,0,0,1,1,1,0
6040,,,NielsenTeresa,0,1,1,0,1,1,0,0,1,1,1,0
6041,,,kopite_girl,0,1,1,0,1,1,0,0,1,1,1,0
6042,,,gend3rfuck,2,1,3,2,1,3,0.5,0.013374,0,0,0,0
6043,,,JaneKer15585589,0,1,1,0,1,1,0,0,1,1,1,0
6044,,,ApreaDanielle,1,1,2,1,1,2,0,0.006687,0,0,0,0
6045,,,Jason1Giles,1,1,2,1,1,2,0,0.006687,0,0,0,0
6046,,,eycsfca,1,1,2,1,1,2,0,0.006687,0,0,0,0
6047,,,femalehedonism,0,1,1,0,1,1,0,0,1,1,1,0
6048,,,atlandco,3,1,4,3,1,4,0.333333,0.020061,0,0,0,0
6049,,,VickiMo08056436,0,2,2,0,2,2,0,0,1,1,1,0
6050,,,Lynn_Colorado,0,1,1,0,1,1,0,0,1,1,1,0
6051,,,hazydav,5,1,6,5,1,6,0.2,0.033436,0,0,0,0
6052,,,hyjville,0,1,1,0,1,1,0,0,1,1,1,0
6053,,,sfhelmut,0,1,1,0,1,1,0,0,1,1,1,0
6054,,,nannieboo,0,1,1,0,1,1,0,0,1,1,1,0
6055,,,QueensIceZ,15,1,16,17,2,19,0.066667,0.100307,0,0,0,0
6056,,,CjReilly5,0,1,1,0,1,1,0,0,1,1,1,0
6057,,,manostorgo,0,1,1,0,1,1,0,0,1,1,1,0
6058,,,Pete19869423,0,1,1,0,1,1,0,0,1,1,1,0
6059,,,xcariati,0,1,1,0,1,1,0,0,1,1,1,0
6060,,,daddykool,0,1,1,0,1,1,0,0,1,1,1,0
6061,,,Fideli7a,0,1,1,0,2,2,0,0,1,1,1,0
6062,,,mhiatt11,0,1,1,0,1,1,0,0,1,1,1,0
6063,,,TrueBluPatriot,0,1,1,0,1,1,0,0,1,1,1,0
6064,,,Ilikefs1,0,4,4,0,4,4,0,0,1,1,1,0
6065,,,brit670,0,1,1,0,1,1,0,0,1,1,1,0
6066,,,kaacire31,8,1,9,8,1,9,0.125,0.061679,0,0,0,0
6067,,,gndvm,0,1,1,0,1,1,0,0,1,1,1,0
6068,,,bangtanvillea,0,1,1,0,1,1,0,0,1,1,1,0
6069,,,jddchicago,0,1,1,0,1,1,0,0,1,1,1,0
6070,,,jewelofchicago,0,1,1,0,1,1,0,0,1,1,1,0
6071,,,TerriOConnell55,0,1,1,0,1,1,0,0,1,1,1,0
6072,,,blackgimbap,0,1,1,0,1,1,0,0,1,1,1,0
6073,,,SuperJediPanda,0,1,1,0,1,1,0,0,1,1,1,0
6074,,,maria_jl06,1,1,2,1,1,2,0,0.006687,0,0,0,0
6075,,,sunnyspot2021,4,1,5,4,1,5,0.25,0.026749,0,0,0,0
6076,,,K8TDidToo,0,1,1,0,1,1,0,0,1,1,1,0
6077,,,AndersonCheri,0,1,1,0,1,1,0,0,1,1,1,0
6078,,,MMMTheBoss1,0,1,1,0,1,1,0,0,1,1,1,0
6079,,,Pseawabear,7,1,8,7,1,8,0.142857,0.04681,0,0,0,0
6080,,,WegmanWilrijk,0,1,1,0,1,1,0,0,1,1,1,0
6081,,,MartinMares6,0,1,1,0,1,1,0,0,1,1,1,0
6082,,,BowmanNancy,0,1,1,0,1,1,0,0,1,1,1,0
6083,,,anthonybwilson,0,1,1,0,1,1,0,0,1,1,1,0
6084,,,ChrisRi80029765,0,1,1,0,1,1,0,0,1,1,1,0
6085,,,509ShawnG,1,1,2,1,1,2,0,0.006687,0,0,0,0
6086,,,ncthue,5,1,6,6,2,8,0.2,0.033436,0,0,0,0
6087,,,Taricky10,0,2,2,0,2,2,0,0,1,1,1,0
6088,,,rebabh,0,1,1,0,1,1,0,0,1,1,1,0
6089,,,jp83376372,0,1,1,0,1,1,0,0,1,1,1,0
6090,,,Claireglide,0,1,1,0,1,1,0,0,1,1,1,0
6091,,,Nizukodemon,6,1,7,10,1,11,0.166667,0.040123,0,0,0,0
6092,,,malibu_sands,0,1,1,0,1,1,0,0,1,1,1,0
6093,,,KarenAxell,0,1,1,0,1,1,0,0,1,1,1,0
6094,,,shirleychcn,0,2,2,0,2,2,0,0,1,1,1,0
6095,,,krisphilli57,8,1,9,11,1,12,0.125,0.053497,0,0,0,0
6096,,,dasuki_21257,0,1,1,0,1,1,0,0,1,1,1,0
6097,,,mp152427,0,1,1,0,1,1,0,0,1,1,1,0
6098,,,slpage63,0,2,2,0,2,2,0,0,1,1,1,0
6099,,,mehaas50,0,1,1,0,1,1,0,0,1,1,1,0
6100,,,GadiNBC,0,1,1,0,1,1,0,0,1,1,1,0
6101,,,amdavis1218,0,1,1,0,1,1,0,0,1,1,1,0
6102,,,GZutsi,1,1,2,1,1,2,0,0.006687,0,0,0,0
6103,,,KatrinaBilling3,1,1,2,1,1,2,0,0.006687,0,0,0,0
6104,,,Mark_Filler,11,1,12,11,1,12,0.090909,0.073559,0,0,0,0
6105,,,justice4all01,0,1,1,0,1,1,0,0,1,1,1,0
6106,,,SRockyChase2,0,1,1,0,1,1,0,0,1,1,1,0
6107,,,SusanULarson,0,1,1,0,1,1,0,0,1,1,1,0
6108,,,poliddy,0,1,1,0,1,1,0,0,1,1,1,0
6109,,,OMGMAHere,0,1,1,0,1,1,0,0,1,1,1,0
6110,,,Arctic__char,0,1,1,0,1,1,0,0,1,1,1,0
6111,,,rwb07076,0,1,1,0,1,1,0,0,1,1,1,0
6112,,,narryohniall,0,1,1,0,1,1,0,0,1,1,1,0
6113,,,theheatherettes,1,1,2,1,1,2,0,0.006687,0,0,0,0
6114,,,thegoldnfinch,11,1,12,11,1,12,0.090909,0.073559,0,0,0,0
6115,,,DaveOleson,0,1,1,0,1,1,0,0,1,1,1,0
6116,,,Kissamtwits,0,1,1,0,1,1,0,0,1,1,1,0
6117,,,paulmcclintock,0,1,1,0,1,1,0,0,1,1,1,0
6118,,,kmserranorn,0,1,1,0,1,1,0,0,1,1,1,0
6119,,,JOJOXOB,0,1,1,0,1,1,0,0,1,1,1,0
6120,,,bethdonica2,0,1,1,0,1,1,0,0,1,1,1,0
6121,,,brianmoney,0,1,1,0,1,1,0,0,1,1,1,0
6122,,,shinangovani,0,1,1,0,1,1,0,0,1,1,1,0
6123,,,CuntyLiberal,0,1,1,0,1,1,0,0,1,1,1,0
6124,,,MaryMjj3,0,2,2,0,2,2,0,0,1,1,1,0
6125,,,LANXI50703629,1,1,2,1,1,2,0,0.006687,0,0,0,0
6126,,,originalspin,2,1,3,2,1,3,0.5,0.013374,0,0,0,0
6127,,,denise_howerton,0,1,1,0,1,1,0,0,1,1,1,0
6128,,,totalmisandrist,3,1,4,3,1,4,0.333333,0.020061,0,0,0,0
6129,,,M6wEu,0,1,1,0,1,1,0,0,1,1,1,0
6130,,,toni_mcclory,0,1,1,0,1,1,0,0,1,1,1,0
6131,,,SB_Zhang,8,1,9,8,1,9,0.125,0.053497,0,0,0,0
6132,,,wiseowl60,0,1,1,0,1,1,0,0,1,1,1,0
6133,,,whiteroz51,0,1,1,0,1,1,0,0,1,1,1,0
6134,,,SoCoHermit,0,1,1,0,1,1,0,0,1,1,1,0
6135,,,kagessass,0,1,1,0,1,1,0,0,1,1,1,0
6136,,,michmccarthy,0,1,1,0,1,1,0,0,1,1,1,0
6137,,,hdcathy,0,1,1,0,1,1,0,0,1,1,1,0
6138,,,BritishGQ,4,1,5,5,2,7,0.25,0.026749,0,0,0,0
6139,,,heididm08,0,1,1,0,1,1,0,0,1,1,1,0
6140,,,Georgia70190490,0,1,1,0,1,1,0,0,1,1,1,0
6141,,,sejlb,0,1,1,0,1,1,0,0,1,1,1,0
6142,,,andresDCmtz,9,1,10,9,1,10,0.111111,0.060184,0,0,0,0
6143,,,shellbelle3128,0,1,1,0,1,1,0,0,1,1,1,0
6144,,,daniel_fainberg,0,1,1,0,1,1,0,0,1,1,1,0
6145,,,cherylhe,0,1,1,0,1,1,0,0,1,1,1,0
6146,,,ValleyChestnut,0,1,1,0,1,1,0,0,1,1,1,0
6147,,,izzyisdancing,0,1,1,0,1,1,0,0,1,1,1,0
6148,,,pzr111,0,1,1,0,1,1,0,0,1,1,1,0
6149,,,mjkellylowe,0,1,1,0,1,1,0,0,1,1,1,0
6150,,,LydiaDenworth,4,1,5,4,1,5,0.25,0.026749,0,0,0,0
6151,,,AmandaPanda521,0,1,1,0,1,1,0,0,1,1,1,0
6152,,,summervacay6,0,1,1,0,1,1,0,0,1,1,1,0
6153,,,ChrissyXris,0,1,1,0,1,1,0,0,1,1,1,0
6154,,,bleudog13,9,1,10,13,1,14,0.111111,0.060184,0,0,0,0
6155,,,RFrentner,0,1,1,0,1,1,0,0,1,1,1,0
6156,,,aagcobb1,0,1,1,0,1,1,0,0,1,1,1,0
6157,,,kymburleigh,0,1,1,0,1,1,0,0,1,1,1,0
6158,,,alice4u2010,0,2,2,0,2,2,0,0,1,1,1,0
6159,,,JonhPhake,0,1,1,0,1,1,0,0,1,1,1,0
6160,,,KriTims1,0,1,1,0,1,1,0,0,1,1,1,0
6161,,,colemarie,0,1,1,0,1,1,0,0,1,1,1,0
6162,,,SpudNM,2,1,3,2,1,3,0.5,0.013374,0,0,0,0
6163,,,missgoldman19,5,1,6,5,1,6,0.2,0.033436,0,0,0,0
6164,,,gotmtv,0,3,3,0,3,3,0,0,2,0.588235,0.65,0
6165,,,hunterfphoto1,0,2,2,0,2,2,0,0,1,1,1,0
6166,,,FaunaFauna3,0,1,1,0,1,1,0,0,1,1,1,0
6167,,,robinkoretsky,2,1,3,2,1,3,0.5,0.013374,0,0,0,0
6168,,,connie_dulin,1,1,2,1,1,2,0,0.006687,0,0,0,0
6169,,,AThePorcupine,7,1,8,7,1,8,0.142857,0.04681,0,0,0,0
6170,,,tcevans87,0,1,1,0,1,1,0,0,1,1,1,0
6171,,,Diffdrum1,0,1,1,0,1,1,0,0,1,1,1,0
6172,,,bonmondieu,0,1,1,0,1,1,0,0,1,1,1,0
6173,,,efgee17,0,1,1,0,1,1,0,0,1,1,1,0
6174,,,0scar1709,0,1,1,0,1,1,0,0,1,1,1,0
6175,,,Misssripper,6,1,7,6,1,7,0.166667,0.040123,0,0,0,0
6176,,,andybrwn,0,1,1,0,1,1,0,0,1,1,1,0
6177,,,MICHAEL56026971,0,1,1,0,1,1,0,0,1,1,1,0
6178,,,JoshBosma,0,1,1,0,1,1,0,0,1,1,1,0
6179,,,3x10to8mps,0,1,1,0,1,1,0,0,1,1,1,0
6180,,,CEHall13,0,1,1,0,1,1,0,0,1,1,1,0
6181,,,gin_is_a_tonic,4,1,5,4,1,5,0.25,0.026749,0,0,0,0
6182,,,FrancesAReed,0,1,1,0,1,1,0,0,1,1,1,0
6183,,,ladyred1956,0,1,1,0,1,1,0,0,1,1,1,0
6184,,,customcore7,0,1,1,0,1,1,0,0,1,1,1,0
6185,,,LindaVT,0,1,1,0,1,1,0,0,1,1,1,0
6186,,,ccaspen,0,2,2,0,2,2,0,0,2,0.75,0.833333,0
6187,,,JulieMilnerEsq,10,2,12,10,2,12,0.090909,0.066871,1,1,1,9
6188,,,pda3olives,0,1,1,0,1,1,0,0,2,0.666667,0.75,0
6189,,,ezeewalker,0,1,1,0,1,1,0,0,2,0.666667,0.75,0
6190,,,JenH0821,0,1,1,0,1,1,0,0,2,0.666667,0.75,0
6191,,,BoogidFfskw2002,0,1,1,0,1,1,0,0,2,0.666667,0.75,0
6192,,,omyword,0,1,1,0,1,1,0,0,2,0.666667,0.75,0
6193,,,kurtbardella,0,2,2,0,2,2,0,0,2,0.75,0.833333,0
6194,,,AndreaRichman29,5,1,6,5,1,6,0.2,0.033436,0,0,0,0
6195,,,BlackBag1,0,1,1,0,1,1,0,0,1,1,1,0
6196,,,marcody8,0,2,2,0,2,2,0,0,1,1,1,0
6197,,,sweeper53,0,2,2,0,2,2,0,0,1,1,1,0
6198,,,redhead1012,0,1,1,0,1,1,0,0,1,1,1,0
6199,,,PageTurner2828,15,1,16,16,1,17,0.066667,0.100307,0,0,0,0
6200,,,GayleThomson13,0,1,1,0,1,1,0,0,1,1,1,0
6201,,,CarolLei4,0,1,1,0,2,2,0,0,1,1,1,0
6202,,,Kava25,0,1,1,0,1,1,0,0,1,1,1,0
6203,,,Squirrel1110,0,1,1,0,1,1,0,0,1,1,1,0
6204,,,MichaelonPorter,0,1,1,0,1,1,0,0,1,1,1,0
6205,,,parickards,0,1,1,0,1,1,0,0,1,1,1,0
6206,,,Azoomazoomazoom,0,1,1,0,1,1,0,0,1,1,1,0
6207,,,mizmaxgordon,0,1,1,0,1,1,0,0,1,1,1,0
6208,,,lwtotbrave,0,2,2,0,2,2,0,0,1,1,1,0
6209,,,JonesSeeker,0,1,1,0,1,1,0,0,1,1,1,0
6210,,,NiqkiC01azul,0,1,1,0,1,1,0,0,1,1,1,0
6211,,,KWhockeygirl,0,1,1,0,1,1,0,0,1,1,1,0
6212,,,RtRivesresister,0,1,1,0,1,1,0,0,1,1,1,0
6213,,,Kryamina,3,1,4,3,1,4,0.333333,0.020061,0,0,0,0
6214,,,ReenieGeraci,0,2,2,0,2,2,0,0,1,1,1,0
6215,,,tubasa_aoi,0,1,1,0,1,1,0,0,1,1,1,0
6216,,,gr82live,3,1,4,3,1,4,0.333333,0.020061,0,0,0,0
6217,,,vuh_LAHS_kehs,0,1,1,0,1,1,0,0,1,1,1,0
6218,,,0613piupiu,0,1,1,0,1,1,0,0,2,0.666667,0.75,0
6219,,,kmitt56,0,1,1,0,2,2,0,0,2,0.666667,0.75,0
6220,,,JeffHechtAZ,0,1,1,0,1,1,0,0,1,1,1,0
6221,,,allisonpaulsen1,0,1,1,0,1,1,0,0,1,1,1,0
6222,,,jefflee81258649,26,1,27,28,2,30,0.038462,0.173866,0,0,0,0
6223,,,Connie19601,0,1,1,0,1,1,0,0,1,1,1,0
6224,,,snoopy6702,0,1,1,0,1,1,0,0,1,1,1,0
6225,,,incazzare,0,1,1,0,1,1,0,0,1,1,1,0
6226,,,sherry6767,0,1,1,0,1,1,0,0,1,1,1,0
6227,,,incognato1,0,1,1,0,1,1,0,0,1,1,1,0
6228,,,blue_jay1,0,1,1,0,1,1,0,0,1,1,1,0
6229,,,FireyTopaz,0,1,1,0,2,2,0,0,1,1,1,0
6230,,,smail_sandi,0,1,1,0,1,1,0,0,1,1,1,0
6231,,,JTurnerGarcia,0,1,1,0,1,1,0,0,1,1,1,0
6232,,,NatalieGarfiel1,0,1,1,0,1,1,0,0,1,1,1,0
6233,,,bob_levitt,0,2,2,0,2,2,0,0,1,1,1,0
6234,,,Boatsandbridges,0,1,1,0,1,1,0,0,1,1,1,0
6235,,,Froggy7777777,0,1,1,0,1,1,0,0,1,1,1,0
6236,,,MJEM70,0,1,1,0,1,1,0,0,1,1,1,0
6237,,,MarjorieDaw,0,1,1,0,1,1,0,0,1,1,1,0
6238,,,CatLoverCares,0,1,1,0,1,1,0,0,1,1,1,0
6239,,,skomoruchar,0,1,1,0,1,1,0,0,1,1,1,0
6240,,,Real_FN_Strange,0,1,1,0,1,1,0,0,1,1,1,0
6241,,,VillainousMango,0,1,1,0,1,1,0,0,1,1,1,0
6242,,,catlogan2,0,1,1,0,1,1,0,0,1,1,1,0
6243,,,chryllaird,0,1,1,0,1,1,0,0,1,1,1,0
6244,,,NorthwesternU,1,1,2,1,1,2,0,0.006687,0,0,0,0
6245,,,mirrorkirby,14,1,15,18,3,21,0.071429,0.120517,0,0,0,0
6246,,,guye_guion,0,2,2,0,2,2,0,0,1,1,1,0
6247,,,baer_dudgeon,0,1,1,0,1,1,0,0,1,1,1,0
6248,,,jillbelasco,0,1,1,0,1,1,0,0,1,1,1,0
6249,,,Kelloggper,0,1,1,0,1,1,0,0,1,1,1,0
6250,,,MrBob_B,0,1,1,0,1,1,0,0,1,1,1,0
6251,,,TwoRiversTX,0,1,1,0,1,1,0,0,1,1,1,0
6252,,,KatrinaWTE,1,1,2,1,1,2,0,0.006687,0,0,0,0
6253,,,eevilplushteri,4,1,5,5,2,7,0.25,0.026749,0,0,0,0
6254,,,Jdleo1800,0,1,1,0,1,1,0,0,1,1,1,0
6255,,,OFARRL1960,0,1,1,0,1,1,0,0,1,1,1,0
6256,,,hzeiger,1,1,2,1,1,2,0,0.006687,0,0,0,0
6257,,,gpettey,0,1,1,0,1,1,0,0,1,1,1,0
6258,,,EmWankenobi,0,2,2,0,2,2,0,0,4,0.4375,0.47381,0
6259,,,sheshedtrump,0,1,1,0,1,1,0,0,1,1,1,0
6260,,,redwingschic,0,1,1,0,1,1,0,0,1,1,1,0
6261,,,drwhovy,0,1,1,0,1,1,0,0,1,1,1,0
6262,,,MrsheleneOwner,0,1,1,0,1,1,0,0,1,1,1,0
6263,,,MrsMommy,6,1,7,7,2,9,0.166667,0.0541,0,0,0,0
6264,,,lmduarte16,0,1,1,0,1,1,0,0,1,1,1,0
6265,,,milliker2017,0,2,2,0,2,2,0,0,4,0.4375,0.47381,0
6266,,,faith_jvs,0,1,1,0,1,1,0,0,1,1,1,0
6267,,,dotthedragon,0,2,2,0,2,2,0,0,4,0.4375,0.47381,0
6268,,,ReneeVoiceBrand,0,2,2,0,2,2,0,0,4,0.4375,0.47381,0
6269,,,Furmom49,0,1,1,0,1,1,0,0,4,0.43038,0.458333,0
6270,,,DoyenneSolace,0,1,1,0,1,1,0,0,4,0.43038,0.458333,0
6271,,,bradbury1958,0,1,1,0,1,1,0,0,4,0.43038,0.458333,0
6272,,,lakemichigander,0,1,1,0,1,1,0,0,4,0.43038,0.458333,0
6273,,,HeymannPaul,0,1,1,0,2,2,0,0,1,1,1,0
6274,,,lisap331,0,1,1,0,1,1,0,0,1,1,1,0
6275,,,NanniMagee,0,1,1,0,1,1,0,0,1,1,1,0
6276,,,H2OEcoLndrmt,0,1,1,0,2,2,0,0,1,1,1,0
6277,,,fauxnamerice,0,1,1,0,1,1,0,0,1,1,1,0
6278,,,trawetsla,0,1,1,0,1,1,0,0,1,1,1,0
6279,,,pettyds3,4,1,5,4,1,5,0.25,0.082656,0,0,0,0
6280,,,chickiej1,0,1,1,0,1,1,0,0,1,1,1,0
6281,,,MommaRicch,0,1,1,0,1,1,0,0,1,1,1,0
6282,,,ChiehtingYeh,4,1,5,4,1,5,0.25,0.026749,0,0,0,0
6283,,,NotTodayKatie,0,1,1,0,1,1,0,0,1,1,1,0
6284,,,queekie1,0,1,1,0,1,1,0,0,1,1,1,0
6285,,,MojoMeida,0,1,1,0,1,1,0,0,1,1,1,0
6286,,,heyashreytae,1,1,2,1,1,2,0,0.006687,0,0,0,0
6287,,,DavePerrino,6,1,7,6,1,7,0.166667,0.040123,0,0,0,0
6288,,,LindaMarkss,0,1,1,0,1,1,0,0,1,1,1,0
6289,,,dkmh70,0,1,1,0,1,1,0,0,1,1,1,0
6290,,,smx_md,0,1,1,0,1,1,0,0,1,1,1,0
6291,,,hamburg_steven,0,1,1,0,1,1,0,0,1,1,1,0
6292,,,erinm_kelly,4,1,5,4,1,5,0.25,0.026749,0,0,0,0
6293,,,klancaster1112,0,1,1,0,1,1,0,0,1,1,1,0
6294,,,SchwRoark,0,1,1,0,1,1,0,0,1,1,1,0
6295,,,daichi77m,0,2,2,0,2,2,0,0,1,1,1,0
6296,,,Ginalilvol,2,1,3,2,1,3,0.5,0.013374,0,0,0,0
6297,,,kswatt,0,1,1,0,1,1,0,0,1,1,1,0
6298,,,mdquon,4,1,5,5,1,6,0.25,0.184145,0,0,0,0
6299,,,KevTKel,0,1,1,0,1,1,0,0,1,1,1,0
6300,,,SalVadacchino1,0,1,1,0,2,2,0,0,1,1,1,0
6301,,,AndrewP98933080,36,2,38,48,12,60,0.027027,0.364688,1,1,1,70
6302,,,irisesformysoul,9,1,10,9,1,10,0.111111,0.074161,0,0,0,0
6303,,,beaysa_belle,0,1,1,0,1,1,0,0,1,1,1,0
6304,,,lindaworkerbee,0,1,1,0,1,1,0,0,1,1,1,0
6305,,,crackers28,0,1,1,0,1,1,0,0,1,1,1,0
6306,,,BigRedTodder,0,1,1,0,1,1,0,0,1,1,1,0
6307,,,TheBookofGinko,0,1,1,0,1,1,0,0,1,1,1,0
6308,,,SteveSchmidtSES,2,1,3,3,2,5,0.5,0.013374,0,0,0,0
6309,,,LolsDay,2,1,3,2,1,3,0.5,0.013374,0,0,0,0
6310,,,bunnythy27,0,1,1,0,1,1,0,0,1,1,1,0
6311,,,IceTalkPodcast,3,1,4,3,1,4,0.333333,0.020061,0,0,0,0
6312,,,Spencer_Linton,0,1,1,0,1,1,0,0,1,1,1,0
6313,,,Tjt4RoJwzk5xjV4,0,1,1,0,1,1,0,0,1,1,1,0
6314,,,summernightsgcv,2,1,3,2,1,3,0.5,0.013374,0,0,0,0
6315,,,masiroyuki1217,0,1,1,0,1,1,0,0,1,1,1,0
6316,,,dmccluskey101,1,1,2,1,1,2,0,0.006687,0,0,0,0
6317,,,real_david775,3,2,5,3,2,5,0.25,0.020061,1,1,1,2
6318,,,_thegoodonesgo,0,2,2,0,2,2,0,0,2,0.75,0.833333,0
6319,,,cb95ethereal,0,3,3,0,3,3,0,0,2,0.8,0.875,0
6320,,,OCColordguy,1,1,2,1,1,2,0,0.006687,0,0,0,0
6321,,,greenapple234,2,1,3,2,1,3,0.5,0.013374,0,0,0,0
6322,,,zerah561,0,1,1,0,1,1,0,0,1,1,1,0
6323,,,vettstappen,1,1,2,1,1,2,0,0.006687,0,0,0,0
6324,,,TravisMedvich,0,1,1,0,1,1,0,0,2,0.666667,0.75,0
6325,,,btslover117,0,1,1,0,1,1,0,0,2,0.666667,0.75,0
6326,,,sh12298,0,2,2,0,2,2,0,0,2,0.75,0.833333,0
6327,,,JoeFilippone,2,1,3,4,3,7,0.5,0.044822,0,0,0,0
6328,,,CASpears1,1,1,2,1,1,2,0,0.006687,0,0,0,0
6329,,,RussRyanLaw,9,1,10,9,1,10,0.111111,0.133563,0,0,0,0
6330,,,minimarshmeIIIo,0,1,1,0,1,1,0,0,1,1,1,0
6331,,,pandapoohkuma,0,1,1,0,1,1,0,0,1,1,1,0
6332,,,bipsterly,0,2,2,0,2,2,0,0,1,1,1,0
6333,,,Fuuta_Ponta,0,3,3,0,3,3,0,0,1,1,1,0
6334,,,chandleur,1,1,2,1,1,2,0,0.006687,0,0,0,0
6335,,,kristabo_,0,1,1,0,1,1,0,0,2,0.666667,0.75,0
6336,,,NotBobo4Sure,6,1,7,6,1,7,0.166667,0.040123,0,0,0,0
6337,,,LIGHTUP_THELIFE,0,2,2,0,2,2,0,0,1,1,1,0
6338,,,DrImranKhan,0,1,1,0,1,1,0,0,1,1,1,0
6339,,,dxangelos,0,1,1,0,1,1,0,0,1,1,1,0
6340,,,raspberrykyun,0,1,1,0,1,1,0,0,1,1,1,0
6341,,,Rickylynn18,0,1,1,0,1,1,0,0,1,1,1,0
6342,,,thorsbounty,3,1,4,3,1,4,0.333333,0.020061,0,0,0,0
6343,,,svspirivm,0,1,1,0,1,1,0,0,1,1,1,0
6344,,,AAmConservative,1,1,2,1,1,2,0,0.006687,0,0,0,0
6345,,,DTiunnson,1,1,2,1,1,2,0,0.006687,0,0,0,0
6346,,,CKscullycat,6,1,7,6,1,7,0.166667,0.040123,0,0,0,0
6347,,,Memory0710,0,1,1,0,1,1,0,0,1,1,1,0
6348,,,BatesWillie,0,1,1,0,1,1,0,0,1,1,1,0
6349,,,cneally,0,1,1,0,1,1,0,0,1,1,1,0
6350,,,tetsu0724d,0,2,2,0,2,2,0,0,1,1,1,0
6351,,,7sephs,4,1,5,6,3,9,0.25,0.026749,0,0,0,0
6352,,,karjarf,3,1,4,3,1,4,0.333333,0.020061,0,0,0,0
6353,,,CatastropheErin,0,1,1,0,1,1,0,0,1,1,1,0
6354,,,jackwalterart,0,1,1,0,1,1,0,0,1,1,1,0
6355,,,mar_lynxx,2,1,3,2,1,3,0.5,0.013374,0,0,0,0
6356,,,annatashton,1,1,2,1,1,2,0,0.006687,0,0,0,0
6357,,,kprasek,0,1,1,0,1,1,0,0,1,1,1,0
6358,,,FanAnonymous38,0,1,1,0,1,1,0,0,1,1,1,0
6359,,,_mhiangmhiang,0,1,1,0,1,1,0,0,1,1,1,0
6360,,,c_ankrum,1,1,2,1,1,2,0,0.006687,0,0,0,0
6361,,,BunneeShelton,3,1,4,4,1,5,0.333333,0.020061,0,0,0,0
6362,,,Nabireminder,0,1,1,0,2,2,0,0,1,1,1,0
6363,,,okeiguess,0,1,1,0,1,1,0,0,1,1,1,0
6364,,,triviaegi,0,1,1,0,1,1,0,0,1,1,1,0
6365,,,amrhibrhm,1,1,2,1,1,2,0,0.006687,0,0,0,0
6366,,,EnalNovie,0,1,1,0,1,1,0,0,1,1,1,0
6367,,,BrendaKaila7,4,1,5,4,1,5,0.25,0.026749,0,0,0,0
6368,,,acstanley3,0,1,1,0,1,1,0,0,1,1,1,0
6369,,,yyoonniico,0,1,1,0,1,1,0,0,1,1,1,0
6370,,,stonedpunz,6,1,7,6,1,7,0.166667,0.040123,0,0,0,0
6371,,,momi_nyannyan,0,1,1,0,1,1,0,0,1,1,1,0
6372,,,mpho_seoyun0,0,1,1,0,1,1,0,0,1,1,1,0
6373,,,OxcarJuniorsUG,0,1,1,0,1,1,0,0,1,1,1,0
6374,,,greenurlifenow,0,1,1,0,1,1,0,0,1,1,1,0
6375,,,ELiZzz0520,0,1,1,0,1,1,0,0,1,1,1,0
6376,,,AruAshita,2,1,3,2,1,3,0.5,0.013374,0,0,0,0
6377,,,nxxnmn90,0,1,1,0,1,1,0,0,1,1,1,0
6378,,,RaihanTheBard,8,1,9,8,1,9,0.125,0.060486,0,0,0,0
6379,,,star4jen,0,1,1,0,1,1,0,0,1,1,1,0
6380,,,Michell23987161,0,1,1,0,1,1,0,0,1,1,1,0
6381,,,filafresh,0,2,2,0,2,2,0,0,1,1,1,0
6382,,,Eunice19891402h,0,1,1,0,1,1,0,0,1,1,1,0
6383,,,dienaboo,0,1,1,0,1,1,0,0,1,1,1,0
6384,,,TODAYshow,1,1,2,1,1,2,0,0.006687,0,0,0,0
6385,,,chiliyskiy,1,1,2,1,1,2,0,0.006687,0,0,0,0
6386,,,unclefecal,10,1,11,10,1,11,0.1,0.172721,0,0,0,0
6387,,,malecmoo,0,1,1,0,1,1,0,0,1,1,1,0
6388,,,hncccccc,0,1,1,0,1,1,0,0,1,1,1,0
6389,,,imaaannn,0,1,1,0,1,1,0,0,1,1,1,0
6390,,,nimidnec,0,1,1,0,1,1,0,0,1,1,1,0
6391,,,hypellopotion,0,1,1,0,1,1,0,0,1,1,1,0
6392,,,BeHappyandCivil,0,1,1,0,1,1,0,0,1,1,1,0
6393,,,myeongom,0,1,1,0,1,1,0,0,1,1,1,0
6394,,,oniipons,4,1,5,4,1,5,0.25,0.026749,0,0,0,0
6395,,,hussain1968,0,1,1,0,1,1,0,0,1,1,1,0
6396,,,hakumei793,0,2,2,0,2,2,0,0,1,1,1,0
6397,,,BritaEngh,2,1,3,3,1,4,0.5,0.013374,0,0,0,0
6398,,,BobNarcos,1,1,2,1,1,2,0,0.006687,0,0,0,0
6399,,,_xiaotuzi_,0,1,1,0,1,1,0,0,1,1,1,0
6400,,,Huya_C,0,1,1,0,1,1,0,0,1,1,1,0
6401,,,russfla,2,1,3,2,1,3,0.5,0.013374,0,0,0,0
6402,,,WelcomeTheLight,1,1,2,1,1,2,0,0.006687,0,0,0,0
6403,,,lehighvalley,2,1,3,2,1,3,0.5,0.013374,0,0,0,0
6404,,,frum168,0,1,1,0,1,1,0,0,1,1,1,0
6405,,,freeacrxcards,21,1,22,29,4,33,0.047619,0.14043,0,0,0,0
6406,,,sofiaP24156389,0,1,1,0,1,1,0,0,1,1,1,0
6407,,,obeepbeepo,0,1,1,0,1,1,0,0,1,1,1,0
6408,,,juliuskevincura,0,3,3,0,3,3,0,0,1,1,1,0
6409,,,creatusmondest,12,1,13,12,1,13,0.083333,0.094223,0,0,0,0
6410,,,danielledai,0,1,1,0,1,1,0,0,1,1,1,0
6411,,,YasuhitoYANO,0,1,1,0,1,1,0,0,1,1,1,0
6412,,,BrownsCraig,0,1,1,0,1,1,0,0,1,1,1,0
6413,,,mcatatbeta,0,3,3,0,3,3,0,0,1,1,1,0
6414,,,soebooon,0,1,1,0,1,1,0,0,1,1,1,0
6415,,,annblr1,0,1,1,0,1,1,0,0,1,1,1,0
6416,,,junnie_huihui,0,1,1,0,1,1,0,0,1,1,1,0
6417,,,c_outsite,0,1,1,0,1,1,0,0,1,1,1,0
6418,,,tea_coffee_moon,3,1,4,3,1,4,0.333333,0.034038,0,0,0,0
6419,,,arsalanbaig137,0,1,1,0,1,1,0,0,1,1,1,0
6420,,,weathermanfran,2,1,3,2,1,3,0.5,0.013374,0,0,0,0
6421,,,Meninaiscrazy,0,1,1,0,1,1,0,0,1,1,1,0
6422,,,lynhours,0,1,1,0,1,1,0,0,1,1,1,0
6423,,,RamboGage,0,1,1,0,1,1,0,0,1,1,1,0
6424,,,kimrocheleau,0,1,1,0,1,1,0,0,1,1,1,0
6425,,,OnyxD4,0,1,1,0,1,1,0,0,1,1,1,0
6426,,,BabyKosica,0,1,1,0,1,1,0,0,1,1,1,0
6427,,,aholdenj,1,1,2,1,1,2,0,0.006687,0,0,0,0
6428,,,wecansoarhigher,0,3,3,0,3,3,0,0,1,1,1,0
6429,,,jmcvea81,0,1,1,0,1,1,0,0,1,1,1,0
6430,,,likaluca,6,1,7,6,1,7,0.166667,0.048304,0,0,0,0
6431,,,Moore7573,0,1,1,0,1,1,0,0,1,1,1,0
6432,,,Casablanca0408,0,1,1,0,1,1,0,0,1,1,1,0
6433,,,farufu_,0,1,1,0,1,1,0,0,1,1,1,0
6434,,,pbrantner,9,1,10,9,1,10,0.111111,0.060184,0,0,0,0
6435,,,bobbyjett,0,1,1,0,1,1,0,0,1,1,1,0
6436,,,kfrueho,0,1,1,0,1,1,0,0,1,1,1,0
6437,,,thubakisaku,0,1,1,0,1,1,0,0,1,1,1,0
6438,,,LT38,0,1,1,0,1,1,0,0,1,1,1,0
6439,,,Butterfly_Seven,0,2,2,0,2,2,0,0,2,0.75,0.833333,0
6440,,,boilingpointkr,0,1,1,0,1,1,0,0,1,1,1,0
6441,,,rikopia,0,1,1,0,1,1,0,0,1,1,1,0
6442,,,Ba4bjtOsJf3cPT3,0,1,1,0,1,1,0,0,1,1,1,0
6443,,,frahector,0,1,1,0,1,1,0,0,1,1,1,0
6444,,,birgungulmedik,0,1,1,0,1,1,0,0,1,1,1,0
6445,,,Bigfoot0713,0,1,1,0,1,1,0,0,1,1,1,0
6446,,,DoItForTess,0,1,1,0,1,1,0,0,1,1,1,0
6447,,,AASisterhood,0,1,1,0,1,1,0,0,1,1,1,0
6448,,,April_Lanuza,0,1,1,0,1,1,0,0,1,1,1,0
6449,,,asphaltIady,0,1,1,0,1,1,0,0,1,1,1,0
6450,,,LeslieKTX,0,1,1,0,1,1,0,0,1,1,1,0
6451,,,PhilosopherHey1,0,1,1,0,2,2,0,0,1,1,1,0
6452,,,YT_Figure,0,1,1,0,1,1,0,0,1,1,1,0
6453,,,TheChangfucius,6,1,7,6,1,7,0.166667,0.047111,0,0,0,0
6454,,,matters_real,0,1,1,0,1,1,0,0,1,1,1,0
6455,,,kjgheroman,0,3,3,0,3,3,0,0,1,1,1,0
6456,,,kgsooslvt,0,1,1,0,1,1,0,0,1,1,1,0
6457,,,PJATOHOO,0,1,1,0,1,1,0,0,1,1,1,0
6458,,,Teachthechange3,0,3,3,0,7,7,0,0,1,1,1,0
6459,,,DSI_2016,11,1,12,13,1,14,0.090909,0.116036,0,0,0,0
6460,,,theflutelady,1,2,3,1,2,3,0.5,0.006687,1,1,1,0
6461,,,WertherGreene,0,1,1,0,1,1,0,0,1,1,1,0
6462,,,AEssaji,0,1,1,0,1,1,0,0,1,1,1,0
6463,,,hennhouse3,0,1,1,0,1,1,0,0,1,1,1,0
6464,,,DIN18599,0,1,1,0,1,1,0,0,1,1,1,0
6465,,,Lylith159,5,1,6,5,1,6,0.2,0.03693,0,0,0,0
6466,,,harukoro12,0,1,1,0,1,1,0,0,1,1,1,0
6467,,,kwenjean,0,1,1,0,1,1,0,0,1,1,1,0
6468,,,jkkkk0011,0,1,1,0,1,1,0,0,1,1,1,0
6469,,,SRight342,1,1,2,1,1,2,0,0.006687,0,0,0,0
6470,,,nigel_333,3,1,4,3,1,4,0.333333,0.020061,0,0,0,0
6471,,,0i1j866,0,1,1,0,1,1,0,0,1,1,1,0
6472,,,ItsStarryo_,0,1,1,0,1,1,0,0,1,1,1,0
6473,,,nickidiacik,3,1,4,3,1,4,0.333333,0.020061,0,0,0,0
6474,,,theladiesch0ice,0,1,1,0,1,1,0,0,1,1,1,0
6475,,,utorgersen,0,2,2,0,2,2,0,0,1,1,1,0
6476,,,chanwygo,0,1,1,0,1,1,0,0,1,1,1,0
6477,,,tungwene,2,1,3,2,1,3,0.5,0.013374,0,0,0,0
6478,,,JustinFaircloth,0,1,1,0,1,1,0,0,1,1,1,0
6479,,,CapitalSportsNC,2,1,3,2,1,3,0.5,0.013374,0,0,0,0
6480,,,5dYHwUeZxFbxvSz,0,1,1,0,1,1,0,0,1,1,1,0
6481,,,MsMarieDotCom,4,1,5,4,1,5,0.25,0.026749,0,0,0,0
6482,,,7b73f39b85e1415,0,5,5,0,5,5,0,0,2,0.727273,0.8125,0
6483,,,pwalkways_210,0,1,1,0,1,1,0,0,1,1,1,0
6484,,,So_Much_Fandoms,0,1,1,0,1,1,0,0,1,1,1,0
6485,,,hopeandquad,0,2,2,0,2,2,0,0,1,1,1,0
6486,,,yasukosunsun,0,1,1,0,1,1,0,0,1,1,1,0
6487,,,AlgiersLady,0,1,1,0,1,1,0,0,1,1,1,0
6488,,,griffyh8er,0,2,2,0,2,2,0,0,1,1,1,0
6489,,,WRAL,0,1,1,0,1,1,0,0,1,1,1,0
6490,,,uraniegarden,0,1,1,0,1,1,0,0,1,1,1,0
6491,,,giulianalonigro,3,1,4,3,1,4,0.333333,0.020061,0,0,0,0
6492,,,JCh505,0,1,1,0,1,1,0,0,1,1,1,0
6493,,,launcry,1,1,2,1,1,2,0,0.006687,0,0,0,0
6494,,,dennisromboy,0,1,1,0,1,1,0,0,3,0.483333,0.5,0
6495,,,WRALSportsFan,5,1,6,5,1,6,0.2,0.033436,0,0,0,0
6496,,,Zhingi1,0,3,3,0,3,3,0,0,1,1,1,0
6497,,,jooniepeg,0,1,1,0,1,1,0,0,1,1,1,0
6498,,,jennykim,0,3,3,0,13,13,0,0,1,1,1,0
6499,,,yellowheart_xjp,0,1,1,0,1,1,0,0,1,1,1,0
6500,,,TellurianDigits,0,1,1,0,1,1,0,0,1,1,1,0
6501,,,elise_hpe,0,1,1,0,1,1,0,0,1,1,1,0
6502,,,Tigergirl72,0,1,1,0,1,1,0,0,1,1,1,0
6503,,,jamieishum,0,1,1,0,1,1,0,0,1,1,1,0
6504,,,CadillacLade12,6,1,7,6,1,7,0.166667,0.040123,0,0,0,0
6505,,,shinesvt,0,1,1,0,1,1,0,0,1,1,1,0
6506,,,chocoma_,0,2,2,0,2,2,0,0,1,1,1,0
6507,,,CherieCherry13,0,1,1,0,1,1,0,0,1,1,1,0
6508,,,Sunday44107521,0,1,1,0,1,1,0,0,1,1,1,0
6509,,,lanhw1,9,1,10,11,3,14,0.111111,0.067173,0,0,0,0
6510,,,JohnsonThongLP,0,2,2,0,2,2,0,0,1,1,1,0
6511,,,mintchoddeonut,0,1,1,0,1,1,0,0,1,1,1,0
6512,,,eLUBlj3Ypby7k9X,0,1,1,0,1,1,0,0,1,1,1,0
6513,,,jlitwinetz,5,1,6,8,4,12,0.2,0.045725,0,0,0,0
6514,,,E0gZjflyWOTAney,0,1,1,0,1,1,0,0,1,1,1,0
6515,,,QueenMelmendi,0,1,1,0,1,1,0,0,1,1,1,0
6516,,,shybimbo,0,1,1,0,1,1,0,0,1,1,1,0
6517,,,hamichanchi,0,1,1,0,1,1,0,0,1,1,1,0
6518,,,KaurananSpring,1,1,2,1,1,2,0,0.006687,0,0,0,0
6519,,,njdotcom,1,1,2,1,1,2,0,0.006687,0,0,0,0
6520,,,dengnyc,1,1,2,1,1,2,0,0.006687,0,0,0,0
6521,,,NBCAsianAmerica,2,1,3,3,2,5,0.5,0.013374,0,0,0,0
6522,,,evelynjmiller1,1,1,2,1,1,2,0,0.006687,0,0,0,0
6523,,,celticfire64,2,1,3,2,1,3,0.5,0.013374,0,0,0,0
6524,,,JThompsbj,0,1,1,0,1,1,0,0,1,1,1,0
6525,,,RedSonj38377472,0,1,1,0,1,1,0,0,1,1,1,0
6526,,,Evalie3689,2,1,3,2,1,3,0.5,0.013374,0,0,0,0
6527,,,ArayAromaz,0,1,1,0,1,1,0,0,1,1,1,0
6528,,,palomapm19,0,4,4,0,4,4,0,0,1,1,1,0
6529,,,BethScholtz,1,1,2,1,1,2,0,0.006687,0,0,0,0
6530,,,carlyalexis_92,3,1,4,3,1,4,0.333333,0.020061,0,0,0,0
6531,,,tofu1231,0,1,1,0,1,1,0,0,1,1,1,0
6532,,,William26059253,3,1,4,3,1,4,0.333333,0.020061,0,0,0,0
6533,,,KeplerSews,0,1,1,0,1,1,0,0,1,1,1,0
6534,,,moonchild_hftds,0,1,1,0,1,1,0,0,1,1,1,0
6535,,,emptybamboogirl,1,1,2,2,2,4,0,0.006687,0,0,0,0
6536,,,FewWinnifred,5,1,6,5,1,6,0.2,0.033436,0,0,0,0
6537,,,maolovesports,0,2,2,0,2,2,0,0,1,1,1,0
6538,,,rainypjms,0,1,1,0,1,1,0,0,1,1,1,0
6539,,,yuma_haruu,0,1,1,0,1,1,0,0,1,1,1,0
6540,,,Lynn_Flores1598,0,1,1,0,1,1,0,0,1,1,1,0
6541,,,ricebxIl,6,1,7,6,1,7,0.166667,0.047111,0,0,0,0
6542,,,KurwaKaras,0,1,1,0,1,1,0,0,1,1,1,0
6543,,,btslgbtwarriors,0,1,1,0,1,1,0,0,1,1,1,0
6544,,,6bgtMEwpu0neSC5,0,1,1,0,1,1,0,0,1,1,1,0
6545,,,katsura_noppe,0,1,1,0,1,1,0,0,1,1,1,0
6546,,,ssdakduk,1,1,2,1,1,2,0,0.006687,0,0,0,0
6547,,,dionysia0101,0,1,1,0,1,1,0,0,1,1,1,0
6548,,,ykkwbch,0,1,1,0,1,1,0,0,1,1,1,0
6549,,,444hyvn,1,1,2,1,1,2,0,0.006687,0,0,0,0
6550,,,joflake,3,1,4,3,1,4,0.333333,0.020061,0,0,0,0
6551,,,koomyrtille,0,1,1,0,1,1,0,0,1,1,1,0
6552,,,KimCheeMichael,0,1,1,0,1,1,0,0,1,1,1,0
6553,,,seachelle669,3,1,4,3,1,4,0.333333,0.020061,0,0,0,0
6554,,,carolinefz321,0,1,1,0,1,1,0,0,1,1,1,0
6555,,,sharingonegirl,0,1,1,0,1,1,0,0,1,1,1,0
6556,,,MarybethJeffr10,2,1,3,2,1,3,0.5,0.013374,0,0,0,0
6557,,,koume316,0,2,2,0,2,2,0,0,1,1,1,0
6558,,,Jiahhhui,1,1,2,1,1,2,0,0.006687,0,0,0,0
6559,,,faeyuz,2,1,3,2,1,3,0.5,0.013374,0,0,0,0
6560,,,WrightVtlala,0,1,1,0,1,1,0,0,1,1,1,0
6561,,,alisacomefrom,0,1,1,0,1,1,0,0,1,1,1,0
6562,,,nomoretakuan,0,1,1,0,1,1,0,0,1,1,1,0
6563,,,Blue00398846,0,1,1,0,1,1,0,0,1,1,1,0
6564,,,onnellinen3,0,1,1,0,1,1,0,0,1,1,1,0
6565,,,CheriPreston,1,1,2,1,1,2,0,0.006687,0,0,0,0
6566,,,hyytheorist,2,1,3,2,1,3,0.5,0.013374,0,0,0,0
6567,,,stephonee,3,1,4,3,1,4,0.333333,0.028243,0,0,0,0
6568,,,Swan2018Olympic,0,1,1,0,1,1,0,0,1,1,1,0
6569,,,azhumiwho,0,1,1,0,1,1,0,0,2,0.571429,0.625,0
6570,,,AsianMenAreSexy,0,1,1,0,1,1,0,0,2,0.571429,0.625,0
6571,,,toysastools,1,1,2,1,1,2,0,0.006687,0,0,0,0
6572,,,christinenyctw,1,1,2,1,1,2,0,0.006687,0,0,0,0
6573,,,Alue1988,0,1,1,0,1,1,0,0,1,1,1,0
6574,,,shaconne2013,3,2,5,3,2,5,0.25,0.020061,1,1,1,2
6575,,,debrob1947,0,1,1,0,1,1,0,0,2,0.666667,0.75,0
6576,,,PatRaines7,0,1,1,0,1,1,0,0,2,0.666667,0.75,0
6577,,,StephenScallan,4,1,5,4,1,5,0.25,0.046027,0,0,0,0
6578,,,clewischat,0,1,1,0,1,1,0,0,1,1,1,0
6579,,,hameedafghan5,0,1,1,0,1,1,0,0,1,1,1,0
6580,,,SaraJoMartin1,1,1,2,1,1,2,0,0.006687,0,0,0,0
6581,,,katharineumm,8,1,9,9,2,11,0.125,0.053497,0,0,0,0
6582,,,cry4taeil,0,1,1,0,1,1,0,0,1,1,1,0
6583,,,nichosbeanie,0,1,1,0,1,1,0,0,1,1,1,0
6584,,,julia_hood,0,1,1,0,1,1,0,0,1,1,1,0
6585,,,rinaskal,0,1,1,0,1,1,0,0,1,1,1,0
6586,,,nbcbayarea,7,3,10,11,7,18,0.111111,0.057293,1,1,1,14
6587,,,2020Better,1,1,2,1,1,2,0,0.006687,0,0,0,0
6588,,,VeritasFilia27,1,1,2,1,1,2,0,0.006687,0,0,0,0
6589,,,daejangie,1,1,2,1,1,2,0,0.006687,0,0,0,0
6590,,,orbithanyu,1,1,2,1,1,2,0,0.006687,0,0,0,0
6591,,,emilyyee_,0,1,1,0,1,1,0,0,1,1,1,0
6592,,,sal18201,0,1,1,0,1,1,0,0,1,1,1,0
6593,,,Jing99463515,0,1,1,0,1,1,0,0,1,1,1,0
6594,,,Cura_Ut_Valeas1,1,1,2,1,1,2,0,0.006687,0,0,0,0
6595,,,bedrockbro,4,1,5,4,1,5,0.25,0.026749,0,0,0,0
6596,,,skyfolly,0,1,1,0,1,1,0,0,1,1,1,0
6597,,,CiaoIao60720688,0,2,2,0,2,2,0,0,1,1,1,0
6598,,,redstatetalk,1,1,2,1,1,2,0,0.006687,0,0,0,0
6599,,,307WindyWyoming,2,1,3,2,1,3,0.5,0.013374,0,0,0,0
6600,,,punkt_ochibo,0,1,1,0,1,1,0,0,1,1,1,0
6601,,,kamiizuruu,5,1,6,6,2,8,0.2,0.040424,0,0,0,0
6602,,,uraru7,0,1,1,0,1,1,0,0,1,1,1,0
6603,,,silver_anchor4,0,1,1,0,1,1,0,0,1,1,1,0
6604,,,0hoerat,0,1,1,0,1,1,0,0,1,1,1,0
6605,,,maximum_girl,0,1,1,0,1,1,0,0,1,1,1,0
6606,,,nyanpalace,0,1,1,0,1,1,0,0,1,1,1,0
6607,,,timcbooth,1,1,2,1,1,2,0,0.006687,0,0,0,0
6608,,,cah__27,0,1,1,0,1,1,0,0,1,1,1,0
6609,,,Ampan_rhythm,0,1,1,0,1,1,0,0,1,1,1,0
6610,,,humanrobotcoll2,9,1,10,9,1,10,0.111111,0.060184,0,0,0,0
6611,,,myindylion,0,1,1,0,1,1,0,0,1,1,1,0
6612,,,el_irazaba,0,1,1,0,1,1,0,0,1,1,1,0
6613,,,nothingness__x,0,1,1,0,1,1,0,0,1,1,1,0
6614,,,CrabNE1,0,1,1,0,1,1,0,0,1,1,1,0
6615,,,fuckdammitfraz,0,1,1,0,1,1,0,0,1,1,1,0
6616,,,ChineseLibDems,0,1,1,0,1,1,0,0,1,1,1,0
6617,,,dancingking_20,0,1,1,0,1,1,0,0,1,1,1,0
6618,,,yuzuru_fairy,0,2,2,0,2,2,0,0,1,1,1,0
6619,,,jennersax,6,1,7,6,1,7,0.166667,0.040123,0,0,0,0
6620,,,jeuBF5py2oSXhWf,0,1,1,0,1,1,0,0,1,1,1,0
6621,,,LoiDenny,0,2,2,0,2,2,0,0,1,1,1,0
6622,,,joy_roehnert,0,1,1,0,1,1,0,0,1,1,1,0
6623,,,f4iryvie,0,1,1,0,1,1,0,0,1,1,1,0
6624,,,PhilippusArabus,1,1,2,1,1,2,0,0.006687,0,0,0,0
6625,,,carhumabasan,0,3,3,0,3,3,0,0,2,0.8,0.875,0
6626,,,jieqion9,0,1,1,0,1,1,0,0,1,1,1,0
6627,,,ChristineR825,0,1,1,0,1,1,0,0,1,1,1,0
6628,,,mdsb0919,0,1,1,0,1,1,0,0,1,1,1,0
6629,,,wstaplin1,1,1,2,1,1,2,0,0.006687,0,0,0,0
6630,,,lesbiabchuu,0,2,2,0,2,2,0,0,1,1,1,0
6631,,,GilesYeo,1,1,2,1,1,2,0,0.006687,0,0,0,0
6632,,,MelanieM_Texas,3,1,4,3,1,4,0.333333,0.034038,0,0,0,0
6633,,,leburialmounds,4,4,8,4,5,9,0.142857,0.026749,1,1,1,9
6634,,,sunlightafters1,0,1,1,0,1,1,0,0,1,1,1,0
6635,,,seijouhz,0,1,1,0,1,1,0,0,1,1,1,0
6636,,,profTSM,0,1,1,0,1,1,0,0,1,1,1,0
6637,,,DDoner6,0,1,1,0,1,1,0,0,1,1,1,0
6638,,,Jacob13867464,0,1,1,0,1,1,0,0,1,1,1,0
6639,,,higeo2,0,1,1,0,1,1,0,0,1,1,1,0
6640,,,JosianeNH33,0,1,1,0,1,1,0,0,1,1,1,0
6641,,,wordyBramia,1,1,2,1,1,2,0,0.006687,0,0,0,0
6642,,,Mamievandoren,5,1,6,5,1,6,0.2,0.036163,0,0,0,0
6643,,,seasonsin1hour,0,1,1,0,1,1,0,0,1,1,1,0
6644,,,Posicho,1,1,2,1,1,2,0,0.006687,0,0,0,0
6645,,,ValentinAleida,3,1,4,3,1,4,0.333333,0.020061,0,0,0,0
6646,,,mjr971,0,1,1,0,1,1,0,0,1,1,1,0
6647,,,henoados,4,1,5,4,1,5,0.25,0.026749,0,0,0,0
6648,,,WeissNachtfeder,0,1,1,0,1,1,0,0,1,1,1,0
6649,,,dufrend,0,1,1,0,1,1,0,0,1,1,1,0
6650,,,bharanidhar,0,1,1,0,1,1,0,0,1,1,1,0
6651,,,CaryZheng,5,1,6,6,2,8,0.2,0.033436,0,0,0,0
6652,,,Lllodddkkkkovvv,0,1,1,0,1,1,0,0,1,1,1,0
6653,,,graham_TeleNoza,0,1,1,0,1,1,0,0,1,1,1,0
6654,,,yokorinjj,0,1,1,0,1,1,0,0,1,1,1,0
6655,,,sacchacrystals,2,1,3,2,1,3,0.5,0.013374,0,0,0,0
6656,,,ATALG3,0,1,1,0,1,1,0,0,1,1,1,0
6657,,,CharlieMMAFAN,5,1,6,5,1,6,0.2,0.033436,0,0,0,0
6658,,,Atty44,0,1,1,0,1,1,0,0,1,1,1,0
6659,,,Le_Sian,0,2,2,0,2,2,0,0,1,1,1,0
6660,,,DavidDHaynes,0,1,1,0,1,1,0,0,1,1,1,0
6661,,,CoppedNews,2,1,3,2,1,3,0.5,0.013374,0,0,0,0
6662,,,TMiller99,0,1,1,0,1,1,0,0,1,1,1,0
6663,,,bloomforyou_,6,1,7,6,1,7,0.166667,0.043617,0,0,0,0
6664,,,UrrutiaRa,0,1,1,0,1,1,0,0,1,1,1,0
6665,,,endlesssolis,0,1,1,0,1,1,0,0,1,1,1,0
6666,,,Heauxrith,0,1,1,0,1,1,0,0,1,1,1,0
6667,,,s5200s,0,1,1,0,1,1,0,0,1,1,1,0
6668,,,MagnoliaG2012,1,2,3,1,2,3,0.5,0.006687,1,1,1,0
6669,,,h5463,0,1,1,0,1,1,0,0,1,1,1,0
6670,,,jasonbohn9,3,1,4,3,1,4,0.333333,0.020061,0,0,0,0
6671,,,Hanjunshi,0,1,1,0,1,1,0,0,1,1,1,0
6672,,,BillGRinehart,0,1,1,0,1,1,0,0,1,1,1,0
6673,,,JamesBa31477771,1,1,2,1,1,2,0,0.006687,0,0,0,0
6674,,,NPRWeekend,0,1,1,0,1,1,0,0,1,1,1,0
6675,,,official_4news,2,1,3,2,1,3,0.5,0.013374,0,0,0,0
6676,,,lonberrett,0,1,1,0,1,1,0,0,1,1,1,0
6677,,,NBCNightlyNews,2,1,3,2,1,3,0.5,0.013374,0,0,0,0
6678,,,NarinaPusaard,0,1,1,0,1,1,0,0,1,1,1,0
6679,,,nprscottsimon,1,1,2,1,1,2,0,0.006687,0,0,0,0
6680,,,karmatiques,1,1,2,1,1,2,0,0.006687,0,0,0,0
6681,,,chimtartlet,3,2,5,4,2,6,0.25,0.020061,1,1,1,2
6682,,,jaketohack1329,0,1,1,0,1,1,0,0,2,0.666667,0.75,0
6683,,,Virgini73432660,1,1,2,1,1,2,0,0.006687,0,0,0,0
6684,,,CommonDem,2,1,3,2,1,3,0.5,0.013374,0,0,0,0
6685,,,stockexchange,0,1,1,0,1,1,0,0,1,1,1,0
6686,,,MargolisWendy,2,1,3,2,1,3,0.5,0.045845,0,0,0,0
6687,,,D12996361,4,1,5,4,1,5,0.25,0.026749,0,0,0,0
6688,,,traveler_mizuho,0,1,1,0,1,1,0,0,1,1,1,0
6689,,,BeccaRay91,0,2,2,0,2,2,0,0,2,0.75,0.833333,0
6690,,,WWaNylQ2mWwiZQR,0,1,1,0,1,1,0,0,1,1,1,0
6691,,,VirgoJ24,3,1,4,3,1,4,0.333333,0.020061,0,0,0,0
6692,,,RKhasasin,0,1,1,0,1,1,0,0,1,1,1,0
6693,,,diverdoug,0,1,1,0,1,1,0,0,1,1,1,0
6694,,,chinelee4,0,1,1,0,1,1,0,0,1,1,1,0
6695,,,Maat_Dai,0,1,1,0,1,1,0,0,1,1,1,0
6696,,,twiDAQ,0,1,1,0,1,1,0,0,1,1,1,0
6697,,,np_grwl,0,2,2,0,2,2,0,0,1,1,1,0
6698,,,OceanLoverFore1,0,1,1,0,1,1,0,0,1,1,1,0
6699,,,sofealina15,0,1,1,0,1,1,0,0,1,1,1,0
6700,,,Michele6360,0,1,1,0,1,1,0,0,1,1,1,0
6701,,,walkingphotos2,0,1,1,0,1,1,0,0,2,0.666667,0.75,0
6702,,,jooniejooniej,0,1,1,0,1,1,0,0,2,0.666667,0.75,0
6703,,,povctrl,0,1,1,0,1,1,0,0,2,0.571429,0.625,0
6704,,,DMSL961,7,1,8,7,1,8,0.142857,0.04681,0,0,0,0
6705,,,mack_souder,0,1,1,0,1,1,0,0,1,1,1,0
6706,,,hanakoma703,0,1,1,0,1,1,0,0,1,1,1,0
6707,,,69Barebear,0,1,1,0,1,1,0,0,1,1,1,0
6708,,,kunsboum,0,2,2,0,2,2,0,0,1,1,1,0
6709,,,GerardoOrtizL,0,1,1,0,1,1,0,0,1,1,1,0
6710,,,Venus_Marquez64,4,1,5,4,1,5,0.25,0.026749,0,0,0,0
6711,,,equi_noctis,0,2,2,0,2,2,0,0,1,1,1,0
6712,,,ChinatownVoices,2,1,3,2,1,3,0.5,0.013374,0,0,0,0
6713,,,gf_eunha_hk,0,1,1,0,1,1,0,0,1,1,1,0
6714,,,yexiao_gaming,2,1,3,2,1,3,0.5,0.013374,0,0,0,0
6715,,,sasssurlaglace,0,2,2,0,2,2,0,0,1,1,1,0
6716,,,tetotorei,0,1,1,0,1,1,0,0,3,0.444444,0.541667,0
6717,,,XJBB,0,1,1,0,1,1,0,0,3,0.444444,0.541667,0
6718,,,ahahgsgsga,0,1,1,0,1,1,0,0,3,0.444444,0.541667,0
6719,,,ludovicamarcel3,0,1,1,0,1,1,0,0,3,0.444444,0.541667,0
6720,,,SyedaShabanaAsh,7,1,8,7,1,8,0.142857,0.04681,0,0,0,0
6721,,,hir0mia,3,1,4,3,1,4,0.333333,0.020061,0,0,0,0
6722,,,AnalystHealth,0,1,1,0,1,1,0,0,1,1,1,0
6723,,,titanic1441992,0,1,1,0,1,1,0,0,1,1,1,0
6724,,,BenisonMrs,1,1,2,1,1,2,0,0.006687,0,0,0,0
6725,,,wx_ae5,1,1,2,1,1,2,0,0.006687,0,0,0,0
6726,,,ClemsonExol,2,1,3,2,1,3,0.5,0.013374,0,0,0,0
6727,,,honestlycorrect,7,1,8,8,2,10,0.142857,0.04681,0,0,0,0
6728,,,Kristib43042441,11,1,12,12,1,13,0.090909,0.128682,0,0,0,0
6729,,,reveshooter,0,1,1,0,1,1,0,0,1,1,1,0
6730,,,cmwheatley56,0,1,1,0,1,1,0,0,1,1,1,0
6731,,,chifruity,0,1,1,0,1,1,0,0,1,1,1,0
6732,,,maryccatanese,0,1,1,0,1,1,0,0,1,1,1,0
6733,,,02kolo,0,1,1,0,1,1,0,0,1,1,1,0
6734,,,InHomeTutor808,1,2,3,1,2,3,0.5,0.006687,1,1,1,0
6735,,,BritishHeraldUK,14,2,16,14,2,16,0.066667,0.104103,1,1,1,15
6736,,,MiloMyo,0,1,1,0,2,2,0,0,1,1,1,0
6737,,,yuzurika_fan,0,1,1,0,1,1,0,0,1,1,1,0
6738,,,Timlongman,10,1,11,12,1,13,0.1,0.066871,0,0,0,0
6739,,,Light320510,0,1,1,0,1,1,0,0,1,1,1,0
6740,,,salopesan,0,1,1,0,1,1,0,0,1,1,1,0
6741,,,heidyzh,0,1,1,0,1,1,0,0,1,1,1,0
6742,,,fuyumi1225,0,2,2,0,2,2,0,0,1,1,1,0
6743,,,kookies_eyelash,0,1,1,0,1,1,0,0,1,1,1,0
6744,,,HenleySecnethia,0,1,1,0,2,2,0,0,1,1,1,0
6745,,,aUTMAjtvtijDCzn,0,1,1,0,2,2,0,0,1,1,1,0
6746,,,mademoiselle_Gx,0,1,1,0,1,1,0,0,1,1,1,0
6747,,,Ronaldoooo547,5,1,6,5,1,6,0.2,0.036163,0,0,0,0
6748,,,kcofefk_34_cum,0,2,2,0,2,2,0,0,1,1,1,0
6749,,,daniijudd,0,1,1,0,1,1,0,0,1,1,1,0
6750,,,skategyoza,0,1,1,0,1,1,0,0,1,1,1,0
6751,,,shroodleoodle,11,1,12,12,1,13,0.090909,0.073559,0,0,0,0
6752,,,OnTheHOtTinROOf,0,1,1,0,1,1,0,0,1,1,1,0
6753,,,Tak_29,0,1,1,0,1,1,0,0,1,1,1,0
6754,,,namolon,0,4,4,0,4,4,0,0,3,0.514286,0.583333,0
6755,,,thatmfjean,0,1,1,0,1,1,0,0,1,1,1,0
6756,,,h_wing_1,0,1,1,0,1,1,0,0,1,1,1,0
6757,,,GMJ1761422198,0,1,1,0,1,1,0,0,1,1,1,0
6758,,,lovemaxmusic,0,1,1,0,1,1,0,0,1,1,1,0
6759,,,triplelutzs,1,1,2,1,1,2,0,0.006687,0,0,0,0
6760,,,anaspansies,1,1,2,1,1,2,0,0.006687,0,0,0,0
6761,,,nongnaur,1,1,2,1,1,2,0,0.006687,0,0,0,0
6762,,,jerichobritton,3,2,5,3,2,5,0.25,0.020061,1,1,1,2
6763,,,itsnotnamjoon,0,1,1,0,1,1,0,0,2,0.666667,0.75,0
6764,,,ash_starmy,0,1,1,0,1,1,0,0,2,0.666667,0.75,0
6765,,,_sallyho,1,4,5,1,4,5,0.25,0.006687,2,0.636364,0.714286,0
6766,,,hatome88,0,1,1,0,2,2,0,0,2,0.666667,0.75,0
6767,,,gunattafan,0,2,2,0,2,2,0,0,2,0.75,0.833333,0
6768,,,sukunamaid,5,1,6,5,1,6,0.2,0.054401,0,0,0,0
6769,,,Cinzia100th,0,2,2,0,2,2,0,0,1,1,1,0
6770,,,rebpriv,0,1,1,0,1,1,0,0,1,1,1,0
6771,,,H4NYUPRNT,1,1,2,1,1,2,0,0.006687,0,0,0,0
6772,,,cmariedreams,1,1,2,1,1,2,0,0.006687,0,0,0,0
6773,,,kondratuiks,11,1,12,13,1,14,0.090909,0.111739,0,0,0,0
6774,,,MAKA_blueICE,0,1,1,0,1,1,0,0,1,1,1,0
6775,,,harufi_4A,0,1,1,0,1,1,0,0,1,1,1,0
6776,,,_3lixabeth_,0,1,1,0,1,1,0,0,1,1,1,0
6777,,,apricot_ice330,0,1,1,0,1,1,0,0,1,1,1,0
6778,,,khughes1963,4,1,5,4,1,5,0.25,0.026749,0,0,0,0
6779,,,noahtrister,0,2,2,0,2,2,0,0,1,1,1,0
6780,,,henrymaraza,5,1,6,5,1,6,0.2,0.033436,0,0,0,0
6781,,,yuzhulu2,0,1,1,0,1,1,0,0,1,1,1,0
6782,,,harutobudae,0,1,1,0,1,1,0,0,1,1,1,0
6783,,,ImranDev3,0,1,1,0,1,1,0,0,1,1,1,0
6784,,,myown614,0,1,1,0,1,1,0,0,1,1,1,0
6785,,,wen_yajun,3,1,4,3,1,4,0.333333,0.020061,0,0,0,0
6786,,,Iaserqeust,0,2,2,0,8,8,0,0,1,1,1,0
6787,,,OconnorPeggy,0,1,1,0,1,1,0,0,2,0.6,0.666667,0
6788,,,andreeafz_,0,1,1,0,1,1,0,0,2,0.6,0.666667,0
6789,,,jakpomidor,0,1,1,0,1,1,0,0,2,0.6,0.666667,0
6790,,,ggnineties,1,1,2,1,1,2,0,0.006687,0,0,0,0
6791,,,JakbPhotography,0,1,1,0,1,1,0,0,1,1,1,0
6792,,,sehunsilog,1,1,2,1,1,2,0,0.006687,0,0,0,0
6793,,,AP_Sports,2,3,5,2,3,5,0.25,0.013374,2,0.75,0.833333,3
6794,,,DMU_SportMgmt,0,1,1,0,1,1,0,0,3,0.5,0.583333,0
6795,,,penn1892,5,1,6,5,1,6,0.2,0.033436,0,0,0,0
6796,,,OttomanaNews,0,1,1,0,1,1,0,0,1,1,1,0
6797,,,hato3845,0,1,1,0,1,1,0,0,1,1,1,0
6798,,,TammyHuskyMom,2,1,3,2,1,3,0.5,0.013374,0,0,0,0
6799,,,Yij9xwukpYAIrSB,0,1,1,0,1,1,0,0,1,1,1,0
6800,,,evereeze,0,1,1,0,1,1,0,0,1,1,1,0
6801,,,ForbesSports,2,1,3,2,1,3,0.5,0.013374,0,0,0,0
6802,,,rikyuzjasgay,0,2,2,0,2,2,0,0,1,1,1,0
6803,,,lita_meza13,10,1,11,11,2,13,0.1,0.069599,0,0,0,0
6804,,,2KY8O6JbwYxLklI,0,1,1,0,1,1,0,0,1,1,1,0
6805,,,noelia098l,0,1,1,0,1,1,0,0,1,1,1,0
6806,,,imjeldescorkim,0,1,1,0,1,1,0,0,1,1,1,0
6807,,,mtvnextsocial,1,1,2,1,1,2,0,0.006687,0,0,0,0
6808,,,TSPSocial,3,1,4,3,1,4,0.333333,0.020061,0,0,0,0
6809,,,MinnieZhang7,0,1,1,0,1,1,0,0,1,1,1,0
6810,,,sevowitch,11,1,12,12,1,13,0.090909,0.073559,0,0,0,0
6811,,,peach9039,0,2,2,0,2,2,0,0,1,1,1,0
6812,,,ConneryBrand,0,1,1,0,1,1,0,0,1,1,1,0
6813,,,lecielblue8,0,1,1,0,1,1,0,0,1,1,1,0
6814,,,RachelAxon,0,1,1,0,1,1,0,0,1,1,1,0
6815,,,LauraJeanSavage,0,1,1,0,1,1,0,0,1,1,1,0
6816,,,abel_jennifer,0,1,1,0,1,1,0,0,1,1,1,0
6817,,,huangjinlong91,0,1,1,0,1,1,0,0,1,1,1,0
6818,,,whry7128,0,1,1,0,1,1,0,0,1,1,1,0
6819,,,BbangHiro,3,1,4,3,1,4,0.333333,0.020061,0,0,0,0
6820,,,efreemanart,0,1,1,0,1,1,0,0,1,1,1,0
6821,,,iniaes,1,1,2,1,1,2,0,0.006687,0,0,0,0
6822,,,BladeTrace,0,1,1,0,1,1,0,0,1,1,1,0
6823,,,k4th29,0,1,1,0,2,2,0,0,1,1,1,0
6824,,,DaNtHeMaN_916,5,1,6,5,1,6,0.2,0.033436,0,0,0,0
6825,,,smilehoyaaaaa,0,1,1,0,1,1,0,0,1,1,1,0
6826,,,MizukiWATARI_KG,0,1,1,0,1,1,0,0,1,1,1,0
6827,,,SouthCaucasus,0,1,1,0,1,1,0,0,1,1,1,0
6828,,,rinrinkichikich,0,1,1,0,1,1,0,0,1,1,1,0
6829,,,_glyzl,0,1,1,0,1,1,0,0,2,0.666667,0.75,0
6830,,,gloriousness,0,1,1,0,1,1,0,0,2,0.666667,0.75,0
6831,,,naco0614,0,1,1,0,1,1,0,0,2,0.666667,0.75,0
6832,,,yuzuwuquads,0,1,1,0,1,1,0,0,2,0.666667,0.75,0
6833,,,rickybaker_,0,1,1,0,1,1,0,0,2,0.666667,0.75,0
6834,,,yoonginnon,0,1,1,0,1,1,0,0,2,0.666667,0.75,0
6835,,,sajitaeso,0,1,1,0,1,1,0,0,2,0.666667,0.75,0
6836,,,yuyonglin4,0,1,1,0,1,1,0,0,2,0.666667,0.75,0
6837,,,granponte316,0,1,1,0,1,1,0,0,2,0.666667,0.75,0
6838,,,sendaiboy1207,0,1,1,0,1,1,0,0,2,0.666667,0.75,0
6839,,,Monbebe84481807,0,1,1,0,1,1,0,0,2,0.666667,0.75,0
6840,,,AhmadAbdullahN7,0,1,1,0,1,1,0,0,2,0.666667,0.75,0
6841,,,ntamyc,0,2,2,0,2,2,0,0,1,1,1,0
6842,,,maybmustbjackie,0,2,2,0,2,2,0,0,1,1,1,0
6843,,,MeganHa67480315,0,1,1,0,1,1,0,0,1,1,1,0
6844,,,isudasabi,0,1,1,0,1,1,0,0,1,1,1,0
6845,,,errthingoes1,0,1,1,0,1,1,0,0,1,1,1,0
6846,,,Reply1983,14,1,15,14,1,15,0.071429,0.096347,0,0,0,0
6847,,,ilyvelvetshidae,0,1,1,0,1,1,0,0,1,1,1,0
6848,,,Mikeekpo,0,1,1,0,1,1,0,0,1,1,1,0
6849,,,lanisoltae,0,1,1,0,1,1,0,0,1,1,1,0
6850,,,AhbunBkk,0,1,1,0,1,1,0,0,1,1,1,0
6851,,,__YUKAchin1211,0,1,1,0,1,1,0,0,1,1,1,0
6852,,,tcl6qVs4HZaU6YP,0,1,1,0,1,1,0,0,1,1,1,0
6853,,,gennrt,0,3,3,0,3,3,0,0,1,1,1,0
6854,,,ainazzman,0,1,1,0,1,1,0,0,1,1,1,0
6855,,,yzlhycyymarli,0,1,1,0,1,1,0,0,1,1,1,0
6856,,,ShannonS1013,0,1,1,0,1,1,0,0,1,1,1,0
6857,,,ikuyaz0,0,1,1,0,1,1,0,0,2,0.666667,0.75,0
6858,,,GJoshOddo,0,1,1,0,1,1,0,0,2,0.666667,0.75,0
6859,,,syldrey,8,1,9,9,2,11,0.125,0.062292,0,0,0,0
6860,,,yasinoki1207,0,1,1,0,1,1,0,0,1,1,1,0
6861,,,RickyAlba17,1,1,2,1,1,2,0,0.006687,0,0,0,0
6862,,,alterNOKIA,0,1,1,0,1,1,0,0,1,1,1,0
6863,,,llily1y,0,1,1,0,1,1,0,0,1,1,1,0
6864,,,misinotaku,0,1,1,0,1,1,0,0,1,1,1,0
6865,,,risa0105yui,0,1,1,0,1,1,0,0,2,0.571429,0.625,0
6866,,,thoushaltduck,2,1,3,2,1,3,0.5,0.013374,0,0,0,0
6867,,,IF_Marigold,0,1,1,0,1,1,0,0,5,0.43662,0.474194,0
6868,,,GymCoaching,3,1,4,3,1,4,0.333333,0.020061,0,0,0,0
6869,,,migscon,0,1,1,0,1,1,0,0,1,1,1,0
6870,,,parzivalvale,0,2,2,0,2,2,0,0,1,1,1,0
6871,,,RenatoTojol,0,1,1,0,1,1,0,0,1,1,1,0
6872,,,BeaDeeH,3,1,4,3,1,4,0.333333,0.020061,0,0,0,0
6873,,,3wawawww,0,1,1,0,1,1,0,0,1,1,1,0
6874,,,TrillerXochi20,0,1,1,0,1,1,0,0,1,1,1,0
6875,,,nyeeeeett,1,1,2,1,1,2,0,0.006687,0,0,0,0
6876,,,atlantaoly,1,1,2,2,2,4,0,0.006687,0,0,0,0
6877,,,TBGDAILY,3,1,4,3,1,4,0.333333,0.020061,0,0,0,0
6878,,,akekaise,0,13,13,0,19,19,0,0,3,0.8,0.895833,0
6879,,,next_china,1,1,2,1,1,2,0,0.006687,0,0,0,0
6880,,,elissetennis,0,1,1,0,1,1,0,0,1,1,1,0
6881,,,Sportslaw_Asser,0,1,1,0,1,1,0,0,1,1,1,0
6882,,,_chimm_chimmy,0,1,1,0,1,1,0,0,1,1,1,0
6883,,,juriandhanyu,0,1,1,0,1,1,0,0,1,1,1,0
6884,,,imajinasong,0,1,1,0,1,1,0,0,1,1,1,0
6885,,,chibalro,0,1,1,0,1,1,0,0,1,1,1,0
6886,,,Empath_Coach_RR,0,2,2,0,2,2,0,0,1,1,1,0
6887,,,anarcobuffon,5,1,6,5,1,6,0.2,0.033436,0,0,0,0
6888,,,baexolife,0,1,1,0,1,1,0,0,1,1,1,0
6889,,,Jessie_YUZURU,0,1,1,0,1,1,0,0,1,1,1,0
6890,,,tonypol89418698,0,1,1,0,1,1,0,0,1,1,1,0
6891,,,BtchBe,0,1,1,0,1,1,0,0,1,1,1,0
6892,,,dinosolostan,2,1,3,2,1,3,0.5,0.013374,0,0,0,0
6893,,,NomiaIqbal,0,1,1,0,1,1,0,0,1,1,1,0
6894,,,jphilli88,10,1,11,11,2,13,0.1,0.077354,0,0,0,0
6895,,,essy917,0,1,1,0,1,1,0,0,1,1,1,0
6896,,,PremSaiGG,0,1,1,0,1,1,0,0,1,1,1,0
6897,,,emperorjoonie,0,2,2,0,2,2,0,0,1,1,1,0
6898,,,lgbtkoko,0,1,1,0,1,1,0,0,1,1,1,0
6899,,,alejandrinito1,0,1,1,0,1,1,0,0,1,1,1,0
6900,,,fuwayuzupi,0,1,1,0,1,1,0,0,1,1,1,0
6901,,,bubutwts,0,1,1,0,1,1,0,0,5,0.43662,0.474194,0
6902,,,aIienagenda,0,1,1,0,1,1,0,0,5,0.43662,0.474194,0
6903,,,Bravo6022,0,1,1,0,1,1,0,0,1,1,1,0
6904,,,BAE9KHYUN,0,1,1,0,1,1,0,0,1,1,1,0
6905,,,KittyzFluffy,2,3,5,2,3,5,0.25,0.013374,2,0.666667,0.75,4
6906,,,BloombergAsia,1,1,2,1,1,2,0,0.006687,0,0,0,0
6907,,,Karyi789Yolanda,4,1,5,4,1,5,0.25,0.026749,0,0,0,0
6908,,,KarenLTaylor2,0,1,1,0,1,1,0,0,1,1,1,0
6909,,,ImpossibleDana,0,1,1,0,1,1,0,0,1,1,1,0
6910,,,DonnaHa01028499,0,1,1,0,1,1,0,0,1,1,1,0
6911,,,peekabooSHOMA,0,1,1,0,1,1,0,0,1,1,1,0
6912,,,k0reanbigminion,0,1,1,0,1,1,0,0,1,1,1,0
6913,,,yunn_0711yunn,0,1,1,0,1,1,0,0,1,1,1,0
6914,,,YouDontKnowISH_,0,2,2,0,2,2,0,0,1,1,1,0
6915,,,AnderCapa21,3,1,4,3,1,4,0.333333,0.020061,0,0,0,0
6916,,,yuzuci7,0,1,1,0,1,1,0,0,1,1,1,0
6917,,,CarnageMovie,8,1,9,9,2,11,0.125,0.053497,0,0,0,0
6918,,,VOFI_371810,0,1,1,0,1,1,0,0,1,1,1,0
6919,,,quantum1021,0,1,1,0,1,1,0,0,1,1,1,0
6920,,,phiItatoss,9,1,10,9,1,10,0.111111,0.067173,0,0,0,0
6921,,,Vayriss,0,1,1,0,1,1,0,0,1,1,1,0
6922,,,timmykins69,0,1,1,0,1,1,0,0,1,1,1,0
6923,,,tamami50617067,0,1,1,0,1,1,0,0,1,1,1,0
6924,,,mariamartak,0,1,1,0,1,1,0,0,1,1,1,0
6925,,,rrovito,0,1,1,0,1,1,0,0,1,1,1,0
6926,,,PAGilchrist,0,5,5,0,5,5,0,0,1,1,1,0
6927,,,ki_sekiya,0,1,1,0,1,1,0,0,1,1,1,0
6928,,,MushtekN,0,1,1,0,1,1,0,0,1,1,1,0
6929,,,comradejoonte,2,1,3,2,1,3,0.5,0.013374,0,0,0,0
6930,,,DayamoyMaji6,0,1,1,0,1,1,0,0,1,1,1,0
6931,,,pfunkphx,4,1,5,5,1,6,0.25,0.04422,0,0,0,0
6932,,,loveskate1118,0,1,1,0,1,1,0,0,1,1,1,0
6933,,,MichaelG1,0,1,1,0,1,1,0,0,1,1,1,0
6934,,,daeprincesse,0,1,1,0,1,1,0,0,2,0.666667,0.75,0
6935,,,AndyVermaut,15,1,16,18,4,22,0.066667,0.103801,0,0,0,0
6936,,,pdimo21,0,1,1,0,1,1,0,0,1,1,1,0
6937,,,amezaiku_sakura,0,1,1,0,1,1,0,0,1,1,1,0
6938,,,charming_cmplx,0,1,1,0,1,1,0,0,1,1,1,0
6939,,,DesantiNadine,1,1,2,1,1,2,0,0.006687,0,0,0,0
6940,,,g_hfangirl,0,7,7,0,7,7,0,0,2,0.888889,0.9375,0
6941,,,MEYYAPPANMD,0,1,1,0,1,1,0,0,1,1,1,0
6942,,,baicuo,3,1,4,3,1,4,0,0.035231,1,1,1,11
6943,,,leylaseagull,0,1,1,0,1,1,0,0,1,1,1,0
6944,,,pmcg,10,1,11,10,1,11,0.1,0.150068,0,0,0,0
6945,,,loafer68012870,0,1,1,0,1,1,0,0,1,1,1,0
6946,,,LunePero,0,1,1,0,1,1,0,0,1,1,1,0
6947,,,Hawkwoood,0,1,1,0,1,1,0,0,1,1,1,0
6948,,,VIPTRBL9,0,1,1,0,1,1,0,0,1,1,1,0
6949,,,futky0909,0,1,1,0,1,1,0,0,1,1,1,0
6950,,,kinanisreel,0,1,1,0,1,1,0,0,1,1,1,0
6951,,,chalmersdavidn,19,1,20,20,1,21,0.052632,0.144527,0,0,0,0
6952,,,ohwattafuck,0,1,1,0,1,1,0,0,1,1,1,0
6953,,,sweetgoos,0,1,1,0,1,1,0,0,1,1,1,0
6954,,,peonybookmark,0,1,1,0,1,1,0,0,1,1,1,0
6955,,,YuzuKitty12,0,1,1,0,1,1,0,0,1,1,1,0
6956,,,laydom7,0,1,1,0,1,1,0,0,1,1,1,0
6957,,,k1ttyjohnny,0,1,1,0,1,1,0,0,1,1,1,0
6958,,,pluto162,0,1,1,0,1,1,0,0,1,1,1,0
6959,,,narrwett,0,1,1,0,1,1,0,0,1,1,1,0
6960,,,runenotwt,0,1,1,0,2,2,0,0,1,1,1,0
6961,,,neverbackspaceu,0,1,1,0,1,1,0,0,1,1,1,0
6962,,,_MeiZzz_,0,2,2,0,2,2,0,0,1,1,1,0
6963,,,toymarte,1,1,2,1,1,2,0,0.006687,0,0,0,0
6964,,,lamine_54,0,1,1,0,1,1,0,0,1,1,1,0
6965,,,okjunca,0,1,1,0,1,1,0,0,1,1,1,0
6966,,,hgjworshipper,2,1,3,2,1,3,0.5,0.013374,0,0,0,0
6967,,,reiayanami0002,0,1,1,0,1,1,0,0,1,1,1,0
6968,,,colossalbimbo,1,1,2,1,1,2,0,0.006687,0,0,0,0
6969,,,CgarlicL,0,1,1,0,1,1,0,0,1,1,1,0
6970,,,TODUCSg,0,1,1,0,1,1,0,0,1,1,1,0
6971,,,blockelf24,0,1,1,0,1,1,0,0,1,1,1,0
6972,,,pearllshinee,0,1,1,0,1,1,0,0,1,1,1,0
6973,,,ae4ca,0,2,2,0,2,2,0,0,1,1,1,0
6974,,,saori_pinoco,0,1,1,0,1,1,0,0,1,1,1,0
6975,,,All_OverVuitton,0,1,1,0,1,1,0,0,1,1,1,0
6976,,,freddiloves,0,1,1,0,1,1,0,0,1,1,1,0
6977,,,CeluloidDoLiver,0,1,1,0,1,1,0,0,1,1,1,0
6978,,,nikochuufcker,0,1,1,0,1,1,0,0,1,1,1,0
6979,,,yzgold11,0,1,1,0,1,1,0,0,1,1,1,0
6980,,,chuuyassoulmate,0,1,1,0,1,1,0,0,1,1,1,0
6981,,,_CoolStoryCori_,0,1,1,0,1,1,0,0,1,1,1,0
6982,,,2dogknight,0,1,1,0,1,1,0,0,1,1,1,0
6983,,,LOONAOHYE2,0,1,1,0,1,1,0,0,2,0.571429,0.625,0
6984,,,AmandaS71123856,0,1,1,0,1,1,0,0,2,0.571429,0.625,0
6985,,,DLaberius,0,1,1,0,1,1,0,0,1,1,1,0
6986,,,gl0bal_feed,6,1,7,6,1,7,0.166667,0.040123,0,0,0,0
6987,,,CalZole,0,1,1,0,1,1,0,0,1,1,1,0
6988,,,dingorocketship,0,1,1,0,1,1,0,0,1,1,1,0
6989,,,indignindigente,0,1,1,0,1,1,0,0,1,1,1,0
6990,,,jmr1513,0,1,1,0,1,1,0,0,1,1,1,0
6991,,,bizkoocho,0,1,1,0,1,1,0,0,2,0.571429,0.625,0
6992,,,msdands,4,1,5,4,1,5,0.25,0.089645,0,0,0,0
6993,,,AngieGLaw,0,1,1,0,1,1,0,0,1,1,1,0
6994,,,caroleannmarie,4,1,5,5,1,6,0.25,0.026749,0,0,0,0
6995,,,yvesIaurents,3,2,5,3,2,5,0.25,0.020061,1,1,1,2
6996,,,zhennituoaini,0,1,1,0,1,1,0,0,2,0.666667,0.75,0
6997,,,Chloeminh511,4,1,5,4,1,5,0.25,0.026749,0,0,0,0
6998,,,riff_in_a_space,0,2,2,0,2,2,0,0,1,1,1,0
6999,,,9394EVER,0,1,1,0,1,1,0,0,1,1,1,0
7000,,,BlogdeLalo,2,1,3,3,1,4,0.5,0.013374,0,0,0,0
7001,,,gogo_MN_tea,0,1,1,0,1,1,0,0,1,1,1,0
7002,,,KRoddrodgers,0,1,1,0,1,1,0,0,1,1,1,0
7003,,,heejinvu,1,1,2,1,1,2,0,0.006687,0,0,0,0
7004,,,np_sabrinasth,0,1,1,0,2,2,0,0,2,0.666667,0.75,0
7005,,,reXTsAnsIG2B8zy,0,1,1,0,1,1,0,0,2,0.666667,0.75,0
7006,,,monmon1112,0,1,1,0,1,1,0,0,2,0.666667,0.75,0
7007,,,twokopi,1,1,2,1,1,2,0,0.006687,0,0,0,0
7008,,,Drkkrw1,0,1,1,0,1,1,0,0,1,1,1,0
7009,,,FLIGHTofINQUIRY,0,1,1,0,1,1,0,0,1,1,1,0
7010,,,sportsreno,4,1,5,4,1,5,0.25,0.026749,0,0,0,0
7011,,,CruisingCathy,0,1,1,0,1,1,0,0,1,1,1,0
7012,,,finallyiiigotit,0,2,2,0,2,2,0,0,2,0.75,0.833333,0
7013,,,u_za_momo,0,1,1,0,1,1,0,0,1,1,1,0
7014,,,MikerovaMaria,2,1,3,2,1,3,0.5,0.013374,0,0,0,0
7015,,,nflving,0,1,1,0,1,1,0,0,1,1,1,0
7016,,,ChloeLauren5,0,1,1,0,1,1,0,0,1,1,1,0
7017,,,hiitsarpita,0,1,1,0,1,1,0,0,1,1,1,0
7018,,,bluesabiru,0,1,1,0,1,1,0,0,1,1,1,0
7019,,,JunShang761984,0,1,1,0,1,1,0,0,1,1,1,0
7020,,,SCXRLTWTCH,0,1,1,0,1,1,0,0,1,1,1,0
7021,,,steve0george,0,1,1,0,1,1,0,0,1,1,1,0
7022,,,marniefel41,0,3,3,0,3,3,0,0,3,0.47619,0.533333,0
7023,,,peacehyos,0,1,1,0,1,1,0,0,1,1,1,0
7024,,,misako9,0,1,1,0,1,1,0,0,1,1,1,0
7025,,,248sajako,3,1,4,3,1,4,0.333333,0.020061,0,0,0,0
7026,,,SiNNy35_,0,1,1,0,1,1,0,0,1,1,1,0
7027,,,komi4loflza,0,1,1,0,1,1,0,0,1,1,1,0
7028,,,GusuCloud,0,1,1,0,1,1,0,0,1,1,1,0
7029,,,marobaudelaire,0,1,1,0,1,1,0,0,1,1,1,0
7030,,,kyssameJo,1,1,2,1,1,2,0,0.006687,0,0,0,0
7031,,,susanwright57,2,1,3,2,1,3,0.5,0.013374,0,0,0,0
7032,,,jamesamcgee,1,1,2,1,1,2,0,0.006687,0,0,0,0
7033,,,kaechantnns0812,0,2,2,0,2,2,0,0,2,0.75,0.833333,0
7034,,,17_aryaa,0,1,1,0,1,1,0,0,2,0.666667,0.75,0
7035,,,luv_172cm_154cm,0,1,1,0,1,1,0,0,2,0.666667,0.75,0
7036,,,kaizen1k,0,1,1,0,1,1,0,0,2,0.666667,0.75,0
7037,,,JeanNabat,6,1,7,6,1,7,0.166667,0.071571,0,0,0,0
7038,,,batgjrls,0,1,1,0,1,1,0,0,1,1,1,0
7039,,,FUNNAGAN,0,2,2,0,2,2,0,0,1,1,1,0
7040,,,CindyWan19,0,1,1,0,1,1,0,0,1,1,1,0
7041,,,InlustrisMedia,0,1,1,0,1,1,0,0,1,1,1,0
7042,,,AlexaAinsworth,0,1,1,0,1,1,0,0,1,1,1,0
7043,,,OicOzzie,10,2,12,11,3,14,0.090909,0.066871,1,1,1,9
7044,,,Criticalanglez,4,1,5,4,1,5,0.25,0.03493,0,0,0,0
7045,,,bladdicts20,0,1,1,0,1,1,0,0,1,1,1,0
7046,,,sushipenguin_,0,1,1,0,1,1,0,0,1,1,1,0
7047,,,captainlvrson,12,1,13,12,1,13,0.083333,0.087234,0,0,0,0
7048,,,wahinertraveler,0,1,1,0,1,1,0,0,1,1,1,0
7049,,,taiga26_7,0,1,1,0,1,1,0,0,1,1,1,0
7050,,,Anderlinq2,0,1,1,0,1,1,0,0,1,1,1,0
7051,,,kamire20,0,1,1,0,1,1,0,0,1,1,1,0
7052,,,nako_luvyzr,0,1,1,0,1,1,0,0,1,1,1,0
7053,,,tatiana_and_tea,0,1,1,0,1,1,0,0,1,1,1,0
7054,,,HANANGEBILY2,4,1,5,4,1,5,0.25,0.026749,0,0,0,0
7055,,,marianneflynn15,0,1,1,0,1,1,0,0,1,1,1,0
7056,,,ptotcnc3,0,1,1,0,1,1,0,0,1,1,1,0
7057,,,_petertingle,0,1,1,0,1,1,0,0,1,1,1,0
7058,,,emisakuau,0,1,1,0,1,1,0,0,1,1,1,0
7059,,,gonzo_30531,0,2,2,0,2,2,0,0,1,1,1,0
7060,,,TT9BP,0,1,1,0,1,1,0,0,1,1,1,0
7061,,,ObermuellerMike,0,1,1,0,1,1,0,0,1,1,1,0
7062,,,amybrewster2016,2,1,3,2,1,3,0.5,0.069282,0,0,0,0
7063,,,rockstarceosu,0,1,1,0,1,1,0,0,1,1,1,0
7064,,,lastresovejas,0,2,2,0,2,2,0,0,1,1,1,0
7065,,,carbon_deborah,5,1,6,6,1,7,0.2,0.033436,0,0,0,0
7066,,,rkriverachas,0,2,2,0,3,3,0,0,1,1,1,0
7067,,,RNewsmap,0,1,1,0,1,1,0,0,1,1,1,0
7068,,,sheepadoodle127,0,2,2,0,2,2,0,0,1,1,1,0
7069,,,Brielle09586269,2,1,3,3,2,5,0.5,0.013374,0,0,0,0
7070,,,BIGDADDYKAIIII,0,1,1,0,1,1,0,0,1,1,1,0
7071,,,prodby2do,2,2,4,2,2,4,0.333333,0.013374,1,1,1,1
7072,,,s4q04zrMVwuDdja,0,1,1,0,1,1,0,0,2,0.666667,0.75,0
7073,,,chamisuika,0,1,1,0,1,1,0,0,1,1,1,0
7074,,,idioticbipolar,5,1,6,6,1,7,0.2,0.033436,0,0,0,0
7075,,,jewjewcat,0,1,1,0,2,2,0,0,1,1,1,0
7076,,,ckafura,0,1,1,0,1,1,0,0,1,1,1,0
7077,,,Jennie_Styes,0,1,1,0,1,1,0,0,1,1,1,0
7078,,,BettyGilpin2,1,1,2,1,1,2,0,0.006687,0,0,0,0
7079,,,mcbmnf,22,8,30,26,12,38,0.036946,0.169889,1,1,1,178
7080,,,yimjuthipong,6,1,7,7,1,8,0.2,0.130906,0,0,0,0
7081,,,nattnit_,3,2,5,3,2,5,0,0.01188,1,1,1,6
7082,,,kaeyaragnvindr,0,1,1,0,1,1,0,0,1,1,1,0
7083,,,Riiiita42,0,1,1,0,1,1,0,0,1,1,1,0
7084,,,Ruu0823,0,3,3,0,3,3,0,0,1,1,1,0
7085,,,tetegoodboy,0,1,1,0,1,1,0,0,1,1,1,0
7086,,,aleatoirement,0,1,1,0,1,1,0,0,1,1,1,0
7087,,,triantafyllidi2,4,1,5,4,1,5,0.25,0.026749,0,0,0,0
7088,,,robearto777,0,1,1,0,1,1,0,0,1,1,1,0
7089,,,Osmanthus_2020,0,1,1,0,1,1,0,0,1,1,1,0
7090,,,ckaminsk,0,1,1,0,1,1,0,0,3,0.4,0.472222,0
7091,,,socialitelife,8,1,9,9,2,11,0.125,0.060486,0,0,0,0
7092,,,kwysxz,0,1,1,0,1,1,0,0,1,1,1,0
7093,,,korl__,0,1,1,0,1,1,0,0,1,1,1,0
7094,,,chicconeri,0,1,1,0,1,1,0,0,1,1,1,0
7095,,,bar_piromi,0,1,1,0,1,1,0,0,2,0.533333,0.5625,0
7096,,,flowerpower3234,0,1,1,0,1,1,0,0,2,0.533333,0.5625,0
7097,,,hamstar55,0,1,1,0,1,1,0,0,2,0.533333,0.5625,0
7098,,,sulmanqamar,0,1,1,0,1,1,0,0,2,0.533333,0.5625,0
7099,,,spicyenjolras,3,1,4,5,1,6,0.333333,0.028857,0,0,0,0
7100,,,stunningselmg,0,1,1,0,1,1,0,0,1,1,1,0
7101,,,SarahImesBorden,1,1,2,1,1,2,0,0.006687,0,0,0,0
7102,,,twlvclara,0,1,1,0,1,1,0,0,1,1,1,0
7103,,,WillSnowboard,7,1,8,7,1,8,0.142857,0.129412,0,0,0,0
7104,,,kerrytracn,0,2,2,0,2,2,0,0,1,1,1,0
7105,,,biscaye69,0,1,1,0,1,1,0,0,1,1,1,0
7106,,,Gwydion620,0,1,1,0,1,1,0,0,1,1,1,0
7107,,,ayakoron6,0,2,2,0,2,2,0,0,1,1,1,0
7108,,,Julia_Famularo,0,1,1,0,1,1,0,0,1,1,1,0
7109,,,liiisacha,0,1,1,0,1,1,0,0,1,1,1,0
7110,,,Lauren64278397,9,1,10,9,1,10,0.125,0.151581,0,0,0,0
7111,,,catskittyns,0,1,1,0,1,1,0,0,1,1,1,0
7112,,,gobigorgonyumba,0,2,2,0,2,2,0,0,1,1,1,0
7113,,,hanahannao,0,2,2,0,2,2,0,0,1,1,1,0
7114,,,Rachell22699470,0,1,1,0,1,1,0,0,1,1,1,0
7115,,,ballcock_shot,7,1,8,7,1,8,0.142857,0.130007,0,0,0,0
7116,,,mumitalo,0,1,1,0,1,1,0,0,1,1,1,0
7117,,,PPD3066,0,1,1,0,1,1,0,0,1,1,1,0
7118,,,kakera_06,0,2,2,0,2,2,0,0,1,1,1,0
7119,,,jlints58,0,2,2,0,3,3,0,0,1,1,1,0
7120,,,uyyksoo,0,1,1,0,1,1,0,0,1,1,1,0
7121,,,J3675L,0,1,1,0,1,1,0,0,1,1,1,0
7122,,,Marco_YS35,0,1,1,0,1,1,0,0,1,1,1,0
7123,,,AmiliaSun,0,1,1,0,1,1,0,0,1,1,1,0
7124,,,0703nina,0,1,1,0,1,1,0,0,1,1,1,0
7125,,,hiikarinnnn,0,1,1,0,1,1,0,0,1,1,1,0
7126,,,jongseongfever,0,1,1,0,1,1,0,0,1,1,1,0
7127,,,peachymamaki,3,1,4,3,1,4,0.333333,0.028857,0,0,0,0
7128,,,iamveep007,0,1,1,0,1,1,0,0,1,1,1,0
7129,,,Nanami1l,0,1,1,0,1,1,0,0,4,0.384615,0.483333,0
7130,,,YaYa47468866,0,1,1,0,1,1,0,0,4,0.384615,0.483333,0
7131,,,martyvidnovic,2,1,3,2,1,3,0.5,0.013374,0,0,0,0
7132,,,y_shuyu,0,1,1,0,1,1,0,0,1,1,1,0
7133,,,phucprime,2,1,3,3,2,5,0.5,0.013374,0,0,0,0
7134,,,Educ8tusAll,1,1,2,1,1,2,0,0.006687,0,0,0,0
7135,,,BelleVoix321,7,1,8,7,1,8,0.142857,0.054992,0,0,0,0
7136,,,ohaewenthusiast,0,1,1,0,1,1,0,0,1,1,1,0
7137,,,jcmr21,0,1,1,0,1,1,0,0,1,1,1,0
7138,,,allegro572,0,2,2,0,2,2,0,0,1,1,1,0
7139,,,Architecks1,0,1,1,0,1,1,0,0,1,1,1,0
7140,,,dahpinks,0,1,1,0,1,1,0,0,1,1,1,0
7141,,,Skyebright8,0,2,2,0,2,2,0,0,1,1,1,0
7142,,,laborunion_,0,1,1,0,1,1,0,0,1,1,1,0
7143,,,iamjan123,0,1,1,0,1,1,0,0,1,1,1,0
7144,,,SVolkovOfficial,0,1,1,0,1,1,0,0,1,1,1,0
7145,,,AndrewOHazard,4,1,5,4,1,5,0.25,0.026749,0,0,0,0
7146,,,stu88545,0,1,1,0,1,1,0,0,1,1,1,0
7147,,,BaliaMarie,0,1,1,0,1,1,0,0,1,1,1,0
7148,,,TheBoboDemon,0,1,1,0,1,1,0,0,1,1,1,0
7149,,,fotosoto,11,1,12,13,2,15,0.090909,0.087535,0,0,0,0
7150,,,prblzz,0,1,1,0,1,1,0,0,1,1,1,0
7151,,,AothmanL,0,5,5,0,5,5,0,0,1,1,1,0
7152,,,AlanGamino1997,0,1,1,0,1,1,0,0,1,1,1,0
7153,,,kathawaii1,0,1,1,0,1,1,0,0,1,1,1,0
7154,,,su1_345_3a4t,0,1,1,0,1,1,0,0,1,1,1,0
7155,,,yyc_dom,0,1,1,0,1,1,0,0,1,1,1,0
7156,,,YaoShunli,10,1,11,11,1,12,0.1,0.07386,0,0,0,0
7157,,,ohemaadufiegh,0,7,7,0,7,7,0,0,2,0.888889,0.9375,0
7158,,,ireneelam,0,1,1,0,1,1,0,0,1,1,1,0
7159,,,tmh2923,0,1,1,0,1,1,0,0,1,1,1,0
7160,,,Dreamofrainbow4,0,1,1,0,1,1,0,0,1,1,1,0
7161,,,boobookittie2,0,1,1,0,1,1,0,0,1,1,1,0
7162,,,andrea_vdebil98,0,1,1,0,1,1,0,0,1,1,1,0
7163,,,angella6002,0,2,2,0,2,2,0,0,1,1,1,0
7164,,,OneTexan2,0,1,1,0,1,1,0,0,1,1,1,0
7165,,,AmandaDC_Art,0,1,1,0,1,1,0,0,1,1,1,0
7166,,,ajthedonut,0,1,1,0,1,1,0,0,1,1,1,0
7167,,,malia_exe,0,1,1,0,1,1,0,0,1,1,1,0
7168,,,makis7121,0,2,2,0,2,2,0,0,1,1,1,0
7169,,,WcPBlog,2,1,3,2,1,3,0.5,0.013374,0,0,0,0
7170,,,PrettyGirlMisha,0,1,1,0,1,1,0,0,1,1,1,0
7171,,,troiashi,3,1,4,3,1,4,0.333333,0.103258,0,0,0,0
7172,,,mackyramos,0,1,1,0,1,1,0,0,1,1,1,0
7173,,,KClvr10,2,1,3,2,1,3,0.5,0.013374,0,0,0,0
7174,,,savybz,0,1,1,0,1,1,0,0,1,1,1,0
7175,,,BirdOwl,2,1,3,3,2,5,0.5,0.013374,0,0,0,0
7176,,,SarcasticCupcak,7,3,10,7,3,10,0.111111,0.04681,1,1,1,12
7177,,,Gregoryokay,0,1,1,0,1,1,0,0,2,0.6,0.666667,0
7178,,,itsWanda,0,1,1,0,1,1,0,0,2,0.6,0.666667,0
7179,,,gayswordfight,0,1,1,0,1,1,0,0,2,0.6,0.666667,0
7180,,,missb62,0,1,1,0,1,1,0,0,2,0.6,0.666667,0
7181,,,tesdaniele,3,1,4,3,1,4,0.333333,0.020061,0,0,0,0
7182,,,LavenderHoodies,0,1,1,0,1,1,0,0,1,1,1,0
7183,,,markmelonlee,0,1,1,0,1,1,0,0,1,1,1,0
7184,,,hjq8888889,2,1,3,3,2,5,0.5,0.013374,0,0,0,0
7185,,,AlloyRedd,1,1,2,1,1,2,0,0.006687,0,0,0,0
7186,,,mariahblackpink,14,1,15,14,1,15,0.071429,0.09362,0,0,0,0
7187,,,yim_chimonac,0,1,1,0,1,1,0,0,1,1,1,0
7188,,,KodyLakewood,0,1,1,0,1,1,0,0,1,1,1,0
7189,,,tonnansha_pe,0,1,1,0,1,1,0,0,1,1,1,0
7190,,,ateezsure,0,2,2,0,2,2,0,0,2,0.75,0.833333,0
7191,,,motorcityd313,0,1,1,0,1,1,0,0,1,1,1,0
7192,,,ClareFKing,0,1,1,0,1,1,0,0,1,1,1,0
7193,,,SesshaChan,0,1,1,0,1,1,0,0,1,1,1,0
7194,,,FBtEvSGhf1gW6pg,0,1,1,0,1,1,0,0,1,1,1,0
7195,,,GOLPSELU,0,1,1,0,1,1,0,0,1,1,1,0
7196,,,TDoyleCarasol,0,1,1,0,1,1,0,0,1,1,1,0
7197,,,ty8nglvr,0,1,1,0,1,1,0,0,1,1,1,0
7198,,,ilya_jnu,2,1,3,2,1,3,0.5,0.013374,0,0,0,0
7199,,,dpdioibqb,0,1,1,0,1,1,0,0,1,1,1,0
7200,,,Beverlyb11,0,1,1,0,1,1,0,0,1,1,1,0
7201,,,PolloFrito89,0,1,1,0,1,1,0,0,1,1,1,0
7202,,,sadam08499791,0,1,1,0,1,1,0,0,1,1,1,0
7203,,,midnight_sth,0,1,1,0,1,1,0,0,1,1,1,0
7204,,,namgod94,0,1,1,0,1,1,0,0,1,1,1,0
7205,,,Kao50090785,0,1,1,0,1,1,0,0,1,1,1,0
7206,,,KATEBR1DGERTON,1,1,2,1,1,2,0,0.006687,0,0,0,0
7207,,,jooilong,3,1,4,3,1,4,0.333333,0.020061,0,0,0,0
7208,,,nanteos620,0,1,1,0,1,1,0,0,1,1,1,0
7209,,,Butongkie89,0,1,1,0,1,1,0,0,1,1,1,0
7210,,,ElisePinkard,0,1,1,0,1,1,0,0,1,1,1,0
7211,,,PointMHD,0,1,1,0,1,1,0,0,1,1,1,0
7212,,,AuwalunDabai,0,1,1,0,1,1,0,0,1,1,1,0
7213,,,tristan_zayn,0,1,1,0,1,1,0,0,1,1,1,0
7214,,,hooey_h,0,1,1,0,1,1,0,0,1,1,1,0
7215,,,pinkbunnyr,4,1,5,4,1,5,0.25,0.026749,0,0,0,0
7216,,,NimerSports,0,1,1,0,1,1,0,0,1,1,1,0
7217,,,Charlenegapeach,0,2,2,0,2,2,0,0,1,1,1,0
7218,,,diana180,3,1,4,3,1,4,0.333333,0.020061,0,0,0,0
7219,,,portraitofxiu,0,1,1,0,1,1,0,0,1,1,1,0
7220,,,counttillbiden,0,1,1,0,1,1,0,0,1,1,1,0
7221,,,durian_lucky,0,1,1,0,1,1,0,0,1,1,1,0
7222,,,davidblaiseg,0,1,1,0,1,1,0,0,1,1,1,0
7223,,,Suzume_chan007,0,1,1,0,1,1,0,0,1,1,1,0
7224,,,Legit_Glow,0,1,1,0,1,1,0,0,1,1,1,0
7225,,,GgSvetik,0,1,1,0,1,1,0,0,1,1,1,0
7226,,,Sharonisyourgod,0,1,1,0,1,1,0,0,1,1,1,0
7227,,,330_43_snow,0,2,2,0,2,2,0,0,1,1,1,0
7228,,,djradar,0,2,2,0,2,2,0,0,1,1,1,0
7229,,,layxingsheep,1,1,2,1,1,2,0,0.006687,0,0,0,0
7230,,,AkitaNanami7,6,1,7,6,1,7,0.166667,0.040123,0,0,0,0
7231,,,AaravPa15591904,0,1,1,0,1,1,0,0,1,1,1,0
7232,,,joon_univrs,0,1,1,0,1,1,0,0,1,1,1,0
7233,,,IPhamx364,0,1,1,0,1,1,0,0,1,1,1,0
7234,,,GH_Narrator,0,1,1,0,1,1,0,0,1,1,1,0
7235,,,yizhanbb,0,1,1,0,1,1,0,0,1,1,1,0
7236,,,anheliccaa,0,2,2,0,2,2,0,0,2,0.75,0.833333,0
7237,,,CarolLaRue,0,1,1,0,1,1,0,0,1,1,1,0
7238,,,Catheri36455257,0,1,1,0,1,1,0,0,1,1,1,0
7239,,,hookpinkies,3,1,4,3,1,4,0.333333,0.020061,0,0,0,0
7240,,,JohnZim73164987,0,1,1,0,1,1,0,0,1,1,1,0
7241,,,samyzzy1207,0,1,1,0,1,1,0,0,2,0.666667,0.75,0
7242,,,yrproperties,8,1,9,10,3,13,0.125,0.053497,0,0,0,0
7243,,,justjen03,3,1,4,3,1,4,0.333333,0.020061,0,0,0,0
7244,,,tiigfox,0,1,1,0,1,1,0,0,1,1,1,0
7245,,,jrbkjrbk,0,1,1,0,1,1,0,0,1,1,1,0
7246,,,mangodejun,4,1,5,6,2,8,0.25,0.026749,0,0,0,0
7247,,,Yamadayouuji,1,1,2,1,1,2,0,0.006687,0,0,0,0
7248,,,jdspn_radio,5,1,6,5,1,6,0.2,0.068378,0,0,0,0
7249,,,lalouis7,0,1,1,0,1,1,0,0,1,1,1,0
7250,,,GAVIN_chazhi,0,1,1,0,1,1,0,0,1,1,1,0
7251,,,mingitime,2,1,3,2,1,3,0.5,0.013374,0,0,0,0
7252,,,0111Lycoris,0,1,1,0,1,1,0,0,1,1,1,0
7253,,,ringle_archive,6,1,7,6,1,7,0.166667,0.040123,0,0,0,0
7254,,,kanagon95,0,1,1,0,1,1,0,0,1,1,1,0
7255,,,southirIwall,0,1,1,0,1,1,0,0,1,1,1,0
7256,,,ksumeloman,0,1,1,0,1,1,0,0,1,1,1,0
7257,,,k_ro150cm,0,1,1,0,1,1,0,0,1,1,1,0
7258,,,OzgunRad,0,1,1,0,1,1,0,0,1,1,1,0
7259,,,lolerademierda,0,1,1,0,1,1,0,0,1,1,1,0
7260,,,LTroche58,0,1,1,0,1,1,0,0,1,1,1,0
7261,,,kirstenfrankly,0,1,1,0,1,1,0,0,2,0.666667,0.75,0
7262,,,JimothyTelsen,4,1,5,4,1,5,0.25,0.026749,0,0,0,0
7263,,,anaiduza,0,1,1,0,1,1,0,0,1,1,1,0
7264,,,PYGOSCELIS_BSK,0,1,1,0,1,1,0,0,1,1,1,0
7265,,,Erping,8,1,9,8,1,9,0.125,0.053497,0,0,0,0
7266,,,bebe_luvs2,0,1,1,0,1,1,0,0,1,1,1,0
7267,,,jonginsavedm3,0,1,1,0,1,1,0,0,1,1,1,0
7268,,,PATRICKCNN,0,1,1,0,1,1,0,0,1,1,1,0
7269,,,cawgeyamas,0,1,1,0,1,1,0,0,1,1,1,0
7270,,,Pol_Bohemian,0,1,1,0,1,1,0,0,1,1,1,0
7271,,,wjtshinimendbab,13,1,14,13,1,14,0.076923,0.095728,0,0,0,0
7272,,,msk_min,0,1,1,0,1,1,0,0,1,1,1,0
7273,,,nohausaufgaben,0,1,1,0,1,1,0,0,1,1,1,0
7274,,,lifeofmrkim,0,1,1,0,1,1,0,0,1,1,1,0
7275,,,AceOutWide,0,1,1,0,1,1,0,0,1,1,1,0
7276,,,CYP20103w,0,1,1,0,1,1,0,0,1,1,1,0
7277,,,Yoongvantata,0,1,1,0,1,1,0,0,1,1,1,0
7278,,,HavelLois,0,1,1,0,1,1,0,0,1,1,1,0
7279,,,therealjasonjia,0,1,1,0,1,1,0,0,1,1,1,0
7280,,,briarbeastie,0,1,1,0,1,1,0,0,1,1,1,0
7281,,,brassfrog,0,1,1,0,1,1,0,0,1,1,1,0
7282,,,0019nagatan,0,1,1,0,1,1,0,0,1,1,1,0
7283,,,itsmelililala,0,1,1,0,1,1,0,0,1,1,1,0
7284,,,SouzaEluam,0,4,4,0,4,4,0,0,1,1,1,0
7285,,,Kinoti_yang,7,1,8,7,1,8,0.142857,0.04681,0,0,0,0
7286,,,chxrryjimim,0,1,1,0,1,1,0,0,1,1,1,0
7287,,,naminamijoon,0,1,1,0,1,1,0,0,1,1,1,0
7288,,,awelab1956,0,1,1,0,1,1,0,0,1,1,1,0
7289,,,hwastae,0,1,1,0,1,1,0,0,1,1,1,0
7290,,,VatKMimi,0,1,1,0,1,1,0,0,1,1,1,0
7291,,,DuchessVan,3,2,5,3,2,5,0.25,0.103258,1,1,1,27
7292,,,shouxiiao,0,1,1,0,1,1,0,0,2,0.666667,0.75,0
7293,,,thecaptrio,1,1,2,1,1,2,0,0.006687,0,0,0,0
7294,,,PianoGeekRedux,4,1,5,4,1,5,0.25,0.026749,0,0,0,0
7295,,,_BrownieFairy_,0,1,1,0,1,1,0,0,1,1,1,0
7296,,,Randomschantz,0,1,1,0,1,1,0,0,1,1,1,0
7297,,,TheresaC1231,2,1,3,2,1,3,0.5,0.013374,0,0,0,0
7298,,,CatsMeow78,0,1,1,0,1,1,0,0,1,1,1,0
7299,,,bo_otao,0,1,1,0,1,1,0,0,1,1,1,0
7300,,,WillsMichael45,0,1,1,0,1,1,0,0,1,1,1,0
7301,,,buddy77587,0,1,1,0,1,1,0,0,1,1,1,0
7302,,,amparomeza,0,1,1,0,1,1,0,0,1,1,1,0
7303,,,anna_bahrnana,2,1,3,2,1,3,0.5,0.013374,0,0,0,0
7304,,,monocaeroscaeli,0,1,1,0,1,1,0,0,1,1,1,0
7305,,,kollywood_net,1,1,2,1,1,2,0,0.006687,0,0,0,0
7306,,,PatouisVuitton,7,1,8,7,1,8,0.142857,0.077288,0,0,0,0
7307,,,BatmanNipple,0,2,2,0,2,2,0,0,1,1,1,0
7308,,,thurljawn,0,1,1,0,1,1,0,0,1,1,1,0
7309,,,Farrah_Aqila,0,1,1,0,1,1,0,0,1,1,1,0
7310,,,andyreports,0,1,1,0,1,1,0,0,2,0.666667,0.75,0
7311,,,sachieuhaihanh,1,1,2,1,1,2,0,0.006687,0,0,0,0
7312,,,kaitlynkam11,8,1,9,8,1,9,0.125,0.152358,0,0,0,0
7313,,,Crimsonredwing,0,2,2,0,2,2,0,0,1,1,1,0
7314,,,ironworker3871,0,1,1,0,1,1,0,0,1,1,1,0
7315,,,luiscastros,0,1,1,0,1,1,0,0,1,1,1,0
7316,,,Derique2000,0,1,1,0,1,1,0,0,1,1,1,0
7317,,,Baleofaks,0,1,1,0,1,1,0,0,1,1,1,0
7318,,,jxslynnee,0,1,1,0,1,1,0,0,1,1,1,0
7319,,,laughforkicks,1,1,2,1,1,2,0,0.006687,0,0,0,0
7320,,,anavantee,1,1,2,1,1,2,0,0.006687,0,0,0,0
7321,,,_charliin,0,1,1,0,1,1,0,0,1,1,1,0
7322,,,m0odr1ng,0,1,1,0,1,1,0,0,1,1,1,0
7323,,,saaramirkovic,0,1,1,0,1,1,0,0,1,1,1,0
7324,,,evermoreanddior,1,1,2,1,1,2,0,0.006687,0,0,0,0
7325,,,jasmine_skate,4,1,5,4,1,5,0.25,0.026749,0,0,0,0
7326,,,reimi2017,0,1,1,0,1,1,0,0,1,1,1,0
7327,,,Schoderli,4,1,5,4,1,5,0.25,0.026749,0,0,0,0
7328,,,DavisKyleen,0,1,1,0,1,1,0,0,1,1,1,0
7329,,,markeugene_,2,1,3,2,1,3,0.5,0.013374,0,0,0,0
7330,,,Ritsuko_Lv,0,1,1,0,1,1,0,0,1,1,1,0
7331,,,jekylljorjia,0,1,1,0,1,1,0,0,2,0.538462,0.571429,0
7332,,,h_hiraetth,0,1,1,0,1,1,0,0,2,0.538462,0.571429,0
7333,,,be_bangarang,1,1,2,1,1,2,0,0.006687,0,0,0,0
7334,,,CatiForHeart,14,1,15,31,1,32,0.071429,0.09362,0,0,0,0
7335,,,toki_myeon,0,1,1,0,1,1,0,0,1,1,1,0
7336,,,sequoia2001,0,1,1,0,1,1,0,0,1,1,1,0
7337,,,gimgobiisfree,0,1,1,0,1,1,0,0,1,1,1,0
7338,,,GrupoAquecendo,0,1,1,0,1,1,0,0,1,1,1,0
7339,,,AquecendoBR,0,1,1,0,1,1,0,0,1,1,1,0
7340,,,ACSMtvNetwork,0,1,1,0,1,1,0,0,1,1,1,0
7341,,,StupidIsAsStu20,0,1,1,0,1,1,0,0,1,1,1,0
7342,,,wis_prince,0,1,1,0,1,1,0,0,1,1,1,0
7343,,,elswythe_,4,1,5,5,1,6,0.25,0.026749,0,0,0,0
7344,,,zuceop,0,1,1,0,1,1,0,0,1,1,1,0
7345,,,GinaApostol,2,1,3,2,1,3,0.5,0.013374,0,0,0,0
7346,,,KimberlyBoyer61,3,1,4,6,1,7,0.333333,0.020061,0,0,0,0
7347,,,ausvano,0,1,1,0,1,1,0,0,1,1,1,0
7348,,,sarahhhgray,3,1,4,4,2,6,0.333333,0.020061,0,0,0,0
7349,,,chbbymm,0,2,2,0,3,3,0,0,1,1,1,0
7350,,,NBCLA,18,1,19,26,5,31,0.055556,0.158805,0,0,0,0
7351,,,maryj59,0,1,1,0,1,1,0,0,1,1,1,0
7352,,,louiseway5,11,2,13,11,2,13,0.083333,0.073559,1,1,1,10
7353,,,rslfan4life,0,1,1,0,1,1,0,0,1,1,1,0
7354,,,actuallylilac,0,1,1,0,1,1,0,0,1,1,1,0
7355,,,srpcohi,0,1,1,0,1,1,0,0,1,1,1,0
7356,,,maeselafana,0,1,1,0,1,1,0,0,1,1,1,0
7357,,,10101313Linnea,0,1,1,0,1,1,0,0,1,1,1,0
7358,,,yuzuRadd,0,1,1,0,1,1,0,0,1,1,1,0
7359,,,Dean86446553,0,1,1,0,1,1,0,0,1,1,1,0
7360,,,maki_maru_maki,0,1,1,0,1,1,0,0,1,1,1,0
7361,,,NAZJNX,0,1,1,0,1,1,0,0,1,1,1,0
7362,,,CheekyMark1917,0,1,1,0,1,1,0,0,1,1,1,0
7363,,,ArielleSherbak,0,1,1,0,1,1,0,0,1,1,1,0
7364,,,archpolcarat,0,1,1,0,1,1,0,0,1,1,1,0
7365,,,Frog__Fish,0,1,1,0,1,1,0,0,1,1,1,0
7366,,,honeymilkyway19,0,4,4,0,6,6,0,0,1,1,1,0
7367,,,Prasert_cha,0,1,1,0,1,1,0,0,1,1,1,0
7368,,,marineblue_1229,0,1,1,0,1,1,0,0,1,1,1,0
7369,,,1tYCOvkEB1ESJWj,3,1,4,3,1,4,0.333333,0.020061,0,0,0,0
7370,,,cyberjoestar,2,1,3,2,1,3,0.5,0.013374,0,0,0,0
7371,,,NkZoezoe,0,1,1,0,1,1,0,0,1,1,1,0
7372,,,hayyy_png,7,1,8,7,1,8,0.142857,0.067775,0,0,0,0
7373,,,yuka5470_17,0,1,1,0,1,1,0,0,1,1,1,0
7374,,,wonwoobeaniee,0,1,1,0,1,1,0,0,1,1,1,0
7375,,,dolphinksoo,0,1,1,0,1,1,0,0,1,1,1,0
7376,,,kthakko,0,1,1,0,1,1,0,0,1,1,1,0
7377,,,ochho88,6,2,8,6,2,8,0.142857,0.040123,1,1,1,5
7378,,,fuwamofu_kitty,0,1,1,0,1,1,0,0,1,1,1,0
7379,,,kebinwooo,0,1,1,0,1,1,0,0,1,1,1,0
7380,,,MarieLoeffler,2,1,3,3,1,4,0.5,0.013374,0,0,0,0
7381,,,Westphilia,7,1,8,7,1,8,0.142857,0.04681,0,0,0,0
7382,,,Aelia_Xu,0,1,1,0,1,1,0,0,1,1,1,0
7383,,,ArtzYeen,0,1,1,0,1,1,0,0,1,1,1,0
7384,,,H0NEYRIVER,0,1,1,0,1,1,0,0,1,1,1,0
7385,,,ceciliawy0405,0,1,1,0,1,1,0,0,1,1,1,0
7386,,,sherivigil,3,1,4,3,1,4,0.333333,0.020061,0,0,0,0
7387,,,christianvizzle,0,1,1,0,1,1,0,0,1,1,1,0
7388,,,gotdoie,6,1,7,7,2,9,0.166667,0.087167,0,0,0,0
7389,,,jlammy_,0,1,1,0,1,1,0,0,1,1,1,0
7390,,,KananiFong,1,1,2,1,1,2,0,0.006687,0,0,0,0
7391,,,spardisjx,4,1,5,5,1,6,0.25,0.026749,0,0,0,0
7392,,,Blackjunque,0,1,1,0,1,1,0,0,1,1,1,0
7393,,,mi_woo17,0,1,1,0,1,1,0,0,3,0.45,0.481481,0
7394,,,Primejodytime,0,1,1,0,1,1,0,0,3,0.45,0.481481,0
7395,,,luccmyeye,0,1,1,0,1,1,0,0,3,0.45,0.481481,0
7396,,,cat_piddle_ism,2,1,3,2,1,3,0.5,0.013374,0,0,0,0
7397,,,RennerRikard,1,1,2,1,1,2,0,0.006687,0,0,0,0
7398,,,glennsn2,3,1,4,3,1,4,0.333333,0.020061,0,0,0,0
7399,,,BoilingCrude,0,1,1,0,1,1,0,0,1,1,1,0
7400,,,FLYFLEDGLINGFLY,1,1,2,1,1,2,0,0.006687,0,0,0,0
7401,,,OshianAizawa,7,1,8,7,1,8,0.142857,0.04681,0,0,0,0
7402,,,mwilliams_matt,0,1,1,0,1,1,0,0,1,1,1,0
7403,,,boomingsystym,0,1,1,0,1,1,0,0,1,1,1,0
7404,,,peachyminki,0,1,1,0,1,1,0,0,1,1,1,0
7405,,,V_V_G,0,1,1,0,1,1,0,0,1,1,1,0
7406,,,scarletpapava,0,1,1,0,1,1,0,0,1,1,1,0
7407,,,beaarthur85,1,1,2,1,1,2,0,0.006687,0,0,0,0
7408,,,wwtawwta_bruh,1,1,2,1,1,2,0,0.006687,0,0,0,0
7409,,,ItsNightlyte,0,1,1,0,1,1,0,0,2,0.545455,0.583333,0
7410,,,_butthole2,5,1,6,5,1,6,0.2,0.033436,0,0,0,0
7411,,,Alexpawlak8,0,1,1,0,1,1,0,0,1,1,1,0
7412,,,redriotsteeth,0,1,1,0,1,1,0,0,1,1,1,0
7413,,,j_m_santiago,4,1,5,4,1,5,0.25,0.026749,0,0,0,0
7414,,,JohnWilson,0,1,1,0,1,1,0,0,1,1,1,0
7415,,,fabucat,0,1,1,0,1,1,0,0,1,1,1,0
7416,,,Astrid_NV,2,1,3,2,1,3,0.5,0.013374,0,0,0,0
7417,,,FesZ74,0,1,1,0,1,1,0,0,1,1,1,0
7418,,,oliviaayyy,1,1,2,1,1,2,0,0.006687,0,0,0,0
7419,,,9NEWS,7,1,8,7,1,8,0.142857,0.04681,0,0,0,0
7420,,,rgstratford,0,1,1,0,1,1,0,0,1,1,1,0
7421,,,sigmamylove,0,1,1,0,1,1,0,0,1,1,1,0
7422,,,vminsqueer,0,2,2,0,2,2,0,0,1,1,1,0
7423,,,Mariana_AreCa,0,1,1,0,1,1,0,0,1,1,1,0
7424,,,SoorinK,0,1,1,0,1,1,0,0,1,1,1,0
7425,,,fotsch1,10,1,11,10,1,11,0.1,0.109706,0,0,0,0
7426,,,metavins,0,1,1,0,1,1,0,0,1,1,1,0
7427,,,louiqaraschid,0,1,1,0,1,1,0,0,1,1,1,0
7428,,,1812patjohnson,0,1,1,0,1,1,0,0,1,1,1,0
7429,,,mirohmap,0,1,1,0,1,1,0,0,1,1,1,0
7430,,,DrTao,0,1,1,0,1,1,0,0,1,1,1,0
7431,,,Aoringoofficial,0,1,1,0,1,1,0,0,1,1,1,0
7432,,,pep0land,0,1,1,0,1,1,0,0,1,1,1,0
7433,,,shineediamondd,0,1,1,0,1,1,0,0,1,1,1,0
7434,,,iRiSMoS_,0,1,1,0,1,1,0,0,3,0.45,0.481481,0
7435,,,HolyLeisure,0,1,1,0,1,1,0,0,3,0.45,0.481481,0
7436,,,mariellalynn,0,1,1,0,1,1,0,0,2,0.666667,0.75,0
7437,,,msmiawallace_,0,1,1,0,1,1,0,0,2,0.666667,0.75,0
7438,,,takaturri,0,1,1,0,1,1,0,0,2,0.666667,0.75,0
7439,,,MilliMacPherson,0,2,2,0,2,2,0,0,2,0.75,0.833333,0
7440,,,dsgnchirp,10,1,11,10,1,11,0.1,0.066871,0,0,0,0
7441,,,yoursmile4good,0,1,1,0,1,1,0,0,1,1,1,0
7442,,,karigane42,0,1,1,0,1,1,0,0,1,1,1,0
7443,,,lesyeuxdear,0,1,1,0,1,1,0,0,1,1,1,0
7444,,,aklee_writes,0,1,1,0,1,1,0,0,1,1,1,0
7445,,,rcjs119,5,1,6,5,1,6,0.2,0.033436,0,0,0,0
7446,,,7Harjit,0,1,1,0,1,1,0,0,1,1,1,0
7447,,,3A4T4F4Lo4Lz4s,0,2,2,0,2,2,0,0,1,1,1,0
7448,,,holyapollo,1,1,2,1,1,2,0,0.006687,0,0,0,0
7449,,,KatsuFunai,1,1,2,1,1,2,0,0.006687,0,0,0,0
7450,,,leroywilsonjr,4,1,5,6,2,8,0.25,0.026749,0,0,0,0
7451,,,altheocc,1,1,2,1,1,2,0,0.006687,0,0,0,0
7452,,,shewasbornIucky,0,1,1,0,1,1,0,0,1,1,1,0
7453,,,zabelipka,2,1,3,2,1,3,0.5,0.013374,0,0,0,0
7454,,,lesbianjjy,0,2,2,0,4,4,0,0,1,1,1,0
7455,,,shessochye,1,1,2,1,1,2,0,0.006687,0,0,0,0
7456,,,eurosport,1,1,2,1,1,2,0,0.006687,0,0,0,0
7457,,,Christi57166282,5,2,7,7,4,11,0.166667,0.033436,1,1,1,4
7458,,,avayu05,18,1,19,20,3,23,0.055556,0.168231,0,0,0,0
7459,,,guizhngballista,0,1,1,0,1,1,0,0,1,1,1,0
7460,,,StephenyKeith,0,1,1,0,1,1,0,0,1,1,1,0
7461,,,lgbtkaz,1,1,2,1,1,2,0,0.006687,0,0,0,0
7462,,,notthatone12,0,1,1,0,1,1,0,0,2,0.6,0.666667,0
7463,,,jnihpyyyy,0,1,1,0,1,1,0,0,2,0.6,0.666667,0
7464,,,susangladwin,2,1,3,2,1,3,0.5,0.013374,0,0,0,0
7465,,,eyeslipseye,0,1,1,0,1,1,0,0,1,1,1,0
7466,,,WokeLiLi68,4,1,5,4,1,5,0.25,0.026749,0,0,0,0
7467,,,syugatan,0,1,1,0,1,1,0,0,1,1,1,0
7468,,,hapimartin,0,1,1,0,1,1,0,0,1,1,1,0
7469,,,toukokirihara,0,1,1,0,1,1,0,0,1,1,1,0
7470,,,gregoryhall_,1,1,2,1,1,2,0,0.006687,0,0,0,0
7471,,,gloriawuwu,1,1,2,1,1,2,0,0.006687,0,0,0,0
7472,,,dgseamon,2,1,3,2,1,3,0.5,0.013374,0,0,0,0
7473,,,scorpio_19999,0,1,1,0,1,1,0,0,1,1,1,0
7474,,,sirimahanthesh,16,1,17,18,2,20,0.0625,0.110489,0,0,0,0
7475,,,avantlaurore,0,1,1,0,1,1,0,0,1,1,1,0
7476,,,BasilLeaf,0,1,1,0,1,1,0,0,1,1,1,0
7477,,,AliciaLocus,0,1,1,0,1,1,0,0,1,1,1,0
7478,,,marianiwiwin,0,1,1,0,1,1,0,0,1,1,1,0
7479,,,Marudr3,0,1,1,0,1,1,0,0,1,1,1,0
7480,,,fuguesque,1,1,2,1,1,2,0,0.006687,0,0,0,0
7481,,,thpontiacbandit,2,1,3,2,1,3,0.5,0.013374,0,0,0,0
7482,,,costaliqueur,0,1,1,0,1,1,0,0,1,1,1,0
7483,,,IreneLim2012,0,1,1,0,1,1,0,0,2,0.666667,0.75,0
7484,,,gtl,0,2,2,0,2,2,0,0,2,0.666667,0.75,0
7485,,,PeripateticMe,22,1,23,23,1,24,0.045455,0.258932,0,0,0,0
7486,,,Jonah12249475,0,1,1,0,1,1,0,0,1,1,1,0
7487,,,Amlaf3,0,1,1,0,1,1,0,0,1,1,1,0
7488,,,LastKnight_2020,0,1,1,0,1,1,0,0,1,1,1,0
7489,,,passion4ds,0,3,3,0,3,3,0,0,1,1,1,0
7490,,,_______ar2,0,1,1,0,1,1,0,0,1,1,1,0
7491,,,wntrbear_mp3,0,1,1,0,1,1,0,0,1,1,1,0
7492,,,ProudNerdBobF,0,1,1,0,1,1,0,0,1,1,1,0
7493,,,GuerillaMobbEnt,0,1,1,0,1,1,0,0,1,1,1,0
7494,,,HYLTSEHUN,0,1,1,0,1,1,0,0,1,1,1,0
7495,,,lilmochishands,0,1,1,0,1,1,0,0,1,1,1,0
7496,,,jeonghyomeal,0,1,1,0,1,1,0,0,1,1,1,0
7497,,,lbredaoray,0,1,1,0,1,1,0,0,1,1,1,0
7498,,,aina8catina3box,0,1,1,0,1,1,0,0,1,1,1,0
7499,,,yaozhang02,0,1,1,0,2,2,0,0,1,1,1,0
7500,,,Motherof2Dog,0,1,1,0,1,1,0,0,1,1,1,0
7501,,,exarcopoulos,0,1,1,0,1,1,0,0,1,1,1,0
7502,,,furiousrainbows,1,1,2,1,1,2,0,0.006687,0,0,0,0
7503,,,Kierangs1,1,1,2,1,1,2,0,0.006687,0,0,0,0
7504,,,EINChinaNews,1,1,2,1,1,2,0,0.006687,0,0,0,0
7505,,,toso_sasha,0,1,1,0,1,1,0,0,1,1,1,0
7506,,,Cody_D_A,4,1,5,4,1,5,0.25,0.026749,0,0,0,0
7507,,,daysgonetuan,0,1,1,0,1,1,0,0,1,1,1,0
7508,,,CindyMa98167479,0,1,1,0,1,1,0,0,1,1,1,0
7509,,,TLebeog,0,1,1,0,1,1,0,0,1,1,1,0
7510,,,quanxilvur,3,1,4,3,1,4,0.333333,0.020061,0,0,0,0
7511,,,izzy_fizzz,0,1,1,0,1,1,0,0,1,1,1,0
7512,,,mpratt47,0,1,1,0,1,1,0,0,1,1,1,0
7513,,,LadyFilmFatale,1,1,2,1,1,2,0,0.006687,0,0,0,0
7514,,,queenbrubs,2,1,3,2,1,3,0.5,0.013374,0,0,0,0
7515,,,ungodlywests,0,1,1,0,1,1,0,0,1,1,1,0
7516,,,ImMillbrae,2,1,3,2,1,3,0.5,0.013374,0,0,0,0
7517,,,nyancow,0,1,1,0,1,1,0,0,1,1,1,0
7518,,,Chinesepop,9,1,10,9,1,10,0.111111,0.116092,0,0,0,0
7519,,,znienjw,0,1,1,0,1,1,0,0,1,1,1,0
7520,,,b0okmarked,0,1,1,0,1,1,0,0,1,1,1,0
7521,,,mellifluoury,0,1,1,0,1,1,0,0,1,1,1,0
7522,,,slugzeee,0,1,1,0,1,1,0,0,1,1,1,0
7523,,,bigbuddhabear1,0,1,1,0,1,1,0,0,1,1,1,0
7524,,,nicosslut,0,1,1,0,1,1,0,0,1,1,1,0
7525,,,hockeywidow95,0,1,1,0,1,1,0,0,1,1,1,0
7526,,,Sirrallo,0,1,1,0,1,1,0,0,1,1,1,0
7527,,,manonchocolatte,0,1,1,0,1,1,0,0,1,1,1,0
7528,,,cnnasiapr,0,1,1,0,1,1,0,0,1,1,1,0
7529,,,dosparkb,0,1,1,0,1,1,0,0,1,1,1,0
7530,,,ConnieKNChang,3,1,4,3,1,4,0.333333,0.020061,0,0,0,0
7531,,,BBBoppa,0,1,1,0,1,1,0,0,1,1,1,0
7532,,,kikilala821822,0,1,1,0,1,1,0,0,1,1,1,0
7533,,,bexwright1,8,1,9,8,1,9,0.125,0.053497,0,0,0,0
7534,,,Kim54440369,0,1,1,0,1,1,0,0,1,1,1,0
7535,,,life_canbeshort,0,1,1,0,1,1,0,0,1,1,1,0
7536,,,momobeark,0,1,1,0,1,1,0,0,1,1,1,0
7537,,,chadmkolton,0,1,1,0,1,1,0,0,1,1,1,0
7538,,,Jazz3asketball,0,1,1,0,1,1,0,0,1,1,1,0
7539,,,minkythe3rd,0,1,1,0,1,1,0,0,1,1,1,0
7540,,,nathanlovescoug,0,1,1,0,1,1,0,0,1,1,1,0
7541,,,ANTlVANCROW,2,1,3,2,1,3,0.5,0.013374,0,0,0,0
7542,,,AdvisorWang,13,1,14,14,2,16,0.076923,0.111392,0,0,0,0
7543,,,Onetwot82898290,0,1,1,0,1,1,0,0,1,1,1,0
7544,,,GPBGeorge,7,3,10,8,4,12,0.111111,0.04681,1,1,1,12
7545,,,NirbhaySRathore,1,1,2,1,1,2,0,0.006687,0,0,0,0
7546,,,Scottvickers27,1,1,2,1,1,2,0,0.006687,0,0,0,0
7547,,,michaelide2010,0,1,1,0,1,1,0,0,2,0.571429,0.625,0
7548,,,chieonii,1,1,2,1,1,2,0,0.006687,0,0,0,0
7549,,,templeofvirgo,0,2,2,0,2,2,0,0,1,1,1,0
7550,,,PennyJTH,0,1,1,0,2,2,0,0,1,1,1,0
7551,,,chinazzzi,4,1,5,4,1,5,0.25,0.026749,0,0,0,0
7552,,,taku_rin123,0,1,1,0,1,1,0,0,1,1,1,0
7553,,,akrh1IA3dOg7fqa,0,1,1,0,1,1,0,0,1,1,1,0
7554,,,cherriesinspace,2,1,3,2,1,3,0.5,0.013374,0,0,0,0
7555,,,KPBabaganoush,2,1,3,2,1,3,0.5,0.013374,0,0,0,0
7556,,,suspurria,0,1,1,0,1,1,0,0,1,1,1,0
7557,,,grandpianoalex,3,1,4,3,1,4,0.333333,0.020061,0,0,0,0
7558,,,hynjaepop,0,1,1,0,1,1,0,0,1,1,1,0
7559,,,IuvIand,0,1,1,0,1,1,0,0,1,1,1,0
7560,,,Busyahchan2,2,1,3,2,1,3,0.5,0.013374,0,0,0,0
7561,,,uZ4RUeSCyPIZ2CV,0,1,1,0,1,1,0,0,1,1,1,0
7562,,,xingou,1,1,2,1,1,2,0,0.006687,0,0,0,0
7563,,,soccerhaus,9,1,10,9,1,10,0.111111,0.060184,0,0,0,0
7564,,,Sol_shine22,0,3,3,0,3,3,0,0,1,1,1,0
7565,,,mikuswn,0,1,1,0,1,1,0,0,1,1,1,0
7566,,,Armando91142904,0,1,1,0,1,1,0,0,1,1,1,0
7567,,,ncity_exoplanet,0,1,1,0,1,1,0,0,1,1,1,0
7568,,,morks_petwmelon,0,1,1,0,1,1,0,0,1,1,1,0
7569,,,LeBongJames,0,1,1,0,1,1,0,0,1,1,1,0
7570,,,ponsmpo,0,1,1,0,1,1,0,0,1,1,1,0
7571,,,helenenothelen,11,1,12,12,2,14,0.090909,0.142659,0,0,0,0
7572,,,Sheepxing_9,0,1,1,0,1,1,0,0,1,1,1,0
7573,,,Neeroo_ebay,0,3,3,0,4,4,0,0,1,1,1,0
7574,,,annetthology,0,1,1,0,1,1,0,0,1,1,1,0
7575,,,soy_aaa_,0,1,1,0,1,1,0,0,1,1,1,0
7576,,,stephanieywyche,0,1,1,0,1,1,0,0,1,1,1,0
7577,,,balconiesoflove,3,1,4,3,1,4,0.333333,0.020061,0,0,0,0
7578,,,peepeeMKII,0,1,1,0,1,1,0,0,1,1,1,0
7579,,,ratsper,0,1,1,0,1,1,0,0,1,1,1,0
7580,,,Pecs8026,0,1,1,0,1,1,0,0,1,1,1,0
7581,,,Iysingularity,6,1,7,7,1,8,0.166667,0.047111,0,0,0,0
7582,,,zackwheeler,0,1,1,0,1,1,0,0,1,1,1,0
7583,,,islaflores_,0,1,1,0,1,1,0,0,1,1,1,0
7584,,,nonorin88,0,1,1,0,1,1,0,0,1,1,1,0
7585,,,cy_beh,2,1,3,2,1,3,0.5,0.013374,0,0,0,0
7586,,,KhbrkNews,3,1,4,3,1,4,0.333333,0.020061,0,0,0,0
7587,,,cherii0621,0,1,1,0,1,1,0,0,1,1,1,0
7588,,,baechustokki,2,1,3,2,1,3,0.5,0.013374,0,0,0,0
7589,,,jenoxygenated,0,1,1,0,1,1,0,0,1,1,1,0
7590,,,moodzino,0,1,1,0,1,1,0,0,1,1,1,0
7591,,,BaekGucci,0,2,2,0,2,2,0,0,1,1,1,0
7592,,,NeblinaE,0,1,1,0,1,1,0,0,1,1,1,0
7593,,,lambwho,2,1,3,2,1,3,0.5,0.013374,0,0,0,0
7594,,,love_exo_Linwy,0,1,1,0,1,1,0,0,1,1,1,0
7595,,,_Terribilis,1,1,2,1,1,2,0,0.006687,0,0,0,0
7596,,,fvckyuehua,3,1,4,3,1,4,0.333333,0.023556,0,0,0,0
7597,,,bee1618033,0,1,1,0,1,1,0,0,1,1,1,0
7598,,,choco_marble_56,0,1,1,0,1,1,0,0,1,1,1,0
7599,,,kay_cilliana,5,1,6,5,1,6,0.2,0.033436,0,0,0,0
7600,,,glace08sel,0,1,1,0,1,1,0,0,1,1,1,0
7601,,,ramiranda47,0,2,2,0,2,2,0,0,2,0.666667,0.75,0
7602,,,umatonadeshiko1,0,2,2,0,2,2,0,0,1,1,1,0
7603,,,icedancecom,0,1,1,0,1,1,0,0,1,1,1,0
7604,,,feedpushr,14,1,15,21,5,26,0.071429,0.09362,0,0,0,0
7605,,,Basil_leafeon,0,2,2,0,2,2,0,0,1,1,1,0
7606,,,Nanncyhannah27,9,1,10,11,1,12,0.111111,0.060184,0,0,0,0
7607,,,Barbiewithatude,0,1,1,0,1,1,0,0,1,1,1,0
7608,,,mystegris,0,1,1,0,1,1,0,0,1,1,1,0
7609,,,Astwisa,0,1,1,0,1,1,0,0,1,1,1,0
7610,,,litmasturbator,0,2,2,0,2,2,0,0,1,1,1,0
7611,,,unagi_kun11,11,1,12,12,2,14,0.090909,0.09103,0,0,0,0
7612,,,nilabuckeye,0,1,1,0,1,1,0,0,1,1,1,0
7613,,,aies_heeso,0,1,1,0,1,1,0,0,2,0.666667,0.75,0
7614,,,yutakarlson,0,1,1,0,1,1,0,0,2,0.666667,0.75,0
7615,,,jazstormborn,0,2,2,0,2,2,0,0,1,1,1,0
7616,,,4legs2legs,5,1,6,5,1,6,0.2,0.050907,0,0,0,0
7617,,,CRY5TA4L,0,1,1,0,1,1,0,0,1,1,1,0
7618,,,oberyncartel,0,1,1,0,1,1,0,0,1,1,1,0
7619,,,ebeno22,5,2,7,5,2,7,0.166667,0.033436,1,1,1,4
7620,,,cou_rt7,0,1,1,0,1,1,0,0,1,1,1,0
7621,,,FreelingBarbara,0,1,1,0,1,1,0,0,1,1,1,0
7622,,,mlimeow,0,1,1,0,1,1,0,0,1,1,1,0
7623,,,lcbradlow,0,1,1,0,1,1,0,0,1,1,1,0
7624,,,kattbert,0,1,1,0,1,1,0,0,1,1,1,0
7625,,,iVincentWang,0,1,1,0,1,1,0,0,1,1,1,0
7626,,,julianku,1,1,2,2,2,4,0,0.006687,0,0,0,0
7627,,,briixght,0,1,1,0,1,1,0,0,1,1,1,0
7628,,,304eve,0,1,1,0,1,1,0,0,1,1,1,0
7629,,,Hihijan2,0,1,1,0,1,1,0,0,1,1,1,0
7630,,,UH1K,0,2,2,0,2,2,0,0,1,1,1,0
7631,,,Gautami95,0,1,1,0,1,1,0,0,1,1,1,0
7632,,,nananetcitizen,0,1,1,0,1,1,0,0,1,1,1,0
7633,,,unc_cool,1,1,2,1,1,2,0,0.006687,0,0,0,0
7634,,,fuckafriedrice,4,1,5,6,1,7,0.25,0.026749,0,0,0,0
7635,,,lixbaby2,3,3,6,3,3,6,0.2,0.020061,1,1,1,4
7636,,,planetgreen2019,0,1,1,0,1,1,0,0,2,0.6,0.666667,0
7637,,,pbnjun,0,1,1,0,1,1,0,0,2,0.6,0.666667,0
7638,,,TearoGasja,1,1,2,1,1,2,0,0.006687,0,0,0,0
7639,,,Nino_el_Bambino,1,1,2,1,1,2,0,0.006687,0,0,0,0
7640,,,scotscoop,1,1,2,1,1,2,0,0.006687,0,0,0,0
7641,,,TopChinaNews,3,1,4,3,1,4,0.333333,0.020061,0,0,0,0
7642,,,omnicronrho77,0,1,1,0,1,1,0,0,1,1,1,0
7643,,,Sunshine_Shua,0,1,1,0,1,1,0,0,1,1,1,0
7644,,,Frasmith1234,2,1,3,2,1,3,0.5,0.013374,0,0,0,0
7645,,,mojones44,0,1,1,0,1,1,0,0,1,1,1,0
7646,,,jmduhnke,3,1,4,3,1,4,0.333333,0.048015,0,0,0,0
7647,,,nathanlovve,0,1,1,0,1,1,0,0,1,1,1,0
7648,,,lolnobutreally,8,2,10,8,2,10,0.111111,0.053497,1,1,1,7
7649,,,jillyfinch,0,1,1,0,1,1,0,0,1,1,1,0
7650,,,ppoppxyz,0,1,1,0,1,1,0,0,2,0.666667,0.75,0
7651,,,hyunfortunately,0,2,2,0,2,2,0,0,2,0.75,0.833333,0
7652,,,janessa31888,0,1,1,0,1,1,0,0,2,0.666667,0.75,0
7653,,,snowflake19982,0,1,1,0,1,1,0,0,2,0.666667,0.75,0
7654,,,duyoduyohae,0,1,1,0,1,1,0,0,2,0.666667,0.75,0
7655,,,evergreenjades,0,3,3,0,3,3,0,0,2,0.714286,0.8,0
7656,,,aparkyparks,3,1,4,3,1,4,0.333333,0.020061,0,0,0,0
7657,,,agnew122,0,1,1,0,1,1,0,0,1,1,1,0
7658,,,sdpowell1,2,1,3,2,1,3,0.5,0.013374,0,0,0,0
7659,,,LibertarianFal1,0,1,1,0,1,1,0,0,1,1,1,0
7660,,,skatefan78,2,1,3,3,2,5,0.5,0.013374,0,0,0,0
7661,,,PfaffSC,0,1,1,0,1,1,0,0,1,1,1,0
7662,,,kimthotjin,2,1,3,2,1,3,0.5,0.013374,0,0,0,0
7663,,,paulballen,0,1,1,0,1,1,0,0,1,1,1,0
7664,,,uhhlynaa,13,1,14,13,1,14,0.076923,0.086933,0,0,0,0
7665,,,dan_bellhorn2ba,0,1,1,0,1,1,0,0,1,1,1,0
7666,,,gnz09392491,0,4,4,0,4,4,0,0,1,1,1,0
7667,,,LynneleeRevis,0,1,1,0,1,1,0,0,1,1,1,0
7668,,,ChuuBite,0,1,1,0,1,1,0,0,1,1,1,0
7669,,,wazi_uchiha,0,1,1,0,1,1,0,0,1,1,1,0
7670,,,LETSWWIN,0,1,1,0,1,1,0,0,1,1,1,0
7671,,,ichthyos,0,1,1,0,1,1,0,0,1,1,1,0
7672,,,pei4y,0,1,1,0,1,1,0,0,1,1,1,0
7673,,,kdryvk,0,4,4,0,4,4,0,0,1,1,1,0
7674,,,yukarin65796595,0,1,1,0,1,1,0,0,1,1,1,0
7675,,,minseokminnie,0,1,1,0,1,1,0,0,1,1,1,0
7676,,,LaurieGoldberg,4,1,5,4,1,5,0.25,0.026749,0,0,0,0
7677,,,jade0420,0,1,1,0,1,1,0,0,1,1,1,0
7678,,,NarumiTakahash4,0,1,1,0,1,1,0,0,1,1,1,0
7679,,,Karen25520676,0,2,2,0,2,2,0,0,1,1,1,0
7680,,,AJBlackston,4,1,5,7,4,11,0.25,0.026749,0,0,0,0
7681,,,teachermom_70,0,1,1,0,1,1,0,0,1,1,1,0
7682,,,zpravy_24,18,1,19,19,2,21,0.055556,0.120369,0,0,0,0
7683,,,alisoncook,0,1,1,0,1,1,0,0,1,1,1,0
7684,,,jhop4749,0,1,1,0,1,1,0,0,1,1,1,0
7685,,,kaho_tsang,0,1,1,0,1,1,0,0,1,1,1,0
7686,,,Seina,0,1,1,0,1,1,0,0,1,1,1,0
7687,,,seungcheolised,0,1,1,0,1,1,0,0,1,1,1,0
7688,,,LiuSuMianHuaa,0,1,1,0,1,1,0,0,1,1,1,0
7689,,,lorybird57,0,1,1,0,1,1,0,0,1,1,1,0
7690,,,DemiLovatoTH,1,1,2,1,1,2,0,0.006687,0,0,0,0
7691,,,gdibarry,1,1,2,1,1,2,0,0.006687,0,0,0,0
7692,,,forelsket05,4,1,5,4,1,5,0.25,0.026749,0,0,0,0
7693,,,SandraR71700221,0,1,1,0,1,1,0,0,1,1,1,0
7694,,,yikwanchu,0,1,1,0,1,1,0,0,1,1,1,0
7695,,,YAbooklover,0,1,1,0,1,1,0,0,1,1,1,0
7696,,,ParentSecurity,4,1,5,4,1,5,0.25,0.033737,0,0,0,0
7697,,,kwangcvlt,2,2,4,2,2,4,0.333333,0.013374,1,1,1,1
7698,,,faithin_chaos,0,1,1,0,1,1,0,0,1,1,1,0
7699,,,gisellelilac,0,1,1,0,1,1,0,0,1,1,1,0
7700,,,s_wnbanut,0,1,1,0,1,1,0,0,3,0.454545,0.533333,0
7701,,,joonmin6,0,1,1,0,1,1,0,0,1,1,1,0
7702,,,2468scottPotter,0,2,2,0,2,2,0,0,1,1,1,0
7703,,,StrawberryNG,12,1,13,13,2,15,0.083333,0.080246,0,0,0,0
7704,,,Juliette5505,0,1,1,0,1,1,0,0,1,1,1,0
7705,,,httpnagyung,0,1,1,0,1,1,0,0,1,1,1,0
7706,,,yuzzz4A,0,1,1,0,1,1,0,0,1,1,1,0
7707,,,JilleWhistler87,0,1,1,0,1,1,0,0,1,1,1,0
7708,,,dazzee,0,1,1,0,1,1,0,0,1,1,1,0
7709,,,Wonnieyu,0,1,1,0,1,1,0,0,1,1,1,0
7710,,,eternitysky2,0,1,1,0,1,1,0,0,1,1,1,0
7711,,,Cdlowe4,0,1,1,0,1,1,0,0,4,0.340659,0.376344,0
7712,,,Kaoturbonista,0,1,1,0,1,1,0,0,4,0.340659,0.376344,0
7713,,,KnightLAT,5,1,6,5,1,6,0.2,0.033436,0,0,0,0
7714,,,anabella0077,0,1,1,0,1,1,0,0,1,1,1,0
7715,,,kyeopi_,0,1,1,0,1,1,0,0,1,1,1,0
7716,,,austinbxxx,0,3,3,0,6,6,0,0,1,1,1,0
7717,,,unsavorycandy,7,1,8,8,1,9,0.142857,0.04681,0,0,0,0
7718,,,pearl21angel,0,1,1,0,1,1,0,0,1,1,1,0
7719,,,A4Annaz,0,1,1,0,1,1,0,0,1,1,1,0
7720,,,Drammmaman,0,1,1,0,1,1,0,0,1,1,1,0
7721,,,khalilah1,0,1,1,0,1,1,0,0,1,1,1,0
7722,,,alienrei,0,1,1,0,1,1,0,0,1,1,1,0
7723,,,Aimdiddles,0,1,1,0,1,1,0,0,1,1,1,0
7724,,,Alpha_Level,0,3,3,0,3,3,0,0,2,0.8,0.875,0
7725,,,GinaLawriw,11,1,12,14,4,18,0.090909,0.09103,0,0,0,0
7726,,,AnimalDefenceMX,8,1,9,10,3,13,0.125,0.053497,0,0,0,0
7727,,,chmodbot3,1,1,2,1,1,2,0,0.006687,0,0,0,0
7728,,,news89com,1,1,2,1,1,2,0,0.006687,0,0,0,0
7729,,,lunaltura,1,2,3,1,2,3,0.5,0.006687,3,0.481481,0.512821,0
7730,,,strophariaAO3,1,1,2,1,1,2,0,0.006687,0,0,0,0
7731,,,KelceeSykes,1,1,2,1,1,2,0,0.006687,0,0,0,0
7732,,,kalacherie,2,1,3,2,1,3,0.5,0.013374,0,0,0,0
7733,,,slovejeffrey,0,1,1,0,1,1,0,0,1,1,1,0
7734,,,msgigicapone,0,3,3,0,4,4,0,0,1,1,1,0
7735,,,LatestComments,5,1,6,7,3,10,0.2,0.054401,0,0,0,0
7736,,,MercorOrg,0,3,3,0,3,3,0,0,1,1,1,0
7737,,,GiGiCaponePR,5,1,6,8,4,12,0.2,0.033436,0,0,0,0
7738,,,swissbusiness,6,1,7,7,2,9,0.166667,0.045577,0,0,0,0
7739,,,MeloniFulvio,10,1,11,12,3,15,0.1,0.066871,0,0,0,0
7740,,,k2c0t0u0s,0,1,1,0,1,1,0,0,1,1,1,0
7741,,,YoshiePink,0,1,1,0,1,1,0,0,1,1,1,0
7742,,,Bbhbvfi,0,1,1,0,1,1,0,0,1,1,1,0
7743,,,cactusgirli,3,1,4,3,1,4,0.333333,0.02705,0,0,0,0
7744,,,nblxh,0,1,1,0,1,1,0,0,1,1,1,0
7745,,,mdyenisova,0,1,1,0,1,1,0,0,2,0.6,0.666667,0
7746,,,Iris_hecatolite,0,1,1,0,1,1,0,0,2,0.6,0.666667,0
7747,,,ZiesmanJordyn,0,1,1,0,1,1,0,0,4,0.413043,0.45614,0
7748,,,focalfeedback,0,1,1,0,1,1,0,0,4,0.413043,0.45614,0
7749,,,RtRyujin,0,2,2,0,3,3,0.5,0,4,0.422222,0.482456,0
7750,,,FanGirlLife1721,0,1,1,0,1,1,0,0,3,0.5,0.566667,0
7751,,,BreakingScams,13,1,14,15,3,18,0.076923,0.14284,0,0,0,0
7752,,,orchidsval,0,1,1,0,1,1,0,0,1,1,1,0
7753,,,Pauliina2897,0,1,1,0,1,1,0,0,1,1,1,0
7754,,,3birdneco3,0,1,1,0,1,1,0,0,1,1,1,0
7755,,,HIRO90899571,0,1,1,0,1,1,0,0,1,1,1,0
7756,,,alenethatcher,0,1,1,0,1,1,0,0,1,1,1,0
7757,,,shineebeanie,0,1,1,0,1,1,0,0,1,1,1,0
7758,,,loonastanss,0,1,1,0,1,1,0,0,1,1,1,0
7759,,,Hollandorange1,0,1,1,0,1,1,0,0,1,1,1,0
7760,,,KathiePloskonka,7,1,8,9,2,11,0.166667,0.060787,0,0,0,0
7761,,,BLACKSTEMUSA,0,1,1,0,1,1,0,0,1,1,1,0
7762,,,HBS_Eric,0,1,1,0,1,1,0,0,1,1,1,0
7763,,,iFuaM,0,1,1,0,1,1,0,0,1,1,1,0
7764,,,SkateOntario,6,1,7,6,1,7,0.166667,0.040123,0,0,0,0
7765,,,yuzuri4Aplus5,0,1,1,0,1,1,0,0,1,1,1,0
7766,,,MNsosweet,0,1,1,0,1,1,0,0,1,1,1,0
7767,,,AngieFrost21,0,1,1,0,1,1,0,0,1,1,1,0
7768,,,exo_choigoo,0,1,1,0,1,1,0,0,1,1,1,0
7769,,,GTuskes,8,1,9,9,1,10,0.125,0.053497,0,0,0,0
7770,,,vorenamjoon,0,1,1,0,1,1,0,0,1,1,1,0
7771,,,lovesminie,0,1,1,0,1,1,0,0,1,1,1,0
7772,,,ASmileNaiHe,0,1,1,0,1,1,0,0,1,1,1,0
7773,,,u17_18wv8,0,3,3,0,6,6,0,0,1,1,1,0
7774,,,hallmarkmiriam1,0,1,1,0,1,1,0,0,1,1,1,0
7775,,,JeffRice365,0,1,1,0,1,1,0,0,1,1,1,0
7776,,,jfriel01,0,1,1,0,1,1,0,0,1,1,1,0
7777,,,kyclouds,0,1,1,0,1,1,0,0,1,1,1,0
7778,,,eikapervaya,0,1,1,0,1,1,0,0,1,1,1,0
7779,,,hobitear_,0,2,2,0,2,2,0,0,2,0.75,0.833333,0
7780,,,fanyu_joshua,10,1,11,13,3,16,0.1,0.070366,0,0,0,0
7781,,,Lauren33268094,0,2,2,0,2,2,0,0,1,1,1,0
7782,,,VlDEOG1RL,0,1,1,0,1,1,0,0,1,1,1,0
7783,,,calico_pjimin,0,1,1,0,1,1,0,0,2,0.529412,0.555556,0
7784,,,jiechengxuli1,0,1,1,0,1,1,0,0,2,0.529412,0.555556,0
7785,,,_regsolis,0,1,1,0,1,1,0,0,2,0.529412,0.555556,0
7786,,,chinma__,0,1,1,0,1,1,0,0,3,0.483333,0.5,0
7787,,,MysticCindi,0,1,1,0,1,1,0,0,3,0.483333,0.5,0
7788,,,Mr__Gary,1,1,2,1,1,2,0,0.006687,0,0,0,0
7789,,,jd_dew,13,1,14,16,1,17,0.076923,0.086933,0,0,0,0
7790,,,paxsonabney,0,2,2,0,2,2,0,0,1,1,1,0
7791,,,SMSyesu,0,1,1,0,1,1,0,0,1,1,1,0
7792,,,doorkeeper4god,0,1,1,0,1,1,0,0,1,1,1,0
7793,,,paintlots,0,1,1,0,1,1,0,0,1,1,1,0
7794,,,coleman_tp,0,1,1,0,1,1,0,0,1,1,1,0
7795,,,dwgahri,0,1,1,0,1,1,0,0,1,1,1,0
7796,,,aheavyhead,0,1,1,0,1,1,0,0,1,1,1,0
7797,,,isab3lla___,0,1,1,0,1,1,0,0,1,1,1,0
7798,,,ravynash_,0,2,2,0,2,2,0,0,1,1,1,0
7799,,,msnuk,1,1,2,2,2,4,0,0.006687,0,0,0,0
7800,,,exinum0457,0,1,1,0,1,1,0,0,1,1,1,0
7801,,,_JimmyNuetron,0,1,1,0,1,1,0,0,1,1,1,0
7802,,,donaatsu,0,2,2,0,2,2,0,0,1,1,1,0
7803,,,fineIinekisses,1,1,2,1,1,2,0,0.006687,0,0,0,0
7804,,,thehill,20,1,21,22,3,25,0.052632,0.168685,0,0,0,0
7805,,,todayis_ok,0,1,1,0,1,1,0,0,1,1,1,0
7806,,,JenniferOBryant,0,1,1,0,1,1,0,0,1,1,1,0
7807,,,hanaKod1,0,1,1,0,1,1,0,0,1,1,1,0
7808,,,J_SuperStar05,0,1,1,0,1,1,0,0,1,1,1,0
7809,,,itsugalicious,0,1,1,0,1,1,0,0,1,1,1,0
7810,,,mywonflower,0,1,1,0,1,1,0,0,1,1,1,0
7811,,,aquaunderlight,0,1,1,0,1,1,0,0,1,1,1,0
7812,,,LaurenHSansing,0,1,1,0,1,1,0,0,1,1,1,0
7813,,,w4_MOKUREN_ren,0,1,1,0,1,1,0,0,1,1,1,0
7814,,,hirozhen,0,1,1,0,1,1,0,0,1,1,1,0
7815,,,Pal0oka,0,1,1,0,1,1,0,0,1,1,1,0
7816,,,Currycat212,0,1,1,0,1,1,0,0,1,1,1,0
7817,,,hcluvbug,9,1,10,9,1,10,0.111111,0.060184,0,0,0,0
7818,,,bethel54,0,1,1,0,1,1,0,0,1,1,1,0
7819,,,tigressinblack2,0,1,1,0,1,1,0,0,1,1,1,0
7820,,,pklxey,0,1,1,0,1,1,0,0,1,1,1,0
7821,,,lunarshipxxx,0,1,1,0,1,1,0,0,1,1,1,0
7822,,,marchyy__,0,1,1,0,1,1,0,0,1,1,1,0
7823,,,andreajclark,0,1,1,0,1,1,0,0,1,1,1,0
7824,,,medicinedotmp3,0,2,2,0,2,2,0,0,1,1,1,0
7825,,,SYLVIAHAS5GEESE,1,1,2,1,1,2,0,0.006687,0,0,0,0
7826,,,kris_m2,9,1,10,9,1,10,0.111111,0.060184,0,0,0,0
7827,,,YunkiHub,0,1,1,0,1,1,0,0,1,1,1,0
7828,,,GeorgeAAlvarez1,0,1,1,0,1,1,0,0,1,1,1,0
7829,,,DulceofLeche,0,1,1,0,1,1,0,0,1,1,1,0
7830,,,bbabangborahae,0,1,1,0,1,1,0,0,1,1,1,0
7831,,,fadhlapar,0,1,1,0,1,1,0,0,1,1,1,0
7832,,,TheDexterBlues,0,1,1,0,1,1,0,0,1,1,1,0
7833,,,smcmomndfan,0,1,1,0,1,1,0,0,1,1,1,0
7834,,,Sunnhugs,0,1,1,0,1,1,0,0,2,0.6,0.666667,0
7835,,,lcosahedron,0,2,2,0,2,2,0,0,2,0.666667,0.75,0
7836,,,abby_potchie,0,1,1,0,1,1,0,0,1,1,1,0
7837,,,unizinx,0,1,1,0,1,1,0,0,1,1,1,0
7838,,,Jamongpudding12,0,1,1,0,1,1,0,0,1,1,1,0
7839,,,elitevotingteam,0,1,1,0,1,1,0,0,2,0.6,0.666667,0
7840,,,19flashback70,0,1,1,0,1,1,0,0,2,0.6,0.666667,0
7841,,,hanyusunshine,0,1,1,0,1,1,0,0,1,1,1,0
7842,,,bigjche,7,1,8,7,1,8,0.142857,0.07127,0,0,0,0
7843,,,hyuckmiel,0,1,1,0,1,1,0,0,1,1,1,0
7844,,,butternana_,0,1,1,0,1,1,0,0,1,1,1,0
7845,,,glbahar_90,0,1,1,0,1,1,0,0,1,1,1,0
7846,,,viralvernon,0,1,1,0,1,1,0,0,1,1,1,0
7847,,,WOWT6News,2,1,3,2,1,3,0.5,0.013374,0,0,0,0
7848,,,asdesign3,0,1,1,0,1,1,0,0,1,1,1,0
7849,,,Kath2252,0,1,1,0,1,1,0,0,2,0.555556,0.6,0
7850,,,MIN9YUA,0,1,1,0,1,1,0,0,2,0.555556,0.6,0
7851,,,CarmelaCroce2,2,1,3,2,1,3,0.5,0.013374,0,0,0,0
7852,,,yuzucele,0,1,1,0,1,1,0,0,1,1,1,0
7853,,,arabelluhh,3,1,4,3,1,4,0.333333,0.020061,0,0,0,0
7854,,,M0ReS7eBchmyZSI,0,1,1,0,1,1,0,0,1,1,1,0
7855,,,Jacq4Peace,2,2,4,2,2,4,0.333333,0.013374,1,1,1,1
7856,,,patron_elsy,0,1,1,0,1,1,0,0,2,0.666667,0.75,0
7857,,,miIfguyun,2,1,3,2,1,3,0.5,0.020363,0,0,0,0
7858,,,Elsinore1616,2,1,3,2,1,3,0.5,0.013374,0,0,0,0
7859,,,dailyherald,3,1,4,3,1,4,0.333333,0.020061,0,0,0,0
7860,,,UnPastelitoEmo,0,1,1,0,1,1,0,0,1,1,1,0
7861,,,hitomi_shiba,0,1,1,0,1,1,0,0,1,1,1,0
7862,,,001Matthew001,5,1,6,5,1,6,0.2,0.088559,0,0,0,0
7863,,,baegongjunim,0,1,1,0,1,1,0,0,1,1,1,0
7864,,,BKells8,0,2,2,0,2,2,0,0,1,1,1,0
7865,,,veronica_jean08,0,1,1,0,1,1,0,0,1,1,1,0
7866,,,firstlove__yg,0,1,1,0,1,1,0,0,1,1,1,0
7867,,,lesyeuxdejrubyj,0,1,1,0,1,1,0,0,1,1,1,0
7868,,,garydunn808,2,1,3,2,1,3,0.5,0.068498,0,0,0,0
7869,,,kriziaremulta,3,1,4,3,1,4,0.333333,0.020061,0,0,0,0
7870,,,girlyhippiegirl,0,1,1,0,1,1,0,0,1,1,1,0
7871,,,SJTOT,0,1,1,0,1,1,0,0,1,1,1,0
7872,,,goblindiaries,1,1,2,1,1,2,0,0.006687,0,0,0,0
7873,,,felizsinz,0,1,1,0,1,1,0,0,2,0.666667,0.75,0
7874,,,Kokokate8812,0,2,2,0,2,2,0,0,2,0.75,0.833333,0
7875,,,do_here,0,1,1,0,1,1,0,0,2,0.666667,0.75,0
7876,,,yujification,2,1,3,2,1,3,0.5,0.013374,0,0,0,0
7877,,,kathyb60,0,1,1,0,1,1,0,0,1,1,1,0
7878,,,Hlida118,16,1,17,18,3,21,0.0625,0.120971,0,0,0,0
7879,,,wangnaeun,0,1,1,0,1,1,0,0,2,0.6,0.666667,0
7880,,,Okara_haru,0,1,1,0,1,1,0,0,2,0.6,0.666667,0
7881,,,BlizzyP039,1,1,2,1,1,2,0,0.006687,0,0,0,0
7882,,,Mudamuda926,2,1,3,2,1,3,0.5,0.020363,0,0,0,0
7883,,,toepickmegirl,0,1,1,0,1,1,0,0,1,1,1,0
7884,,,ouindees,7,1,8,7,1,8,0.142857,0.04681,0,0,0,0
7885,,,xSHINinsp,0,2,2,0,2,2,0,0,1,1,1,0
7886,,,PragueArtist,0,1,1,0,1,1,0,0,1,1,1,0
7887,,,icy_trails,0,2,2,0,2,2,0,0,1,1,1,0
7888,,,ValVsaltsman,0,1,1,0,1,1,0,0,1,1,1,0
7889,,,tlmac17,0,1,1,0,1,1,0,0,1,1,1,0
7890,,,babymoo4x4,2,1,3,2,1,3,0.5,0.013374,0,0,0,0
7891,,,Reggie25803710,0,1,1,0,1,1,0,0,1,1,1,0
7892,,,antwangriezmann,0,1,1,0,1,1,0,0,1,1,1,0
7893,,,sanstwin,0,1,1,0,1,1,0,0,1,1,1,0
7894,,,PatTwombly,0,1,1,0,1,1,0,0,1,1,1,0
7895,,,sandrapoetry,0,1,1,0,1,1,0,0,1,1,1,0
7896,,,W3rOn1k4,0,1,1,0,1,1,0,0,1,1,1,0
7897,,,BE4RRYCHANIE,0,1,1,0,1,1,0,0,1,1,1,0
7898,,,yuko47533808,0,1,1,0,1,1,0,0,1,1,1,0
7899,,,Fi2009,1,1,2,1,1,2,0,0.006687,0,0,0,0
7900,,,elakhbargate,2,1,3,2,1,3,0.5,0.03434,0,0,0,0
7901,,,drwhocat,6,2,8,6,2,8,0.142857,0.040123,1,1,1,5
7902,,,DjAmbalee,17,1,18,19,2,21,0.058824,0.196435,0,0,0,0
7903,,,cquick00,0,1,1,0,1,1,0,0,1,1,1,0
7904,,,leftnotright,0,1,1,0,1,1,0,0,1,1,1,0
7905,,,ksky9012,2,1,3,2,1,3,0.5,0.013374,0,0,0,0
7906,,,mogien2,0,1,1,0,1,1,0,0,1,1,1,0
7907,,,rice_dough,9,1,10,12,1,13,0.111111,0.060184,0,0,0,0
7908,,,plutanizada,0,1,1,0,1,1,0,0,1,1,1,0
7909,,,EArb81,0,1,1,0,1,1,0,0,1,1,1,0
7910,,,Quhan10,0,1,1,0,1,1,0,0,1,1,1,0
7911,,,paran_aaaaa,0,1,1,0,1,1,0,0,1,1,1,0
7912,,,longtenten,0,1,1,0,1,1,0,0,1,1,1,0
7913,,,bradleejaay,0,1,1,0,1,1,0,0,1,1,1,0
7914,,,cxmmonplaces,1,1,2,1,1,2,0,0.006687,0,0,0,0
7915,,,fel237,0,3,3,0,3,3,0,0,1,1,1,0
7916,,,eztango,2,1,3,2,1,3,0.5,0.013374,0,0,0,0
7917,,,KUNSEARPiERCiNG,1,1,2,1,1,2,0,0.006687,0,0,0,0
7918,,,amarangely,12,1,13,14,3,17,0.083333,0.100103,0,0,0,0
7919,,,G4M3GYU,0,1,1,0,1,1,0,0,1,1,1,0
7920,,,MichaelBraatz13,0,1,1,0,1,1,0,0,1,1,1,0
7921,,,ikarisbiased,7,2,9,7,2,9,0,0.030447,1,1,1,14
7922,,,hagiwararyu11,2,1,3,2,1,3,0.5,0.013374,0,0,0,0
7923,,,nctaryn,0,1,1,0,1,1,0,0,1,1,1,0
7924,,,Kema_cantik,0,1,1,0,1,1,0,0,1,1,1,0
7925,,,skzlow,0,1,1,0,1,1,0,0,2,0.555556,0.6,0
7926,,,QKingcoral,0,1,1,0,1,1,0,0,2,0.555556,0.6,0
7927,,,pleasebemybaek,0,1,1,0,1,1,0,0,2,0.555556,0.6,0
7928,,,japantimes,6,1,7,6,1,7,0.166667,0.040123,0,0,0,0
7929,,,Lucieferasa,0,1,1,0,1,1,0,0,1,1,1,0
7930,,,natuki853,0,3,3,0,3,3,0,0,1,1,1,0
7931,,,derekblad,0,1,1,0,1,1,0,0,1,1,1,0
7932,,,atsomnambulist,0,1,1,0,1,1,0,0,1,1,1,0
7933,,,LisaRei09103400,0,1,1,0,1,1,0,0,1,1,1,0
7934,,,luckiiyu7,0,1,1,0,1,1,0,0,1,1,1,0
7935,,,meaghansgf,1,1,2,1,1,2,0,0.006687,0,0,0,0
7936,,,cinnabun1235,1,1,2,1,1,2,0,0.006687,0,0,0,0
7937,,,RasmusHyltegard,0,1,1,0,1,1,0,0,1,1,1,0
7938,,,tay_tay0512,0,1,1,0,2,2,0,0,1,1,1,0
7939,,,jofh5,0,1,1,0,1,1,0,0,1,1,1,0
7940,,,sky_baker19,0,1,1,0,1,1,0,0,1,1,1,0
7941,,,CDanshina,0,1,1,0,1,1,0,0,1,1,1,0
7942,,,extrabaecon,0,1,1,0,1,1,0,0,1,1,1,0
7943,,,ayyee_me,2,1,3,2,1,3,0.5,0.048317,0,0,0,0
7944,,,zapgotcha,0,1,1,0,1,1,0,0,1,1,1,0
7945,,,SAIKIEKO,0,1,1,0,1,1,0,0,1,1,1,0
7946,,,RepKarenKwan,0,1,1,0,1,1,0,0,1,1,1,0
7947,,,dirteumind,0,1,1,0,1,1,0,0,1,1,1,0
7948,,,enfysblessed,0,1,1,0,1,1,0,0,1,1,1,0
7949,,,pwizo1,1,1,2,1,1,2,0,0.006687,0,0,0,0
7950,,,crinymph084,0,1,1,0,1,1,0,0,1,1,1,0
7951,,,slytherellie,0,2,2,0,2,2,0,0,2,0.75,0.833333,0
7952,,,KSLcom,1,1,2,1,1,2,0,0.006687,0,0,0,0
7953,,,ragdolls1227,3,1,4,3,1,4,0.333333,0.020061,0,0,0,0
7954,,,AckersonBarbara,0,1,1,0,1,1,0,0,1,1,1,0
7955,,,masayosher,0,1,1,0,1,1,0,0,1,1,1,0
7956,,,thembanhmiii,0,2,2,0,2,2,0,0,2,0.75,0.833333,0
7957,,,takukochan,0,1,1,0,1,1,0,0,2,0.666667,0.75,0
7958,,,DOST0EVSKI,0,1,1,0,1,1,0,0,2,0.666667,0.75,0
7959,,,mmmmsnwwww,0,1,1,0,1,1,0,0,2,0.666667,0.75,0
7960,,,CrescentLizzy,2,1,3,2,1,3,0.5,0.013374,0,0,0,0
7961,,,ibasthings,0,1,1,0,1,1,0,0,1,1,1,0
7962,,,TsuduNarita,0,1,1,0,1,1,0,0,1,1,1,0
7963,,,welovehyunjin,8,1,9,8,1,9,0.125,0.06398,0,0,0,0
7964,,,kareunhae,0,1,1,0,1,1,0,0,1,1,1,0
7965,,,lindamurri,0,1,1,0,1,1,0,0,1,1,1,0
7966,,,for_dksoo,0,2,2,0,2,2,0,0,1,1,1,0
7967,,,RaisinZesty,0,1,1,0,1,1,0,0,1,1,1,0
7968,,,komo0oo,0,1,1,0,3,3,0,0,1,1,1,0
7969,,,mary50840570,0,1,1,0,1,1,0,0,1,1,1,0
7970,,,Zoeismycat,0,1,1,0,1,1,0,0,1,1,1,0
7971,,,Mishalee2001,6,1,7,7,1,8,0.166667,0.050606,0,0,0,0
7972,,,vixxkinase,0,1,1,0,2,2,0,0,1,1,1,0
7973,,,laxfairfax,0,1,1,0,1,1,0,0,1,1,1,0
7974,,,nikle84,0,1,1,0,1,1,0,0,1,1,1,0
7975,,,NiseeMcD,0,1,1,0,1,1,0,0,1,1,1,0
7976,,,ravnnies,4,1,5,5,1,6,0.25,0.026749,0,0,0,0
7977,,,Phaedra220,0,1,1,0,1,1,0,0,1,1,1,0
7978,,,HanyuHeeseung,0,1,1,0,1,1,0,0,1,1,1,0
7979,,,btyhurts,6,1,7,6,1,7,0.166667,0.040123,0,0,0,0
7980,,,Celnnee,0,1,1,0,1,1,0,0,1,1,1,0
7981,,,allen_Zzzzzzzz,0,1,1,0,1,1,0,0,1,1,1,0
7982,,,tykakaobcha,0,1,1,0,1,1,0,0,1,1,1,0
7983,,,loanloan,3,1,4,3,1,4,0.333333,0.02705,0,0,0,0
7984,,,jonginternet,0,1,1,0,1,1,0,0,1,1,1,0
7985,,,jimintinybeakie,13,1,14,13,1,14,0.076923,0.097416,0,0,0,0
7986,,,hsarnic,0,1,1,0,1,1,0,0,1,1,1,0
7987,,,YasminI39962571,0,1,1,0,1,1,0,0,1,1,1,0
7988,,,granteb,0,1,1,0,1,1,0,0,1,1,1,0
7989,,,lesbianchangmo,0,1,1,0,1,1,0,0,1,1,1,0
7990,,,MaybeLaterSon,0,1,1,0,1,1,0,0,1,1,1,0
7991,,,safonskawoda,0,1,1,0,1,1,0,0,1,1,1,0
7992,,,cnsowozoo,0,1,1,0,1,1,0,0,1,1,1,0
7993,,,UpstreamPolitic,2,1,3,2,1,3,0.5,0.013374,0,0,0,0
7994,,,94H4NYU,1,1,2,1,1,2,0,0.006687,0,0,0,0
7995,,,gingerchildes,7,1,8,7,1,8,0.142857,0.101934,0,0,0,0
7996,,,MoKnowz_,0,1,1,0,1,1,0,0,1,1,1,0
7997,,,MyMagicDragon,0,1,1,0,1,1,0,0,1,1,1,0
7998,,,bIackcateez,2,1,3,2,1,3,0.5,0.013374,0,0,0,0
7999,,,OrlandoGirl407,0,1,1,0,1,1,0,0,1,1,1,0
8000,,,uraelin,0,1,1,0,1,1,0,0,1,1,1,0
8001,,,z5ongli,0,1,1,0,1,1,0,0,1,1,1,0
8002,,,TheDrive700,0,1,1,0,1,1,0,0,1,1,1,0
8003,,,anshlump,0,1,1,0,1,1,0,0,1,1,1,0
8004,,,ESPN700,2,1,3,2,1,3,0.5,0.013374,0,0,0,0
8005,,,NeighJesusYshua,0,1,1,0,1,1,0,0,1,1,1,0
8006,,,sky_sassia,12,1,13,13,1,14,0.083333,0.136153,0,0,0,0
8007,,,MemereB51,0,1,1,0,1,1,0,0,1,1,1,0
8008,,,Gnaf_FF,0,1,1,0,1,1,0,0,1,1,1,0
8009,,,dadalalalaooo,0,2,2,0,2,2,0,0,3,0.555556,0.666667,0
8010,,,ChrastilGene,0,1,1,0,1,1,0,0,1,1,1,0
8011,,,Oc3Tm,0,1,1,0,1,1,0,0,1,1,1,0
8012,,,maro6thstar,0,1,1,0,1,1,0,0,1,1,1,0
8013,,,2310_mama,0,2,2,0,2,2,0,0,1,1,1,0
8014,,,paul_kramarchyk,2,1,3,2,1,3,0.5,0.013374,0,0,0,0
8015,,,oshjohn1969,1,1,2,1,1,2,0,0.006687,0,0,0,0
8016,,,Chellie9,2,1,3,2,1,3,0.5,0.013374,0,0,0,0
8017,,,TERRYWA72103222,0,1,1,0,1,1,0,0,1,1,1,0
8018,,,C_rentsch,0,1,1,0,1,1,0,0,1,1,1,0
8019,,,orthokimchipac,8,1,9,8,1,9,0.125,0.06398,0,0,0,0
8020,,,yuzu_swan_gold,0,1,1,0,1,1,0,0,1,1,1,0
8021,,,MichaelGThorne1,0,1,1,0,1,1,0,0,1,1,1,0
8022,,,Sweet_PINee,0,1,1,0,1,1,0,0,1,1,1,0
8023,,,koocentre,0,1,1,0,1,1,0,0,1,1,1,0
8024,,,Patrici30775780,0,1,1,0,1,1,0,0,1,1,1,0
8025,,,wesolley,3,1,4,3,1,4,0.333333,0.020061,0,0,0,0
8026,,,tramy_nguyenh,0,1,1,0,1,1,0,0,1,1,1,0
8027,,,JaxGayNews,2,1,3,2,1,3,0.5,0.013374,0,0,0,0
8028,,,camttott,0,2,2,0,2,2,0,0,1,1,1,0
8029,,,jaxgay,2,1,3,2,1,3,0.5,0.013374,0,0,0,0
8030,,,giftgave,0,1,1,0,1,1,0,0,1,1,1,0
8031,,,claire_h_e,8,1,9,8,1,9,0.125,0.053497,0,0,0,0
8032,,,fangirl78123,0,1,1,0,1,1,0,0,1,1,1,0
8033,,,doievoid,0,1,1,0,1,1,0,0,1,1,1,0
8034,,,plantggukie,0,1,1,0,1,1,0,0,1,1,1,0
8035,,,EmpressAriana,0,1,1,0,1,1,0,0,1,1,1,0
8036,,,clumsy_kookie,0,1,1,0,1,1,0,0,1,1,1,0
8037,,,chocolatechiror,0,1,1,0,1,1,0,0,1,1,1,0
8038,,,NicoleHaase,0,1,1,0,1,1,0,0,1,1,1,0
8039,,,MissOquist,2,1,3,2,1,3,0.5,0.013374,0,0,0,0
8040,,,staran1981,0,3,3,0,3,3,0,0,1,1,1,0
8041,,,notkaylastweets,2,1,3,2,1,3,0.5,0.013374,0,0,0,0
8042,,,soouniverse,0,1,1,0,1,1,0,0,1,1,1,0
8043,,,mmcaf1,6,1,7,6,1,7,0.166667,0.040123,0,0,0,0
8044,,,sulfi_7,0,1,1,0,1,1,0,0,1,1,1,0
8045,,,birdwriter7,0,1,1,0,1,1,0,0,1,1,1,0
8046,,,rayxsth,0,1,1,0,1,1,0,0,1,1,1,0
8047,,,JohnFriedri,0,1,1,0,1,1,0,0,1,1,1,0
8048,,,vitisbibi,0,1,1,0,1,1,0,0,1,1,1,0
8049,,,ScottHamilton84,9,1,10,9,1,10,0.111111,0.060184,0,0,0,0
8050,,,hyejooslug,0,1,1,0,1,1,0,0,1,1,1,0
8051,,,RAI54326029,0,1,1,0,1,1,0,0,1,1,1,0
8052,,,gwynethyutiamco,0,1,1,0,1,1,0,0,1,1,1,0
8053,,,nathan_wavy,0,2,2,0,2,2,0,0,1,1,1,0
8054,,,SengTaikor,0,1,1,0,1,1,0,0,1,1,1,0
8055,,,TomWAVYTV,0,2,2,0,2,2,0,0,1,1,1,0
8056,,,NathanChen_Fan,0,7,7,0,7,7,0.02381,0,6,0.351351,0.444017,0
8057,,,spaceboundiza,0,1,1,0,1,1,0,0,1,1,1,0
8058,,,erikakcarlson,5,1,6,5,1,6,0.2,0.033436,0,0,0,0
8059,,,AnitaWAVY,0,2,2,0,2,2,0,0,1,1,1,0
8060,,,HelloImIan27,0,1,1,0,1,1,0,0,1,1,1,0
8061,,,zayouna_desir,0,1,1,0,1,1,0,0,1,1,1,0
8062,,,WAVY_News,3,3,6,4,4,8,0.2,0.020061,1,1,1,4
8063,,,Yuzu_islove,0,2,2,0,2,2,0,0,2,0.666667,0.75,0
8064,,,_skull_997,0,1,1,0,1,1,0,0,2,0.6,0.666667,0
8065,,,sk8mom007,1,1,2,1,1,2,0,0.006687,0,0,0,0
8066,,,Iesbilse,10,1,11,10,1,11,0.1,0.066871,0,0,0,0
8067,,,ruirwi,0,1,1,0,1,1,0,0,1,1,1,0
8068,,,ashima9090,0,1,1,0,1,1,0,0,1,1,1,0
8069,,,pennydoodledump,0,1,1,0,1,1,0,0,1,1,1,0
8070,,,SocialWJustice1,0,3,3,0,3,3,0,0,1,1,1,0
8071,,,luvzyxzjs,0,1,1,0,1,1,0,0,1,1,1,0
8072,,,meairy,0,1,1,0,1,1,0,0,1,1,1,0
8073,,,DougGator144,0,1,1,0,1,1,0,0,1,1,1,0
8074,,,readership1981,0,1,1,0,1,1,0,0,1,1,1,0
8075,,,jlynngansch,3,1,4,3,1,4,0.333333,0.020061,0,0,0,0
8076,,,roseetea,0,1,1,0,1,1,0,0,1,1,1,0
8077,,,Ming_tweet,0,1,1,0,1,1,0,0,1,1,1,0
8078,,,pzyduckie,12,1,13,15,3,18,0.083333,0.080246,0,0,0,0
8079,,,ValJorRom,0,1,1,0,1,1,0,0,1,1,1,0
8080,,,jcasas8512,0,1,1,0,1,1,0,0,1,1,1,0
8081,,,sportsCourt,0,1,1,0,1,1,0,0,1,1,1,0
8082,,,yisanghoon0401,6,1,7,7,2,9,0.166667,0.040123,0,0,0,0
8083,,,tzkdIin,0,1,1,0,1,1,0,0,1,1,1,0
8084,,,cobainlegacy,0,1,1,0,1,1,0,0,1,1,1,0
8085,,,Blairiyuh,0,1,1,0,1,1,0,0,1,1,1,0
8086,,,restebanrf1993,0,1,1,0,1,1,0,0,1,1,1,0
8087,,,serrano_rene,0,3,3,0,3,3,0,0,1,1,1,0
8088,,,clairewillett,1,1,2,2,2,4,0,0.006687,0,0,0,0
8089,,,bfforcejs,2,1,3,2,1,3,0.5,0.013374,0,0,0,0
8090,,,crumbled_pastry,0,1,1,0,1,1,0,0,1,1,1,0
8091,,,BadClassical,4,1,5,4,1,5,0.25,0.026749,0,0,0,0
8092,,,ygr666,0,1,1,0,1,1,0,0,1,1,1,0
8093,,,carpediemscl,0,1,1,0,1,1,0,0,1,1,1,0
8094,,,gintiiii_,2,1,3,2,1,3,0.5,0.013374,0,0,0,0
8095,,,exulzae,0,1,1,0,1,1,0,0,1,1,1,0
8096,,,zoafartz,2,1,3,2,1,3,0.5,0.013374,0,0,0,0
8097,,,swiftgustd,0,1,1,0,1,1,0,0,1,1,1,0
8098,,,trojangold,5,1,6,9,1,10,0.2,0.033436,0,0,0,0
8099,,,JacksanYang,0,1,1,0,1,1,0,0,1,1,1,0
8100,,,poohhanyu,0,8,8,0,13,13,0,0,2,0.75,0.833333,0
8101,,,Bigobie1102,0,1,1,0,1,1,0,0,1,1,1,0
8102,,,MicheleManatt,2,1,3,3,1,4,0.5,0.013374,0,0,0,0
8103,,,dpopoet,1,1,2,1,1,2,0,0.006687,0,0,0,0
8104,,,RaffaellaDeFili,0,1,1,0,1,1,0,0,1,1,1,0
8105,,,oldmomnow,0,1,1,0,1,1,0,0,1,1,1,0
8106,,,FarraHrag,0,1,1,0,1,1,0,0,1,1,1,0
8107,,,jameekassandra,1,1,2,1,1,2,0,0.006687,0,0,0,0
8108,,,yang_lpy1999,1,1,2,1,1,2,0,0.006687,0,0,0,0
8109,,,EIFY,14,1,15,14,1,15,0.071429,0.09362,0,0,0,0
8110,,,bethanylozier,0,2,2,0,2,2,0,0,1,1,1,0
8111,,,SkonieSkoop,0,1,1,0,1,1,0,0,1,1,1,0
8112,,,papijones4,0,1,1,0,1,1,0,0,1,1,1,0
8113,,,23Bf1X5nGBx589R,0,1,1,0,1,1,0,0,1,1,1,0
8114,,,Liebefacts,0,1,1,0,1,1,0,0,1,1,1,0
8115,,,GrossAmilee,0,1,1,0,1,1,0,0,1,1,1,0
8116,,,JennWQuinlan,0,1,1,0,1,1,0,0,1,1,1,0
8117,,,Baby_J44,0,1,1,0,1,1,0,0,1,1,1,0
8118,,,ITACHICARTER,0,1,1,0,1,1,0,0,1,1,1,0
8119,,,annablabs,4,1,5,6,1,7,0.25,0.065696,0,0,0,0
8120,,,Ynjames6396,14,1,15,14,1,15,0,0.058166,1,1,1,14
8121,,,emperorweiner,0,1,1,0,1,1,0,0,1,1,1,0
8122,,,HarleyBendaWBOY,4,1,5,4,1,5,0.25,0.026749,0,0,0,0
8123,,,catboysmarklix,0,1,1,0,1,1,0,0,1,1,1,0
8124,,,TheRobinCousins,0,1,1,0,1,1,0,0,1,1,1,0
8125,,,CaptainPeeKay,0,1,1,0,1,1,0,0,1,1,1,0
8126,,,wbaltv11,7,1,8,8,2,10,0.142857,0.081752,0,0,0,0
8127,,,hoseoccc,0,1,1,0,1,1,0,0,1,1,1,0
8128,,,HangMingda,0,1,1,0,1,1,0,0,2,0.538462,0.571429,0
8129,,,XinghuiG,1,1,2,1,1,2,0,0.006687,0,0,0,0
8130,,,ShunL0v343v4,0,1,1,0,1,1,0,0,1,1,1,0
8131,,,wabbitt_q,0,1,1,0,1,1,0,0,1,1,1,0
8132,,,RexPugmire,0,1,1,0,1,1,0,0,2,0.666667,0.75,0
8133,,,sssskxA4,0,1,1,0,1,1,0,0,2,0.666667,0.75,0
8134,,,notanegirlpls,6,1,7,6,1,7,0.166667,0.040123,0,0,0,0
8135,,,ethereal_yae,0,1,1,0,1,1,0,0,1,1,1,0
8136,,,fredarachel1952,0,1,1,0,1,1,0,0,1,1,1,0
8137,,,TQTsDHOZ5Wmul9U,0,1,1,0,1,1,0,0,1,1,1,0
8138,,,boywlove,0,1,1,0,1,1,0,0,1,1,1,0
8139,,,bieIlmann,0,1,1,0,1,1,0,0,1,1,1,0
8140,,,JuyeonTBZ02,5,1,6,6,1,7,0.2,0.03693,0,0,0,0
8141,,,TheCleve30,0,1,1,0,1,1,0,0,1,1,1,0
8142,,,skywise478,0,1,1,0,1,1,0,0,1,1,1,0
8143,,,pau_amezcua123,0,1,1,0,1,1,0,0,1,1,1,0
8144,,,CarolineHuntoon,3,1,4,3,1,4,0.333333,0.020061,0,0,0,0
8145,,,WoshanSheik,0,1,1,0,1,1,0,0,1,1,1,0
8146,,,loseyowife,0,1,1,0,1,1,0,0,2,0.538462,0.571429,0
8147,,,interestelarkat,0,1,1,0,1,1,0,0,2,0.538462,0.571429,0
8148,,,yeoliebestboy,0,1,1,0,1,1,0,0,2,0.538462,0.571429,0
8149,,,jellyiren,9,1,10,9,1,10,0.111111,0.116092,0,0,0,0
8150,,,Belleyee88,0,1,1,0,1,1,0,0,1,1,1,0
8151,,,yalemetaI,0,1,1,0,1,1,0,0,1,1,1,0
8152,,,HeskethTuck,0,1,1,0,1,1,0,0,1,1,1,0
8153,,,sandra73468727,0,1,1,0,1,1,0,0,1,1,1,0
8154,,,Phillygirl1441,0,1,1,0,1,1,0,0,1,1,1,0
8155,,,_sunnysarah,0,1,1,0,1,1,0,0,1,1,1,0
8156,,,goonerkate,5,1,6,5,1,6,0.2,0.033436,0,0,0,0
8157,,,ddramona,0,1,1,0,1,1,0,0,1,1,1,0
8158,,,enby_panic,0,1,1,0,1,1,0,0,1,1,1,0
8159,,,neergpainter,0,1,1,0,1,1,0,0,1,1,1,0
8160,,,KatieCollettTV,0,1,1,0,1,1,0,0,1,1,1,0
8161,,,voodookunt,1,1,2,1,1,2,0,0.006687,0,0,0,0
8162,,,LDrakkaris,4,1,5,4,1,5,0.25,0.026749,0,0,0,0
8163,,,Christin210,0,1,1,0,1,1,0,0,1,1,1,0
8164,,,OystianSinclair,0,1,1,0,1,1,0,0,1,1,1,0
8165,,,cafebleu_karen,0,1,1,0,1,1,0,0,1,1,1,0
8166,,,NME,6,1,7,6,1,7,0.166667,0.040123,0,0,0,0
8167,,,JadaJones57,0,1,1,0,1,1,0,0,1,1,1,0
8168,,,LAT_ChrisStone,0,1,1,0,1,1,0,0,1,1,1,0
8169,,,Kismap_0909,0,1,1,0,1,1,0,0,1,1,1,0
8170,,,jennmheath,4,1,5,4,1,5,0.25,0.026749,0,0,0,0
8171,,,C4TSINL0VE,0,1,1,0,1,1,0,0,1,1,1,0
8172,,,4evrmomof4,0,1,1,0,1,1,0,0,1,1,1,0
8173,,,Hoesuckclub,1,1,2,1,1,2,0,0.006687,0,0,0,0
8174,,,BigJimDanoon,3,1,4,3,1,4,0.333333,0.020061,0,0,0,0
8175,,,bellewithluv,0,1,1,0,1,1,0,0,1,1,1,0
8176,,,BeWater84640726,0,1,1,0,1,1,0,0,3,0.465116,0.483333,0
8177,,,LPlothow,0,1,1,0,1,1,0,0,1,1,1,0
8178,,,lmhtapes,1,1,2,1,1,2,0,0.006687,0,0,0,0
8179,,,Skating68,5,1,6,6,1,7,0.2,0.096332,0,0,0,0
8180,,,beau2104,0,1,1,0,1,1,0,0,1,1,1,0
8181,,,060320na,0,1,1,0,1,1,0,0,1,1,1,0
8182,,,Av4nna,0,1,1,0,1,1,0,0,1,1,1,0
8183,,,KOLYADABOT,4,1,5,4,1,5,0.25,0.026749,0,0,0,0
8184,,,saturnjunmyeon,0,1,1,0,1,1,0,0,1,1,1,0
8185,,,fromdebs,0,3,3,0,3,3,0,0,1,1,1,0
8186,,,avclre,3,2,5,3,2,5,0.25,0.020061,1,1,1,2
8187,,,tiffanikatepan,0,4,4,0,4,4,0,0,2,0.7,0.785714,0
8188,,,bikeguy2,0,1,1,0,1,1,0,0,1,1,1,0
8189,,,1FreshTake,0,1,1,0,1,1,0,0,1,1,1,0
8190,,,SylviaSGoodman4,2,1,3,2,1,3,0.5,0.013374,0,0,0,0
8191,,,BeccaBo50830907,4,1,5,4,1,5,0.25,0.026749,0,0,0,0
8192,,,beatlebabe49,0,1,1,0,1,1,0,0,1,1,1,0
8193,,,sakura79yz,0,1,1,0,1,1,0,0,1,1,1,0
8194,,,Rarisa77,5,2,7,5,2,7,0.166667,0.040424,1,1,1,5
8195,,,koreaerok,0,1,1,0,1,1,0,0,2,0.666667,0.75,0
8196,,,kerihyde67,0,1,1,0,1,1,0,0,2,0.666667,0.75,0
8197,,,halfwaytnwhere,0,1,1,0,1,1,0,0,2,0.666667,0.75,0
8198,,,toxicb_y,0,1,1,0,1,1,0,0,2,0.538462,0.571429,0
8199,,,cherrybubs08,0,1,1,0,1,1,0,0,2,0.538462,0.571429,0
8200,,,WomenWhoDare,0,1,1,0,1,1,0,0,2,0.538462,0.571429,0
8201,,,YrBittrEx,1,1,2,1,1,2,0,0.006687,0,0,0,0
8202,,,_oftoday_,4,1,5,4,1,5,0.25,0.026749,0,0,0,0
8203,,,boysyakarsoon,0,1,1,0,1,1,0,0,1,1,1,0
8204,,,Kierceldwen,0,1,1,0,1,1,0,0,1,1,1,0
8205,,,__43oxox,0,4,4,0,4,4,0,0,1,1,1,0
8206,,,PDXPinky,2,1,3,2,1,3,0.5,0.013374,0,0,0,0
8207,,,jktaru,0,1,1,0,1,1,0,0,1,1,1,0
8208,,,Maleko_ai,0,2,2,0,2,2,0,0,1,1,1,0
8209,,,dooscarfox,3,1,4,3,1,4,0.333333,0.02705,0,0,0,0
8210,,,minsugatrasher,0,1,1,0,1,1,0,0,1,1,1,0
8211,,,HeatherInCO1,3,1,4,4,1,5,0.333333,0.020061,0,0,0,0
8212,,,NewsandRecord,1,1,2,1,1,2,0,0.006687,0,0,0,0
8213,,,WandaNon,3,1,4,3,1,4,0.333333,0.020061,0,0,0,0
8214,,,SatanKaichou,0,1,1,0,1,1,0,0,1,1,1,0
8215,,,juliewa43117224,0,2,2,0,2,2,0,0,1,1,1,0
8216,,,lilycumc,4,3,7,4,3,7,0.166667,0.026749,1,1,1,6
8217,,,wanqxianz,0,1,1,0,1,1,0,0,2,0.6,0.666667,0
8218,,,BiffLaTourette,0,1,1,0,1,1,0,0,2,0.6,0.666667,0
8219,,,wildern355,0,1,1,0,1,1,0,0,2,0.6,0.666667,0
8220,,,hoshiwols,3,1,4,3,1,4,0.333333,0.020061,0,0,0,0
8221,,,feeling_emptyy_,0,1,1,0,1,1,0,0,1,1,1,0
8222,,,dztulloch,0,1,1,0,1,1,0,0,1,1,1,0
8223,,,IsabellaDovale5,4,1,5,4,1,5,0.25,0.032203,0,0,0,0
8224,,,mojazlatko,0,1,1,0,1,1,0,0,1,1,1,0
8225,,,cingulom4nia,0,1,1,0,1,1,0,0,1,1,1,0
8226,,,problematik_era,2,1,3,2,1,3,0.5,0.013374,0,0,0,0
8227,,,ElaineDeyoe,0,1,1,0,1,1,0,0,1,1,1,0
8228,,,troubIemakers,5,2,7,5,2,7,0.166667,0.033436,1,1,1,4
8229,,,swoopute0226,0,1,1,0,1,1,0,0,2,0.666667,0.75,0
8230,,,wintervante1230,0,1,1,0,1,1,0,0,2,0.666667,0.75,0
8231,,,kirstinosgood,0,1,1,0,1,1,0,0,2,0.666667,0.75,0
8232,,,namu__namu___,0,1,1,0,1,1,0,0,2,0.666667,0.75,0
8233,,,DonaldMBraden,1,1,2,1,1,2,0,0.006687,0,0,0,0
8234,,,aelizabethI,0,1,1,0,1,1,0,0,1,1,1,0
8235,,,swaybangtan,0,1,1,0,1,1,0,0,1,1,1,0
8236,,,Biatryce,0,1,1,0,1,1,0,0,1,1,1,0
8237,,,loeysgalaxy614,0,2,2,0,2,2,0,0,1,1,1,0
8238,,,fabershields,0,1,1,0,1,1,0,0,1,1,1,0
8239,,,kbutler127,0,1,1,0,1,1,0,0,1,1,1,0
8240,,,SusieKline,5,1,6,5,1,6,0.2,0.033436,0,0,0,0
8241,,,CamronHarris15,0,1,1,0,1,1,0,0,1,1,1,0
8242,,,lizzieliz342,0,1,1,0,1,1,0,0,1,1,1,0
8243,,,gendereviI,9,1,10,11,2,13,0.111111,0.063679,0,0,0,0
8244,,,xmagicmomentsx,0,1,1,0,1,1,0,0,1,1,1,0
8245,,,pastapainmeds,0,1,1,0,1,1,0,0,1,1,1,0
8246,,,cryosubin,0,1,1,0,1,1,0,0,1,1,1,0
8247,,,hopeduckie,0,1,1,0,1,1,0,0,1,1,1,0
8248,,,sorrynotsarika,2,1,3,2,1,3,0.5,0.013374,0,0,0,0
8249,,,ketchmeifucan,0,1,1,0,1,1,0,0,1,1,1,0
8250,,,pineapplebeomie,4,1,5,4,1,5,0.25,0.054702,0,0,0,0
8251,,,uscftball,0,1,1,0,1,1,0,0,1,1,1,0
8252,,,SusanC916,8,2,10,8,2,10,0.111111,0.053497,1,1,1,7
8253,,,FiredrakeFervid,0,1,1,0,1,1,0,0,1,1,1,0
8254,,,scientist_for,0,1,1,0,1,1,0,0,1,1,1,0
8255,,,rayyzio,0,1,1,0,1,1,0,0,1,1,1,0
8256,,,debbie_li,0,1,1,0,1,1,0,0,1,1,1,0
8257,,,sumaleedotcom,0,1,1,0,1,1,0,0,1,1,1,0
8258,,,coochjuice,0,1,1,0,1,1,0,0,1,1,1,0
8259,,,dean_sigma,0,1,1,0,1,1,0,0,1,1,1,0
8260,,,hopesalive12,4,1,5,4,1,5,0.25,0.026749,0,0,0,0
8261,,,IO_Chris,0,1,1,0,1,1,0,0,1,1,1,0
8262,,,onemorecin2,0,1,1,0,1,1,0,0,1,1,1,0
8263,,,ORDiane,0,1,1,0,1,1,0,0,1,1,1,0
8264,,,kikipenny,2,1,3,2,1,3,0.5,0.013374,0,0,0,0
8265,,,moonjunss,0,1,1,0,1,1,0,0,1,1,1,0
8266,,,KSLcomSports,1,1,2,1,1,2,0,0.006687,0,0,0,0
8267,,,Wsterrell,0,1,1,0,1,1,0,0,1,1,1,0
8268,,,nothewayitlooks,0,1,1,0,1,1,0,0,1,1,1,0
8269,,,PandemicTruther,17,1,18,17,1,18,0.058824,0.113681,0,0,0,0
8270,,,Tanis42,0,1,1,0,1,1,0,0,1,1,1,0
8271,,,JulianaF53,0,1,1,0,1,1,0,0,1,1,1,0
8272,,,crlulukat,0,1,1,0,1,1,0,0,1,1,1,0
8273,,,olivia_p_walker,0,1,1,0,1,1,0,0,1,1,1,0
8274,,,lykke71,0,1,1,0,1,1,0,0,1,1,1,0
8275,,,kilvon,0,1,1,0,1,1,0,0,1,1,1,0
8276,,,adeqana_12,0,1,1,0,1,1,0,0,1,1,1,0
8277,,,KareAnderson,0,1,1,0,1,1,0,0,1,1,1,0
8278,,,mskathykhang,0,1,1,0,1,1,0,0,1,1,1,0
8279,,,ethicalcourage,0,1,1,0,1,1,0,0,1,1,1,0
8280,,,lover_yuzuru,0,1,1,0,1,1,0,0,1,1,1,0
8281,,,DemetErbas,3,1,4,3,1,4,0.333333,0.020061,0,0,0,0
8282,,,YourProcessGuy,0,1,1,0,1,1,0,0,1,1,1,0
8283,,,AllieMannheimer,0,1,1,0,1,1,0,0,1,1,1,0
8284,,,StensaasTessa,0,1,1,0,1,1,0,0,1,1,1,0
8285,,,sanulllim,0,1,1,0,1,1,0,0,1,1,1,0
8286,,,tearym00n,1,1,2,1,1,2,0,0.006687,0,0,0,0
8287,,,ecchen1,11,1,12,11,1,12,0.090909,0.135006,0,0,0,0
8288,,,v5jTwgyGMWlPos5,0,2,2,0,2,2,0,0,1,1,1,0
8289,,,abcd127127127,0,1,1,0,1,1,0,0,1,1,1,0
8290,,,KelleyDiarmid,0,1,1,0,1,1,0,0,1,1,1,0
8291,,,ciaoAbby,0,1,1,0,1,1,0,0,1,1,1,0
8292,,,EnterCesar,0,1,1,0,1,1,0,0,1,1,1,0
8293,,,FSinHarlem,1,2,3,1,2,3,0.5,0.006687,1,1,1,0
8294,,,mac_attack13,0,1,1,0,1,1,0,0,1,1,1,0
8295,,,Caiterz4Catz,3,1,4,4,1,5,0.333333,0.075185,0,0,0,0
8296,,,BillOccham,7,1,8,8,1,9,0.142857,0.04681,0,0,0,0
8297,,,ASpooorts,0,1,1,0,1,1,0,0,1,1,1,0
8298,,,jins_plump_lips,0,1,1,0,1,1,0,0,1,1,1,0
8299,,,usamaro0713,0,1,1,0,1,1,0,0,1,1,1,0
8300,,,jengrimes8,0,1,1,0,1,1,0,0,1,1,1,0
8301,,,RealJeffSnyder,0,1,1,0,1,1,0,0,1,1,1,0
8302,,,goomygoom1,0,1,1,0,1,1,0,0,1,1,1,0
8303,,,KbuTsuPwCrL4omN,0,1,1,0,1,1,0,0,1,1,1,0
8304,,,disconcerto,0,1,1,0,1,1,0,0,1,1,1,0
8305,,,gyarufied,3,1,4,3,1,4,0.333333,0.020061,0,0,0,0
8306,,,an_ryo8,0,1,1,0,1,1,0,0,1,1,1,0
8307,,,Marielena_TV,4,1,5,6,2,8,0.333333,0.037231,0,0,0,0
8308,,,LUCY_5124,0,1,1,0,1,1,0,0,1,1,1,0
8309,,,0h_Mariaa,1,1,2,1,1,2,0,0.006687,0,0,0,0
8310,,,_ayelenati,6,1,7,6,1,7,0.166667,0.095246,0,0,0,0
8311,,,JonDowding,0,2,2,0,2,2,0,0,1,1,1,0
8312,,,TheFlyOnThePen1,2,1,3,2,1,3,0.5,0.023857,0,0,0,0
8313,,,WAVY10Bob,1,1,2,1,1,2,0,0.006687,0,0,0,0
8314,,,jaz_hag,4,1,5,4,1,5,0.25,0.026749,0,0,0,0
8315,,,alissa033,0,1,1,0,1,1,0,0,1,1,1,0
8316,,,carol_clovely4,0,1,1,0,1,1,0,0,1,1,1,0
8317,,,jeonskvt,0,1,1,0,1,1,0,0,1,1,1,0
8318,,,thechloeallen,3,2,5,3,3,6,0.25,0.020061,1,1,1,2
8319,,,sk8rky10,0,1,1,0,1,1,0,0,2,0.666667,0.75,0
8320,,,steffidilse,0,1,1,0,1,1,0,0,2,0.666667,0.75,0
8321,,,S0FTC0FFIN,3,1,4,3,1,4,0.333333,0.020061,0,0,0,0
8322,,,Xieerlove,0,1,1,0,1,1,0,0,1,1,1,0
8323,,,bobcrowder,0,1,1,0,1,1,0,0,1,1,1,0
8324,,,hopyeji,7,1,8,7,1,8,0.166667,0.057293,0,0,0,0
8325,,,jacque_cottrell,0,1,1,0,1,1,0,0,1,1,1,0
8326,,,uhhitsjamie,0,1,1,0,1,1,0,0,1,1,1,0
8327,,,LonghandPencils,0,1,1,0,1,1,0,0,1,1,1,0
8328,,,monaniwho,0,1,1,0,1,1,0,0,1,1,1,0
8329,,,Micheekayy,6,1,7,6,1,7,0.166667,0.105729,0,0,0,0
8330,,,BYUSuperFan1,0,1,1,0,1,1,0,0,1,1,1,0
8331,,,SabaAthif,0,1,1,0,1,1,0,0,1,1,1,0
8332,,,rikkoff0711,0,1,1,0,1,1,0,0,1,1,1,0
8333,,,astralsprggn,0,1,1,0,1,1,0,0,1,1,1,0
8334,,,Joyce1Kathy,3,1,4,3,1,4,0.333333,0.020061,0,0,0,0
8335,,,ekko4511,0,1,1,0,1,1,0,0,1,1,1,0
8336,,,br4vegrls,0,1,1,0,1,1,0,0,1,1,1,0
8337,,,hellarexy,3,1,4,3,1,4,0.333333,0.034038,0,0,0,0
8338,,,Pat23110589,1,1,2,1,1,2,0,0.006687,0,0,0,0
8339,,,usportsnow,1,1,2,1,1,2,0,0.006687,0,0,0,0
8340,,,lovelybbytan,3,1,4,3,1,4,0.333333,0.034038,0,0,0,0
8341,,,darrrlinngg,0,1,1,0,1,1,0,0,2,0.6,0.666667,0
8342,,,pjmhmu,0,1,1,0,1,1,0,0,2,0.6,0.666667,0
8343,,,minhyoungsong,2,1,3,2,1,3,0.5,0.013374,0,0,0,0
8344,,,mochimantm,0,1,1,0,1,1,0,0,1,1,1,0
8345,,,coda3star,6,1,7,6,1,7,0.166667,0.040123,0,0,0,0
8346,,,ShadowbannedRep,0,1,1,0,1,1,0,0,1,1,1,0
8347,,,DianeWang8,0,1,1,0,1,1,0,0,1,1,1,0
8348,,,toriamaasehun,0,1,1,0,1,1,0,0,1,1,1,0
8349,,,kordeipinks,0,1,1,0,1,1,0,0,1,1,1,0
8350,,,Mercede97927330,0,1,1,0,1,1,0,0,1,1,1,0
8351,,,zyxsouleri,3,1,4,3,1,4,0.333333,0.020061,0,0,0,0
8352,,,mist_mae,0,2,2,0,2,2,0,0,1,1,1,0
8353,,,suncheonsa,3,1,4,3,1,4,0.333333,0.023556,0,0,0,0
8354,,,Clair_lab,0,1,1,0,1,1,0,0,1,1,1,0
8355,,,yeo9z,13,1,14,16,4,20,0.076923,0.086933,0,0,0,0
8356,,,whtdaffodil,0,1,1,0,1,1,0,0,1,1,1,0
8357,,,MATZPIRATE,0,1,1,0,1,1,0,0,1,1,1,0
8358,,,LionQue39480372,11,1,12,14,2,16,0.090909,0.073559,0,0,0,0
8359,,,penguinpaddle,3,1,4,3,1,4,0.333333,0.020061,0,0,0,0
8360,,,KellandC,0,1,1,0,1,1,0,0,1,1,1,0
8361,,,_y_ulissa,0,1,1,0,1,1,0,0,1,1,1,0
8362,,,lu_weiping,1,1,2,1,1,2,0,0.006687,0,0,0,0
8363,,,PanguloPrince,9,4,13,10,5,15,0.083333,0.063679,1,1,1,24
8364,,,seuilrene,2,1,3,2,1,3,0.5,0.013374,0,0,0,0
8365,,,Fuking_CrazyTie,0,1,1,0,1,1,0,0,1,1,1,0
8366,,,mrstevenrowley,1,1,2,1,1,2,0,0.006687,0,0,0,0
8367,,,favritRB,0,1,1,0,1,1,0,0,2,0.666667,0.75,0
8368,,,lojuha1,0,1,1,0,1,1,0,0,2,0.666667,0.75,0
8369,,,jetpuffbubblez,0,1,1,0,1,1,0,0,2,0.666667,0.75,0
8370,,,portnekosan,0,1,1,0,1,1,0,0,2,0.666667,0.75,0
8371,,,JonesShanna99,0,1,1,0,1,1,0,0,2,0.666667,0.75,0
8372,,,potatoeloop,0,1,1,0,1,1,0,0,2,0.666667,0.75,0
8373,,,Moonihae,0,1,1,0,1,1,0,0,2,0.666667,0.75,0
8374,,,GiannaJax,0,1,1,0,1,1,0,0,2,0.666667,0.75,0
8375,,,kennykennynyc,1,1,2,1,1,2,0,0.006687,0,0,0,0
8376,,,GawlinskiLaura,0,1,1,0,1,1,0,0,1,1,1,0
8377,,,ygstan0515,0,1,1,0,1,1,0,0,1,1,1,0
8378,,,AlwaysOptimist7,0,1,1,0,1,1,0,0,1,1,1,0
8379,,,NotToday0299,0,1,1,0,1,1,0,0,1,1,1,0
8380,,,ValeFangirl74,0,1,1,0,1,1,0,0,1,1,1,0
8381,,,Yaemin189,0,1,1,0,1,1,0,0,1,1,1,0
8382,,,SottonaPerDekuu,0,1,1,0,1,1,0,0,1,1,1,0
8383,,,gwjiminie,0,1,1,0,1,1,0,0,1,1,1,0
8384,,,JimInClwr,0,1,1,0,1,1,0,0,1,1,1,0
8385,,,JeanineT3,0,2,2,0,2,2,0,0,1,1,1,0
8386,,,kqSFRKS3ctohj29,0,1,1,0,1,1,0,0,1,1,1,0
8387,,,tnbfla,6,1,7,6,1,7,0.166667,0.040123,0,0,0,0
8388,,,Sanastasea1,0,1,1,0,1,1,0,0,1,1,1,0
8389,,,Sneaky__Ben,0,1,1,0,1,1,0,0,1,1,1,0
8390,,,grandmabarbara,0,1,1,0,1,1,0,0,1,1,1,0
8391,,,Frog_Feathers,0,1,1,0,1,1,0,0,1,1,1,0
8392,,,JordaanS,6,1,7,6,1,7,0.166667,0.075969,0,0,0,0
8393,,,cheolsf,0,1,1,0,1,1,0,0,1,1,1,0
8394,,,APSE_sportmedia,0,1,1,0,1,1,0,0,1,1,1,0
8395,,,KingdomVel,0,1,1,0,1,1,0,0,1,1,1,0
8396,,,heeres_shini,2,1,3,2,1,3,0.5,0.013374,0,0,0,0
8397,,,zhangtruth1,0,1,1,0,1,1,0,0,1,1,1,0
8398,,,binicarus,0,1,1,0,1,1,0,0,1,1,1,0
8399,,,weirdgardenerd,0,1,1,0,1,1,0,0,1,1,1,0
8400,,,ryugubokkie,0,1,1,0,1,1,0,0,1,1,1,0
8401,,,ariannahuff,1,1,2,1,1,2,0,0.006687,0,0,0,0
8402,,,Courtne76853573,2,1,3,2,1,3,0.5,0.013374,0,0,0,0
8403,,,cyannhue,1,1,2,1,1,2,0,0.006687,0,0,0,0
8404,,,rtalalay,3,1,4,3,1,4,0.333333,0.020061,0,0,0,0
8405,,,navywife53sco,0,1,1,0,1,1,0,0,1,1,1,0
8406,,,anna_buyse,0,2,2,0,2,2,0,0,1,1,1,0
8407,,,VirTanadhal,0,1,1,0,1,1,0,0,3,0.5,0.541667,0
8408,,,DogsNDemocrats,7,1,8,8,2,10,0.142857,0.053798,0,0,0,0
8409,,,heavensxul,2,1,3,2,1,3,0.5,0.013374,0,0,0,0
8410,,,astrodynes,0,1,1,0,1,1,0,0,1,1,1,0
8411,,,LisaHair9,1,1,2,1,1,2,0,0.006687,0,0,0,0
8412,,,KSHB41,1,1,2,1,1,2,0,0.006687,0,0,0,0
8413,,,cisco_utahute,0,1,1,0,1,1,0,0,1,1,1,0
8414,,,grandma_lynnee,0,1,1,0,1,1,0,0,1,1,1,0
8415,,,IonaItalia,0,1,1,0,1,1,0,0,1,1,1,0
8416,,,jess1962,0,2,2,0,2,2,0,0,1,1,1,0
8417,,,nat_luvsuu,0,1,1,0,1,1,0,0,1,1,1,0
8418,,,p3rkjmn,0,1,1,0,1,1,0,0,1,1,1,0
8419,,,ictgth,0,1,1,0,1,1,0,0,1,1,1,0
8420,,,CommunistPrinc1,0,1,1,0,1,1,0,0,1,1,1,0
8421,,,boyisagun4,0,3,3,0,4,4,0,0,2,0.8,0.875,0
8422,,,NickyP194,0,1,1,0,1,1,0,0,1,1,1,0
8423,,,QuotidienEurope,0,1,1,0,1,1,0,0,1,1,1,0
8424,,,1jb1,0,1,1,0,1,1,0,0,1,1,1,0
8425,,,KidsPress,0,1,1,0,1,1,0,0,1,1,1,0
8426,,,YukiRekishi,0,1,1,0,1,1,0,0,1,1,1,0
8427,,,LAunvrz,4,1,5,4,1,5,0.25,0.026749,0,0,0,0
8428,,,Chase_Glorfield,0,1,1,0,1,1,0,0,1,1,1,0
8429,,,constantblur_,0,2,2,0,2,2,0,0,1,1,1,0
8430,,,skidmore11,0,1,1,0,1,1,0,0,1,1,1,0
8431,,,Madame_Wiladina,0,1,1,0,1,1,0,0,1,1,1,0
8432,,,RedStaplerGuy,0,1,1,0,1,1,0,0,1,1,1,0
8433,,,hoosierscholar7,0,1,1,0,1,1,0,0,1,1,1,0
8434,,,wICsQvfmueyW5Bo,0,1,1,0,1,1,0,0,1,1,1,0
8435,,,TPangoro,0,1,1,0,1,1,0,0,1,1,1,0
8436,,,SeaAnemones_,0,1,1,0,1,1,0,0,1,1,1,0
8437,,,JamesGross,0,1,1,0,1,1,0,0,1,1,1,0
8438,,,ocatipus,0,1,1,0,1,1,0,0,1,1,1,0
8439,,,inarizakis,13,1,14,14,1,15,0.076923,0.086933,0,0,0,0
8440,,,GilliesJacky,0,1,1,0,1,1,0,0,1,1,1,0
8441,,,vitaminosh,0,1,1,0,1,1,0,0,1,1,1,0
8442,,,Laurallhp,0,1,1,0,1,1,0,0,1,1,1,0
8443,,,MatthewCronin9,0,1,1,0,1,1,0,0,1,1,1,0
8444,,,UtSkinsFan,0,1,1,0,1,1,0,0,1,1,1,0
8445,,,MI6ban_,0,1,1,0,1,1,0,0,1,1,1,0
8446,,,Vogel_Lynne2112,0,1,1,0,1,1,0,0,1,1,1,0
8447,,,smackmom25,0,1,1,0,1,1,0,0,1,1,1,0
8448,,,nykimchi,0,1,1,0,1,1,0,0,1,1,1,0
8449,,,POPSUGARFitness,1,1,2,1,1,2,0,0.006687,0,0,0,0
8450,,,moonalisalien,0,1,1,0,1,1,0,0,1,1,1,0
8451,,,beejoli,6,1,7,7,1,8,0.166667,0.040123,0,0,0,0
8452,,,BluecosmosH,0,1,1,0,1,1,0,0,1,1,1,0
8453,,,GardeniaCoast,0,1,1,0,1,1,0,0,1,1,1,0
8454,,,ryansharich,0,1,1,0,1,1,0,0,1,1,1,0
8455,,,m1kues,0,1,1,0,1,1,0,0,1,1,1,0
8456,,,talaniz64,2,1,3,2,1,3,0.5,0.013374,0,0,0,0
8457,,,ohmycelestie,2,1,3,2,1,3,0.5,0.013374,0,0,0,0
8458,,,thvrkived,0,1,1,0,1,1,0,0,1,1,1,0
8459,,,Yeo_Cry_Tea,1,1,2,1,1,2,0,0.006687,0,0,0,0
8460,,,baltazarsd,0,1,1,0,1,1,0,0,1,1,1,0
8461,,,wordwarrior16,0,1,1,0,1,1,0,0,1,1,1,0
8462,,,inniessmile,6,1,7,6,1,7,0.166667,0.040123,0,0,0,0
8463,,,beserjee,0,1,1,0,1,1,0,0,1,1,1,0
8464,,,its_ritza,0,1,1,0,1,1,0,0,1,1,1,0
8465,,,lewing99,0,1,1,0,1,1,0,0,1,1,1,0
8466,,,blueselenophile,0,1,1,0,1,1,0,0,1,1,1,0
8467,,,chanuhl,1,2,3,1,2,3,0.5,0.006687,1,1,1,0
8468,,,TheByteNews1,4,1,5,4,1,5,0.25,0.026749,0,0,0,0
8469,,,LUVYHA0,0,1,1,0,1,1,0,0,1,1,1,0
8470,,,42_dolphins,0,1,1,0,1,1,0,0,1,1,1,0
8471,,,julianpowpow,0,1,1,0,1,1,0,0,1,1,1,0
8472,,,Samanth32950694,1,1,2,1,1,2,0,0.006687,0,0,0,0
8473,,,sunlightmirae,2,2,4,2,2,4,0.333333,0.013374,1,1,1,1
8474,,,WtWg20,2,1,3,2,1,3,0.5,0.013374,0,0,0,0
8475,,,Aestheticdesir4,0,1,1,0,1,1,0,0,1,1,1,0
8476,,,cerez4s,2,1,3,2,1,3,0.5,0.056208,0,0,0,0
8477,,,onmogoro,4,1,5,4,1,5,0.25,0.026749,0,0,0,0
8478,,,ncitysace,0,1,1,0,1,1,0,0,1,1,1,0
8479,,,iluvmomoo,5,1,6,5,1,6,0.2,0.03693,0,0,0,0
8480,,,MUresti9,0,1,1,0,1,1,0,0,1,1,1,0
8481,,,sarahparvini,1,4,5,1,4,5,0.25,0.006687,2,0.714286,0.8,0
8482,,,JacquelynNorm14,0,1,1,0,1,1,0,0,1,1,1,0
8483,,,yuzuuhan,2,1,3,2,1,3,0.5,0.013374,0,0,0,0
8484,,,RealFactsVsFake,0,1,1,0,1,1,0,0,2,0.666667,0.75,0
8485,,,tinana3344520,0,1,1,0,1,1,0,0,2,0.666667,0.75,0
8486,,,Riley9797,0,1,1,0,1,1,0,0,2,0.666667,0.75,0
8487,,,RZZMTZZ_,0,1,1,0,1,1,0,0,2,0.666667,0.75,0
8488,,,jmcclure24,1,1,2,1,1,2,0,0.006687,0,0,0,0
8489,,,gatitos262,0,1,1,0,1,1,0,0,2,0.571429,0.625,0
8490,,,Got_Bangtan,0,1,1,0,1,1,0,0,1,1,1,0
8491,,,cleanwatr,0,1,1,0,1,1,0,0,1,1,1,0
8492,,,elsacaride,2,2,4,2,2,4,0.333333,0.013374,1,1,1,1
8493,,,doglovingfool,0,1,1,0,1,1,0,0,2,0.666667,0.75,0
8494,,,bluesn_,1,1,2,1,1,2,0,0.006687,0,0,0,0
8495,,,MelissaRabb1,3,1,4,3,1,4,0.333333,0.020061,0,0,0,0
8496,,,LyndaParra16,0,2,2,0,2,2,0,0,1,1,1,0
8497,,,raicinn,0,1,1,0,1,1,0,0,1,1,1,0
8498,,,NancyinHI,7,1,8,9,3,12,0.142857,0.04681,0,0,0,0
8499,,,Master_Commando,0,1,1,0,1,1,0,0,1,1,1,0
8500,,,Ria17098827,0,1,1,0,1,1,0,0,1,1,1,0
8501,,,stcrrytan,0,1,1,0,1,1,0,0,1,1,1,0
8502,,,NEODECADESENSHI,0,1,1,0,1,1,0,0,1,1,1,0
8503,,,AngelaSkates84,13,2,15,15,4,19,0.071429,0.180612,1,1,1,39
8504,,,exfkaty,1,1,2,1,1,2,0,0.006687,0,0,0,0
8505,,,bettedavising,4,1,5,4,1,5,0.25,0.026749,0,0,0,0
8506,,,rickyoung66,0,1,1,0,1,1,0,0,1,1,1,0
8507,,,_minho_25,0,1,1,0,1,1,0,0,1,1,1,0
8508,,,konekotoohana,0,1,1,0,1,1,0,0,1,1,1,0
8509,,,flower3415,0,1,1,0,1,1,0,0,1,1,1,0
8510,,,hydrangees,1,1,2,1,1,2,0,0.006687,0,0,0,0
8511,,,briannynj,0,1,1,0,1,1,0,0,1,1,1,0
8512,,,sehoakgae,0,1,1,0,1,1,0,0,1,1,1,0
8513,,,rdaniel_murph,3,1,4,3,1,4,0.333333,0.020061,0,0,0,0
8514,,,thatsseojohnny,0,1,1,0,1,1,0,0,1,1,1,0
8515,,,FOLROUNDPRO,0,1,1,0,1,1,0,0,1,1,1,0
8516,,,bamagirl35950,0,1,1,0,1,1,0,0,2,0.666667,0.75,0
8517,,,vallasyla,0,1,1,0,1,1,0,0,2,0.666667,0.75,0
8518,,,jwingate46,0,2,2,0,2,2,0,0,2,0.75,0.833333,0
8519,,,Elliemart112,0,1,1,0,1,1,0,0,2,0.666667,0.75,0
8520,,,doryibo,0,1,1,0,1,1,0,0,2,0.666667,0.75,0
8521,,,littleduckiee,0,1,1,0,1,1,0,0,2,0.666667,0.75,0
8522,,,rmstagnaro,0,1,1,0,1,1,0,0,1,1,1,0
8523,,,tandon_armaan,4,1,5,4,1,5,0.25,0.026749,0,0,0,0
8524,,,sunflwersunoo,0,1,1,0,1,1,0,0,1,1,1,0
8525,,,greekpitka,0,1,1,0,1,1,0,0,1,1,1,0
8526,,,daylllighter,0,1,1,0,1,1,0,0,1,1,1,0
8527,,,daniiceprincess,5,1,6,5,1,6,0.2,0.033436,0,0,0,0
8528,,,LEAPuncaptalent,0,1,1,0,1,1,0,0,1,1,1,0
8529,,,iRankin_savage,0,1,1,0,1,1,0,0,1,1,1,0
8530,,,lbroadway98,0,1,1,0,1,1,0,0,1,1,1,0
8531,,,emi_koga,10,1,11,10,1,11,0.1,0.07386,0,0,0,0
8532,,,tjgphoto,0,1,1,0,1,1,0,0,1,1,1,0
8533,,,etoileluna77,0,1,1,0,1,1,0,0,1,1,1,0
8534,,,FiddlerForest,0,1,1,0,1,1,0,0,1,1,1,0
8535,,,ThanhViet86,0,1,1,0,1,1,0,0,1,1,1,0
8536,,,annabelyje,0,1,1,0,1,1,0,0,1,1,1,0
8537,,,farfnme,0,1,1,0,1,1,0,0,1,1,1,0
8538,,,jeongbless,4,1,5,4,1,5,0.25,0.026749,0,0,0,0
8539,,,himemeww,0,1,1,0,1,1,0,0,1,1,1,0
8540,,,sweetnightvmins,0,1,1,0,1,1,0,0,1,1,1,0
8541,,,yuzutohui,9,1,10,9,1,10,0.111111,0.060184,0,0,0,0
8542,,,xiangchen2011,0,1,1,0,1,1,0,0,1,1,1,0
8543,,,xielianIovebot,0,1,1,0,1,1,0,0,1,1,1,0
8544,,,PR0DBYEO,0,6,6,0,6,6,0,0,2,0.875,0.928571,0
8545,,,Bryeannsrose,0,1,1,0,1,1,0,0,1,1,1,0
8546,,,tyo1129,0,1,1,0,1,1,0,0,1,1,1,0
8547,,,ABtslover_JK,0,1,1,0,1,1,0,0,1,1,1,0
8548,,,murasakikkumo,0,1,1,0,1,1,0,0,1,1,1,0
8549,,,soapdemon34,0,1,1,0,1,1,0,0,2,0.571429,0.625,0
8550,,,jon45470876,1,1,2,1,1,2,0,0.006687,0,0,0,0
8551,,,election_every,0,1,1,0,1,1,0,0,2,0.666667,0.75,0
8552,,,Yaya05101,1,1,2,1,1,2,0,0.006687,0,0,0,0
8553,,,bokenosuke00,7,1,8,7,1,8,0.142857,0.04681,0,0,0,0
8554,,,GleekNicolas1,0,1,1,0,1,1,0,0,1,1,1,0
8555,,,smartbooklight,0,1,1,0,1,1,0,0,1,1,1,0
8556,,,GratefultoJesus,0,2,2,0,2,2,0,0,1,1,1,0
8557,,,tzbarb_tietz,1,1,2,1,1,2,0,0.006687,0,0,0,0
8558,,,news6850,1,1,2,1,1,2,0,0.006687,0,0,0,0
8559,,,freepeeper,2,1,3,2,1,3,0.5,0.013374,0,0,0,0
8560,,,DaraBoo68,0,1,1,0,1,1,0,0,1,1,1,0
8561,,,weebssus,9,1,10,9,1,10,0.111111,0.060184,0,0,0,0
8562,,,CATB0Y_Y,0,1,1,0,1,1,0,0,1,1,1,0
8563,,,artistsinger124,0,1,1,0,1,1,0,0,1,1,1,0
8564,,,TunafishSndwch,0,1,1,0,1,1,0,0,1,1,1,0
8565,,,mchelle_am,0,2,2,0,2,2,0,0,1,1,1,0
8566,,,ilona84010600,0,1,1,0,1,1,0,0,1,1,1,0
8567,,,tvchiquita,0,1,1,0,1,1,0,0,1,1,1,0
8568,,,er_ique,1,2,3,1,2,3,0.5,0.006687,1,1,1,0
8569,,,AlinGusuLan,4,1,5,5,2,7,0.25,0.026749,0,0,0,0
8570,,,Jasmine_97123,0,1,1,0,1,1,0,0,1,1,1,0
8571,,,Monique24073326,0,1,1,0,1,1,0,0,1,1,1,0
8572,,,Mystique_3,0,1,1,0,1,1,0,0,1,1,1,0
8573,,,naosoueuamaria,1,1,2,1,1,2,0,0.00396,1,1,1,1
8574,,,fenneCrisgi,0,1,1,0,1,1,0,0,1,1,1,0
8575,,,zenpundit,0,1,1,0,1,1,0,0,1,1,1,0
8576,,,apinkmilfs,4,2,6,4,2,6,0.2,0.026749,1,1,1,3
8577,,,Choco_Bans,0,1,1,0,1,1,0,0,2,0.666667,0.75,0
8578,,,minyoonjislover,0,1,1,0,1,1,0,0,2,0.666667,0.75,0
8579,,,changbinssbicep,1,1,2,1,1,2,0,0.006687,0,0,0,0
8580,,,sltrib,2,1,3,3,2,5,0.5,0.013374,0,0,0,0
8581,,,ownbusinesses,3,1,4,3,1,4,0.333333,0.020061,0,0,0,0
8582,,,quaranTinaTurnr,0,1,1,0,1,1,0,0,1,1,1,0
8583,,,BrynnCarmanTV,0,1,1,0,1,1,0,0,1,1,1,0
8584,,,irenahuang,2,1,3,2,1,3,0.5,0.013374,0,0,0,0
8585,,,kennnnnychen,0,1,1,0,1,1,0,0,1,1,1,0
8586,,,fcbaker14,1,1,2,1,1,2,0,0.006687,0,0,0,0
8587,,,snbatman,0,1,1,0,1,1,0,0,1,1,1,0
8588,,,MavisGary,0,1,1,0,1,1,0,0,1,1,1,0
8589,,,spfsexbanq20101,0,1,1,0,1,1,0,0,1,1,1,0
8590,,,akaminhobby,0,1,1,0,1,1,0,0,1,1,1,0
8591,,,gjpinga,0,1,1,0,1,1,0,0,1,1,1,0
8592,,,jooncenatiddies,0,1,1,0,1,1,0,0,1,1,1,0
8593,,,pamelabweed,0,1,1,0,1,1,0,0,1,1,1,0
8594,,,sleepingrae,3,1,4,3,1,4,0.333333,0.020061,0,0,0,0
8595,,,ocanannain,0,2,2,0,2,2,0,0,1,1,1,0
8596,,,kkyufviry,0,3,3,0,3,3,0,0,2,0.8,0.875,0
8597,,,csella3,0,1,1,0,1,1,0,0,1,1,1,0
8598,,,dz3bom,15,1,16,15,1,16,0,0.081217,1,1,1,21
8599,,,voronincup,6,2,8,6,2,8,0.142857,0.105073,1,1,1,55
8600,,,craymer_theresa,0,1,1,0,1,1,0,0,2,0.666667,0.75,0
8601,,,SexyLyingChive,0,1,1,0,1,1,0,0,2,0.666667,0.75,0
8602,,,NutterMutter,0,2,2,0,2,2,0,0,2,0.75,0.833333,0
8603,,,freakiesttofu,5,1,6,5,1,6,0.2,0.047413,0,0,0,0
8604,,,OnlyWhiteTiger,0,1,1,0,1,1,0,0,1,1,1,0
8605,,,im_ning_ning,0,1,1,0,1,1,0,0,1,1,1,0
8606,,,shimkyoong_,0,1,1,0,1,1,0,0,2,0.666667,0.75,0
8607,,,MarcJackson17,0,1,1,0,1,1,0,0,2,0.666667,0.75,0
8608,,,chellelaine,0,1,1,0,1,1,0,0,2,0.666667,0.75,0
8609,,,GilAsakawa,2,1,3,2,1,3,0.5,0.013374,0,0,0,0
8610,,,shoecoop,0,1,1,0,1,1,0,0,1,1,1,0
8611,,,ChauhanAnnika,2,1,3,2,1,3,0.5,0.013374,0,0,0,0
8612,,,pw4rkyl,0,1,1,0,1,1,0,0,1,1,1,0
8613,,,subzero810,3,1,4,3,1,4,0.333333,0.020061,0,0,0,0
8614,,,Laura1375,0,1,1,0,1,1,0,0,1,1,1,0
8615,,,PrettyBoy_JBS,0,1,1,0,1,1,0,0,1,1,1,0
8616,,,SpookyFiish,9,1,10,9,1,10,0.111111,0.133921,0,0,0,0
8617,,,chenddar,0,1,1,0,1,1,0,0,1,1,1,0
8618,,,A01Ara,0,1,1,0,1,1,0,0,1,1,1,0
8619,,,yuzufart,4,2,6,4,2,6,0.2,0.026749,1,1,1,3
8620,,,olivesweet07,0,1,1,0,1,1,0,0,1,1,1,0
8621,,,mcgee_mom,0,1,1,0,1,1,0,0,1,1,1,0
8622,,,Lsquared341,0,1,1,0,1,1,0,0,1,1,1,0
8623,,,iclwll,0,1,1,0,1,1,0,0,1,1,1,0
8624,,,nublew,5,1,6,5,1,6,0.2,0.033436,0,0,0,0
8625,,,wwwwwwwgeeeron,0,1,1,0,1,1,0,0,1,1,1,0
8626,,,Shirley2012exo,0,1,1,0,1,1,0,0,1,1,1,0
8627,,,nikkaeeeee,0,1,1,0,1,1,0,0,1,1,1,0
8628,,,Danananana613,0,1,1,0,1,1,0,0,1,1,1,0
8629,,,ReiMurasame,1,1,2,1,1,2,0,0.006687,0,0,0,0
8630,,,beauzishu,1,1,2,1,1,2,0,0.006687,0,0,0,0
8631,,,DI0RBIBI,8,1,9,8,1,9,0.125,0.065173,0,0,0,0
8632,,,Mariamne175,0,1,1,0,1,1,0,0,1,1,1,0
8633,,,ShiYunZhao,0,1,1,0,1,1,0,0,1,1,1,0
8634,,,lifeofjaykstone,0,1,1,0,1,1,0,0,1,1,1,0
8635,,,absurdnicole,0,1,1,0,1,1,0,0,1,1,1,0
8636,,,cheese_breath,0,1,1,0,1,1,0,0,1,1,1,0
8637,,,WendyWendlandt,4,1,5,4,1,5,0.25,0.026749,0,0,0,0
8638,,,Whynotbeme2021,0,1,1,0,1,1,0,0,1,1,1,0
8639,,,C_Robbins_,0,1,1,0,1,1,0,0,1,1,1,0
8640,,,dadiva18,0,1,1,0,1,1,0,0,1,1,1,0
8641,,,CryptoNFTide,2,1,3,2,1,3,0.5,0.013374,0,0,0,0
8642,,,nsyafqhs,0,1,1,0,1,1,0,0,1,1,1,0
8643,,,mintiipuffs,9,1,10,9,1,10,0.111111,0.082343,0,0,0,0
8644,,,ANIME7JSTORM9,0,1,1,0,1,1,0,0,1,1,1,0
8645,,,KokoNeNe6,0,1,1,0,1,1,0,0,1,1,1,0
8646,,,whiskypixie,0,1,1,0,1,1,0,0,1,1,1,0
8647,,,angel_ponders,4,3,7,4,3,7,0.166667,0.026749,1,1,1,6
8648,,,whrjongo55,0,1,1,0,1,1,0,0,1,1,1,0
8649,,,sugarshaz19,0,1,1,0,1,1,0,0,1,1,1,0
8650,,,esgeelo,2,1,3,2,1,3,0.5,0.013374,0,0,0,0
8651,,,winterfairyyyy,0,6,6,0,7,7,0,0,1,1,1,0
8652,,,2366R,0,1,1,0,1,1,0,0,2,0.571429,0.625,0
8653,,,krlaw6,0,1,1,0,1,1,0,0,2,0.571429,0.625,0
8654,,,stingracer0905,0,1,1,0,1,1,0,0,2,0.571429,0.625,0
8655,,,peopeolucario,0,1,1,0,1,1,0,0,2,0.571429,0.625,0
8656,,,hvoyer17,0,1,1,0,1,1,0,0,2,0.571429,0.625,0
8657,,,zeliomosexuelo,0,3,3,0,3,3,0,0,2,0.666667,0.75,0
8658,,,TheLegendaryJD,0,1,1,0,1,1,0,0,2,0.571429,0.625,0
8659,,,kamreilly14,1,1,2,1,1,2,0,0.006687,0,0,0,0
8660,,,usheadlinebot,8,1,9,9,2,11,0.125,0.053497,0,0,0,0
8661,,,Natalia87009396,0,1,1,0,1,1,0,0,1,1,1,0
8662,,,neo4192,0,1,1,0,1,1,0,0,1,1,1,0
8663,,,kaeya_my_love,0,1,1,0,1,1,0,0,1,1,1,0
8664,,,badassakurahar1,0,1,1,0,1,1,0,0,1,1,1,0
8665,,,mistydawnsmiles,6,1,7,6,1,7,0.166667,0.040123,0,0,0,0
8666,,,tempestking69,0,1,1,0,1,1,0,0,1,1,1,0
8667,,,slugo13,0,1,1,0,1,1,0,0,1,1,1,0
8668,,,MosbyKala,0,1,1,0,1,1,0,0,1,1,1,0
8669,,,aeri4luv,0,1,1,0,1,1,0,0,1,1,1,0
8670,,,JenningsNicole5,0,1,1,0,1,1,0,0,1,1,1,0
8671,,,yamane_patricia,0,1,1,0,1,1,0,0,1,1,1,0
8672,,,toragorawrr,0,1,1,0,1,1,0,0,1,1,1,0
8673,,,MorningExp,0,1,1,0,1,1,0,0,1,1,1,0
8674,,,abc4utah,3,1,4,3,1,4,0.333333,0.020061,0,0,0,0
8675,,,SurpriseMaxine,0,1,1,0,1,1,0,0,1,1,1,0
8676,,,thewebbix,0,1,1,0,1,1,0,0,1,1,1,0
8677,,,mandaroojack,1,1,2,1,1,2,0,0.006687,0,0,0,0
8678,,,ReturnNormalcy,8,1,9,9,1,10,0.125,0.053497,0,0,0,0
8679,,,pluto_mybeloved,0,1,1,0,1,1,0,0,1,1,1,0
8680,,,ajisfabulous,0,2,2,0,2,2,0,0,1,1,1,0
8681,,,softandtender_,0,1,1,0,1,1,0,0,1,1,1,0
8682,,,squishcat_,0,1,1,0,1,1,0,0,1,1,1,0
8683,,,minerva65324362,0,1,1,0,1,1,0,0,1,1,1,0
8684,,,CrazyLove4Dogs,0,1,1,0,1,1,0,0,1,1,1,0
8685,,,rycoolbeans,4,1,5,4,1,5,0.25,0.026749,0,0,0,0
8686,,,MU1CH1R0,0,1,1,0,1,1,0,0,1,1,1,0
8687,,,usatriathlon,0,1,1,0,1,1,0,0,1,1,1,0
8688,,,Quiarafrancisco,2,1,3,2,1,3,0.5,0.013374,0,0,0,0
8689,,,jetstream_dan_,0,2,2,0,2,2,0,0,1,1,1,0
8690,,,Vaccinated20,0,1,1,0,1,1,0,0,1,1,1,0
8691,,,docdallin,0,1,1,0,1,1,0,0,1,1,1,0
8692,,,Ellieh37656427,1,1,2,1,1,2,0,0.006687,0,0,0,0
8693,,,90sBellaDonna,6,1,7,7,2,9,0.166667,0.040123,0,0,0,0
8694,,,eliyelio,0,1,1,0,1,1,0,0,1,1,1,0
8695,,,heemo724,0,1,1,0,1,1,0,0,1,1,1,0
8696,,,ABQSatellite,4,1,5,4,1,5,0.25,0.026749,0,0,0,0
8697,,,LaylaHitsugaya,0,1,1,0,1,1,0,0,1,1,1,0
8698,,,mAcChaos,0,1,1,0,1,1,0,0,1,1,1,0
8699,,,AnilBer75410115,0,1,1,0,1,1,0,0,1,1,1,0
8700,,,_GogyOfPozest,3,1,4,3,1,4,0.333333,0.020061,0,0,0,0
8701,,,Sokal_Guy,0,1,1,0,1,1,0,0,1,1,1,0
8702,,,nolovebaaby,0,1,1,0,1,1,0,0,1,1,1,0
8703,,,Beefnoodlebf,2,1,3,3,2,5,0.5,0.013374,0,0,0,0
8704,,,nicosolos,0,1,1,0,1,1,0,0,1,1,1,0
8705,,,PatriciaAAlonzo,0,1,1,0,1,1,0,0,2,0.666667,0.75,0
8706,,,asteadyview,0,1,1,0,1,1,0,0,2,0.666667,0.75,0
8707,,,elizabeth172000,0,2,2,0,2,2,0,0,2,0.75,0.833333,0
8708,,,henrygraysonb,0,1,1,0,1,1,0,0,2,0.666667,0.75,0
8709,,,clayson11,0,1,1,0,1,1,0,0,2,0.666667,0.75,0
8710,,,annalongworth14,0,1,1,0,1,1,0,0,2,0.666667,0.75,0
8711,,,getmeanamjoon,0,1,1,0,1,1,0,0,2,0.666667,0.75,0
8712,,,RenielRodrigue9,0,1,1,0,1,1,0,0,2,0.666667,0.75,0
8713,,,nekoringo67,0,3,3,0,3,3,0,0,2,0.8,0.875,0
8714,,,reneeasance,0,1,1,0,1,1,0,0,2,0.666667,0.75,0
8715,,,ItsMeJonRamos,0,1,1,0,1,1,0,0,2,0.666667,0.75,0
8716,,,anmitsu_95vmin,0,1,1,0,1,1,0,0,2,0.666667,0.75,0
8717,,,CarriMac,1,1,2,1,1,2,0,0.006687,0,0,0,0
8718,,,AshleyLippe,11,1,12,11,1,12,0.090909,0.073559,0,0,0,0
8719,,,xieliav,0,1,1,0,1,1,0,0,1,1,1,0
8720,,,JoelleNemecek,0,1,1,0,1,1,0,0,1,1,1,0
8721,,,RichieandKate_,0,1,1,0,1,1,0,0,1,1,1,0
8722,,,RuthColby7,0,1,1,0,1,1,0,0,1,1,1,0
8723,,,CortesLanderos,0,1,1,0,1,1,0,0,1,1,1,0
8724,,,gayyyboiii97,0,1,1,0,1,1,0,0,1,1,1,0
8725,,,spookyxjjong,0,1,1,0,1,1,0,0,1,1,1,0
8726,,,afyyxgr,0,1,1,0,1,1,0,0,1,1,1,0
8727,,,wenjinqsui,1,1,2,1,1,2,0,0.006687,0,0,0,0
8728,,,jdh_harms,0,1,1,0,1,1,0,0,1,1,1,0
8729,,,PapaFigManJez,0,2,2,0,3,3,0,0,1,1,1,0
8730,,,MusicREDEF,1,1,2,1,1,2,0,0.006687,0,0,0,0
8731,,,Deseret,1,1,2,1,1,2,0,0.006687,0,0,0,0
8732,,,EvaRedini,7,1,8,7,1,8,0.142857,0.04681,0,0,0,0
8733,,,Blue_Flame_Rose,0,1,1,0,1,1,0,0,1,1,1,0
8734,,,AnneMCosgrove2,0,1,1,0,1,1,0,0,1,1,1,0
8735,,,katz0woman,0,1,1,0,1,1,0,0,1,1,1,0
8736,,,AztkSmooth,0,1,1,0,1,1,0,0,1,1,1,0
8737,,,michulax,0,1,1,0,1,1,0,0,1,1,1,0
8738,,,itsaubreysmalls,2,1,3,2,1,3,0.5,0.013374,0,0,0,0
8739,,,JennyVera134,0,1,1,0,1,1,0,0,1,1,1,0
8740,,,KenneyKay,1,1,2,1,1,2,0,0.006687,0,0,0,0
8741,,,DrRobinDVM,0,1,1,0,1,1,0,0,1,1,1,0
8742,,,SEOranodon,0,1,1,0,1,1,0,0,1,1,1,0
8743,,,moved2italy,0,1,1,0,1,1,0,0,1,1,1,0
8744,,,CeceliaHuddles2,0,2,2,0,2,2,0,0,1,1,1,0
8745,,,byLorettaHunt,0,1,1,0,1,1,0,0,1,1,1,0
8746,,,127generation,9,1,10,9,1,10,0.111111,0.079462,0,0,0,0
8747,,,Its_A_GOP_COUP,0,1,1,0,1,1,0,0,1,1,1,0
8748,,,axvenm,0,1,1,0,1,1,0,0,1,1,1,0
8749,,,SarahHughesNY,0,2,2,0,2,2,0,0,1,1,1,0
8750,,,kataksng,0,1,1,0,1,1,0,0,1,1,1,0
8751,,,kari_paulson,0,1,1,0,1,1,0,0,1,1,1,0
8752,,,traderjoes_stan,2,1,3,2,1,3,0.5,0.013374,0,0,0,0
8753,,,bIingstar,4,1,5,4,1,5,0.25,0.026749,0,0,0,0
8754,,,PTPGUK2ndFamily,0,1,1,0,1,1,0,0,1,1,1,0
8755,,,4Wade2021,0,1,1,0,1,1,0,0,1,1,1,0
8756,,,annejowrites,0,1,1,0,1,1,0,0,1,1,1,0
8757,,,katelovescode,3,1,4,3,1,4,0.333333,0.02705,0,0,0,0
8758,,,alpacaaparka,0,1,1,0,1,1,0,0,1,1,1,0
8759,,,FireGoddessB,0,1,1,0,1,1,0,0,1,1,1,0
8760,,,scaraIuvr69,0,1,1,0,1,1,0,0,1,1,1,0
8761,,,chaoticnuwutral,0,1,1,0,1,1,0,0,1,1,1,0
8762,,,ppjvpp,0,1,1,0,1,1,0,0,1,1,1,0
8763,,,vsizzzle,0,1,1,0,1,1,0,0,1,1,1,0
8764,,,ttstarrfish,0,1,1,0,1,1,0,0,1,1,1,0
8765,,,AndreaDMorgan,0,1,1,0,1,1,0,0,1,1,1,0
8766,,,100worms,1,1,2,1,1,2,0,0.006687,0,0,0,0
8767,,,emilyevirgin,1,1,2,1,1,2,0,0.006687,0,0,0,0
8768,,,levisslutdotcom,4,1,5,4,1,5,0.25,0.03493,0,0,0,0
8769,,,absonderlich_,0,1,1,0,1,1,0,0,1,1,1,0
8770,,,BOOPYUZU,0,1,1,0,1,1,0,0,1,1,1,0
8771,,,yutajuuI,3,1,4,3,1,4,0.333333,0.020061,0,0,0,0
8772,,,soyoungiya,0,1,1,0,1,1,0,0,1,1,1,0
8773,,,DrGJackBrown,0,1,1,0,1,1,0,0,1,1,1,0
8774,,,jkathleen5,1,1,2,1,1,2,0,0.006687,0,0,0,0
8775,,,edunkel,6,1,7,8,3,11,0.166667,0.040123,0,0,0,0
8776,,,Rmontsej,0,1,1,0,1,1,0,0,1,1,1,0
8777,,,vancesanders,5,1,6,5,1,6,0.2,0.033436,0,0,0,0
8778,,,wendzedin,0,1,1,0,1,1,0,0,1,1,1,0
8779,,,A1471,0,1,1,0,1,1,0,0,1,1,1,0
8780,,,annielkozak,0,1,1,0,1,1,0,0,1,1,1,0
8781,,,JoanMos67129782,3,1,4,3,1,4,0.333333,0.020061,0,0,0,0
8782,,,piones789,0,1,1,0,1,1,0,0,1,1,1,0
8783,,,bojingles83,0,1,1,0,1,1,0,0,1,1,1,0
8784,,,nzaccardi,3,1,4,3,1,4,0.333333,0.058498,0,0,0,0
8785,,,fireashdustlife,0,3,3,0,3,3,0,0,1,1,1,0
8786,,,BL0NDECH4N,0,1,1,0,1,1,0,0,1,1,1,0
8787,,,pogowo1,0,1,1,0,1,1,0,0,1,1,1,0
8788,,,seokjins_smile,0,1,1,0,1,1,0,0,1,1,1,0
8789,,,asleepzeul,0,1,1,0,1,1,0,0,1,1,1,0
8790,,,RayHorsleyConsu,0,1,1,0,1,1,0,0,1,1,1,0
8791,,,Askia1443,0,1,1,0,1,1,0,0,1,1,1,0
8792,,,Sena_eight8,0,1,1,0,1,1,0,0,1,1,1,0
8793,,,profbookwurm2,0,1,1,0,1,1,0,0,1,1,1,0
8794,,,xcalxiv,0,1,1,0,1,1,0,0,1,1,1,0
8795,,,je_mclaughlin,0,1,1,0,1,1,0,0,1,1,1,0
8796,,,MintMarshmello1,0,1,1,0,1,1,0,0,1,1,1,0
8797,,,DoolinDebi,0,1,1,0,1,1,0,0,1,1,1,0
8798,,,ardatyakshiis,1,1,2,1,1,2,0,0.006687,0,0,0,0
8799,,,1_ufff,0,1,1,0,1,1,0,0,1,1,1,0
8800,,,ChinniChris,3,1,4,3,1,4,0.333333,0.020061,0,0,0,0
8801,,,KriSarah_,0,2,2,0,2,2,0,0,1,1,1,0
8802,,,puddingissweet,0,1,1,0,1,1,0,0,1,1,1,0
8803,,,DeeDeeRex,16,1,17,16,1,17,0.0625,0.127193,0,0,0,0
8804,,,PLVYBXYBLIZZY,0,1,1,0,1,1,0,0,1,1,1,0
8805,,,elyssiiann,0,1,1,0,1,1,0,0,1,1,1,0
8806,,,Zazuke5557,0,1,1,0,1,1,0,0,1,1,1,0
8807,,,kurtonweb,0,1,1,0,1,1,0,0,1,1,1,0
8808,,,alvyko,1,2,3,1,2,3,0,0.00396,1,1,1,2
8809,,,kenschultz_,0,1,1,0,1,1,0,0,1,1,1,0
8810,,,Michael26455113,0,1,1,0,1,1,0,0,1,1,1,0
8811,,,LetMeBe0301,0,1,1,0,1,1,0,0,1,1,1,0
8812,,,cypherSEOK_7,0,1,1,0,1,1,0,0,1,1,1,0
8813,,,amorethv,0,1,1,0,1,1,0,0,1,1,1,0
8814,,,MikahMiriam,0,1,1,0,1,1,0,0,1,1,1,0
8815,,,gongulvv,1,1,2,1,1,2,0,0.006687,0,0,0,0
8816,,,h_tao_,3,1,4,3,1,4,0.333333,0.020061,0,0,0,0
8817,,,willgotulaughin,0,1,1,0,1,1,0,0,1,1,1,0
8818,,,deAwesomeMe1,0,1,1,0,1,1,0,0,1,1,1,0
8819,,,MICHAEL12145859,0,1,1,0,1,1,0,0,1,1,1,0
8820,,,fairfain,4,1,5,4,1,5,0.25,0.026749,0,0,0,0
8821,,,oruquitas,0,1,1,0,1,1,0,0,1,1,1,0
8822,,,tomezi2998,0,1,1,0,1,1,0,0,1,1,1,0
8823,,,WooleyHeidi,0,1,1,0,1,1,0,0,1,1,1,0
8824,,,malicioustaurus,1,1,2,1,1,2,0,0.006687,0,0,0,0
8825,,,singsandsmiles,2,1,3,2,1,3,0.5,0.013374,0,0,0,0
8826,,,LiaMirandaSun,5,1,6,5,1,6,0.2,0.033436,0,0,0,0
8827,,,lithub,0,1,1,0,1,1,0,0,1,1,1,0
8828,,,ccburnt1,0,1,1,0,1,1,0,0,1,1,1,0
8829,,,DCCelebrity,0,1,1,0,1,1,0,0,1,1,1,0
8830,,,earthtojazi,2,1,3,2,1,3,0.5,0.013374,0,0,0,0
8831,,,YouCanPlayTeam,0,1,1,0,1,1,0,0,1,1,1,0
8832,,,kate_matheny,2,1,3,2,1,3,0.5,0.013374,0,0,0,0
8833,,,EvelynSoo9701,0,1,1,0,1,1,0,0,1,1,1,0
8834,,,99seokjins,0,1,1,0,1,1,0,0,1,1,1,0
8835,,,__sixrings6,0,1,1,0,1,1,0,0,1,1,1,0
8836,,,mi_loszek,0,1,1,0,1,1,0,0,1,1,1,0
8837,,,Starr_Chen,6,1,7,6,1,7,0.166667,0.040123,0,0,0,0
8838,,,smsolberg,0,1,1,0,1,1,0,0,1,1,1,0
8839,,,LucySul83935904,0,1,1,0,1,1,0,0,1,1,1,0
8840,,,Kiah_Coleman,0,1,1,0,1,1,0,0,1,1,1,0
8841,,,bajiaoan,0,2,2,0,2,2,0,0,1,1,1,0
8842,,,AyanaMonique,0,1,1,0,1,1,0,0,1,1,1,0
8843,,,HADENIYI_01,0,1,1,0,1,1,0,0,1,1,1,0
8844,,,EthanChorin,0,1,1,0,1,1,0,0,1,1,1,0
8845,,,KimmieK12,0,1,1,0,1,1,0,0,1,1,1,0
8846,,,drewgouge,0,1,1,0,1,1,0,0,1,1,1,0
8847,,,BucPrin,0,1,1,0,1,1,0,0,1,1,1,0
8848,,,angelyuniii,0,1,1,0,1,1,0,0,1,1,1,0
8849,,,arguinghessa,0,1,1,0,1,1,0,0,1,1,1,0
8850,,,witchcatf,0,1,1,0,1,1,0,0,1,1,1,0
8851,,,jeantegodlock,0,1,1,0,1,1,0,0,1,1,1,0
8852,,,gtrain33,0,1,1,0,1,1,0,0,1,1,1,0
8853,,,spaceyforjimin,0,1,1,0,1,1,0,0,1,1,1,0
8854,,,PSobleskie,0,1,1,0,1,1,0,0,1,1,1,0
8855,,,KarenSueBell,1,1,2,1,1,2,0,0.006687,0,0,0,0
8856,,,ecoangelhsu,2,1,3,2,1,3,0.5,0.013374,0,0,0,0
8857,,,levi_pdf,0,1,1,0,1,1,0,0,1,1,1,0
8858,,,hetchrome,4,1,5,4,1,5,0.25,0.026749,0,0,0,0
8859,,,josemarquez19,0,1,1,0,1,1,0,0,1,1,1,0
8860,,,bangtanoono,0,1,1,0,1,1,0,0,1,1,1,0
8861,,,bruiser0862,0,1,1,0,1,1,0,0,1,1,1,0
8862,,,gotmefool7,0,1,1,0,1,1,0,0,1,1,1,0
8863,,,chenyanqing,0,1,1,0,1,1,0,0,1,1,1,0
8864,,,Ebljazzfan,0,1,1,0,1,1,0,0,1,1,1,0
8865,,,_nik_nik_b,0,1,1,0,1,1,0,0,1,1,1,0
8866,,,me2hannah,3,1,4,3,1,4,0.333333,0.020061,0,0,0,0
8867,,,ImgoodImInExile,0,1,1,0,1,1,0,0,1,1,1,0
8868,,,myungender,4,1,5,4,1,5,0.25,0.026749,0,0,0,0
8869,,,Goeland63,0,1,1,0,1,1,0,0,1,1,1,0
8870,,,yungeexiao,0,1,1,0,1,1,0,0,1,1,1,0
8871,,,MottoMotto123,0,1,1,0,1,1,0,0,1,1,1,0
8872,,,evie_dem136,3,1,4,3,1,4,0.333333,0.020061,0,0,0,0
8873,,,No_o1999,0,1,1,0,1,1,0,0,1,1,1,0
8874,,,revarsev,2,1,3,2,1,3,0.5,0.013374,0,0,0,0
8875,,,RandyHulcy,0,2,2,0,2,2,0,0,2,0.75,0.833333,0
8876,,,m_marlovsarmin,0,1,1,0,1,1,0,0,2,0.6,0.666667,0
8877,,,lgbtqnewsalert,0,1,1,0,1,1,0,0,2,0.6,0.666667,0
8878,,,MySeattleNews,0,1,1,0,1,1,0,0,2,0.6,0.666667,0
8879,,,AsianCoaches,3,2,5,3,2,5,0.25,0.020061,1,1,1,2
8880,,,bloodystubborn,0,1,1,0,1,1,0,0,2,0.666667,0.75,0
8881,,,JakeMcMillian,0,1,1,0,1,1,0,0,2,0.666667,0.75,0
8882,,,Admerasia,4,1,5,4,1,5,0.25,0.026749,0,0,0,0
8883,,,NZbb0x,0,1,1,0,1,1,0,0,1,1,1,0
8884,,,Dornrschen8,0,1,1,0,1,1,0,0,1,1,1,0
8885,,,comicmizchief,0,1,1,0,1,1,0,0,1,1,1,0
8886,,,KING5Seattle,4,1,5,4,1,5,0.25,0.030243,0,0,0,0
8887,,,orangeblueeee,0,1,1,0,1,1,0,0,1,1,1,0
8888,,,yutasheadphones,0,1,1,0,1,1,0,0,1,1,1,0
8889,,,chxrltzi,0,1,1,0,1,1,0,0,1,1,1,0
8890,,,_hyyhyoongi,0,1,1,0,1,1,0,0,1,1,1,0
8891,,,myfavisonanana,0,1,1,0,1,1,0,0,1,1,1,0
8892,,,shuzhu2020,1,1,2,1,1,2,0,0.006687,0,0,0,0
8893,,,Xl40S,1,1,2,1,1,2,0,0.006687,0,0,0,0
8894,,,outsports,2,1,3,3,2,5,0.5,0.013374,0,0,0,0
8895,,,kyeobit,1,1,2,1,1,2,0,0.006687,0,0,0,0
8896,,,allaboutluvs,2,1,3,2,1,3,0.5,0.013374,0,0,0,0
8897,,,mbrauchler,0,1,1,0,1,1,0,0,1,1,1,0
8898,,,AllieLei,2,1,3,2,1,3,0.5,0.013374,0,0,0,0
8899,,,bestiewhocares,0,1,1,0,1,1,0,0,1,1,1,0
8900,,,Mikeys2ndBitch,0,2,2,0,3,3,0,0,1,1,1,0
8901,,,FnFtalk,2,1,3,2,1,3,0.5,0.016101,0,0,0,0
8902,,,spiraltastic,4,1,5,4,1,5,0.25,0.026749,0,0,0,0
8903,,,rojas2465,0,1,1,0,1,1,0,0,1,1,1,0
8904,,,kcihcdopi,0,1,1,0,1,1,0,0,1,1,1,0
8905,,,dazaiwtf,7,1,8,8,1,9,0.142857,0.060787,0,0,0,0
8906,,,_sad_bitch_Sae,0,1,1,0,1,1,0,0,1,1,1,0
8907,,,krasll,0,1,1,0,1,1,0,0,1,1,1,0
8908,,,pececilloconpan,0,1,1,0,1,1,0,0,1,1,1,0
8909,,,mwhereford,5,1,6,5,1,6,0.2,0.033436,0,0,0,0
8910,,,katilunga,0,1,1,0,1,1,0,0,1,1,1,0
8911,,,nash2798,0,1,1,0,1,1,0,0,1,1,1,0
8912,,,Tokiimon,0,1,1,0,1,1,0,0,1,1,1,0
8913,,,annie_ts3,0,1,1,0,1,1,0,0,1,1,1,0
8914,,,CatCaseyAZ,1,1,2,1,1,2,0,0.006687,0,0,0,0
8915,,,spkheller,5,1,6,5,1,6,0.2,0.033436,0,0,0,0
8916,,,amylourose,0,1,1,0,1,1,0,0,1,1,1,0
8917,,,JohnHirose,0,1,1,0,1,1,0,0,1,1,1,0
8918,,,jamiearrington,0,1,1,0,1,1,0,0,1,1,1,0
8919,,,TreCampisano,0,1,1,0,1,1,0,0,1,1,1,0
8920,,,cjmsports,4,1,5,4,1,5,0.25,0.026749,0,0,0,0
8921,,,meggiemoon3,0,1,1,0,1,1,0,0,1,1,1,0
8922,,,yuzukun24kame67,0,1,1,0,1,1,0,0,1,1,1,0
8923,,,AnitaCamposeco,0,1,1,0,1,1,0,0,1,1,1,0
8924,,,Holly500,1,1,2,1,1,2,0,0.006687,0,0,0,0
8925,,,MiniRavioIi,0,1,1,0,1,1,0,0,1,1,1,0
8926,,,liviiery,0,1,1,0,1,1,0,0,1,1,1,0
8927,,,kiraleann23,0,1,1,0,1,1,0,0,1,1,1,0
8928,,,1outside,3,1,4,4,2,6,0.333333,0.020061,0,0,0,0
8929,,,luvrnboo,1,1,2,1,1,2,0,0.006687,0,0,0,0
8930,,,tinypalate,0,1,1,0,1,1,0,0,1,1,1,0
8931,,,ClaytonEdge1,0,1,1,0,1,1,0,0,1,1,1,0
8932,,,NYCRobyn,3,1,4,3,1,4,0.333333,0.020061,0,0,0,0
8933,,,ohka_2018,0,2,2,0,2,2,0,0,1,1,1,0
8934,,,GencDardani,0,1,1,0,1,1,0,0,1,1,1,0
8935,,,SmithStegall,0,1,1,0,1,1,0,0,1,1,1,0
8936,,,stevestonjason,0,1,1,0,1,1,0,0,1,1,1,0
8937,,,Jb84107,0,1,1,0,1,1,0,0,1,1,1,0
8938,,,swimrun262,0,1,1,0,1,1,0,0,1,1,1,0
8939,,,MrF0_olish,0,1,1,0,1,1,0,0,1,1,1,0
8940,,,saulesbuciuota,0,1,1,0,1,1,0,0,1,1,1,0
8941,,,VoteJohnScott,2,1,3,2,1,3,0.5,0.013374,0,0,0,0
8942,,,Kazzellin,0,1,1,0,1,1,0,0,1,1,1,0
8943,,,latimessports,2,1,3,3,2,5,0.5,0.013374,0,0,0,0
8944,,,stainedglasslut,0,2,2,0,2,2,0,0,1,1,1,0
8945,,,contentbees,4,1,5,4,1,5,0.25,0.026749,0,0,0,0
8946,,,mx9407_,0,1,1,0,1,1,0,0,1,1,1,0
8947,,,Oneworldsportx,0,4,4,0,8,8,0,0,1,1,1,0
8948,,,MacroDistress,0,1,1,0,1,1,0,0,1,1,1,0
8949,,,SonofJohn51,0,1,1,0,1,1,0,0,1,1,1,0
8950,,,GraceWa88711695,0,1,1,0,1,1,0,0,1,1,1,0
8951,,,_LorrieKim_,3,1,4,3,1,4,0.333333,0.020061,0,0,0,0
8952,,,yibaobaobei,0,2,2,0,2,2,0,0,1,1,1,0
8953,,,ChristoDisney,0,1,1,0,1,1,0,0,1,1,1,0
8954,,,AmandaD49561461,0,1,1,0,1,1,0,0,2,0.6,0.666667,0
8955,,,starsiIver,3,1,4,3,1,4,0.333333,0.020061,0,0,0,0
8956,,,RichersonJulie,0,1,1,0,1,1,0,0,1,1,1,0
8957,,,atinyseokjin,0,1,1,0,1,1,0,0,2,0.6,0.666667,0
8958,,,timabimaa,3,2,5,3,2,5,0.25,0.020061,2,0.6,0.666667,6
8959,,,DetroitDeeDee,0,1,1,0,1,1,0,0,1,1,1,0
8960,,,Arthurlee_M,0,2,2,0,2,2,0,0,1,1,1,0
8961,,,warriorwhimsies,0,2,2,0,2,2,0,0,2,0.75,0.833333,0
8962,,,NedStanley,0,1,1,0,1,1,0,0,1,1,1,0
8963,,,MCG2000,0,2,2,0,2,2,0,0,1,1,1,0
8964,,,MarkW_E01,0,1,1,0,1,1,0,0,1,1,1,0
8965,,,JoeAColes,4,1,5,5,1,6,0.25,0.026749,0,0,0,0
8966,,,koukoupuffs,0,1,1,0,1,1,0,0,1,1,1,0
8967,,,brutus_reaper,0,1,1,0,1,1,0,0,1,1,1,0
8968,,,enkelvreter,2,1,3,2,1,3,0.5,0.013374,0,0,0,0
8969,,,0abbyabigail0,0,1,1,0,1,1,0,0,1,1,1,0
8970,,,_mmmairon_,0,1,1,0,1,1,0,0,1,1,1,0
8971,,,Baalderdash,0,1,1,0,1,1,0,0,1,1,1,0
8972,,,SharonDoylePR,1,1,2,1,1,2,0,0.006687,0,0,0,0
8973,,,John_270rtizz,4,1,5,7,1,8,0.25,0.026749,0,0,0,0
8974,,,lilacyuzu,0,1,1,0,1,1,0,0,1,1,1,0
8975,,,jiangwxnyin,1,1,2,1,1,2,0,0.006687,0,0,0,0
8976,,,amNewYork,1,1,2,1,1,2,0,0.006687,0,0,0,0
8977,,,onlyzhans,7,1,8,7,1,8,0.142857,0.066088,0,0,0,0
8978,,,obahoeru,0,1,1,0,1,1,0,0,1,1,1,0
8979,,,okaykujou,0,1,1,0,1,1,0,0,1,1,1,0
8980,,,bcarez,0,1,1,0,1,1,0,0,1,1,1,0
8981,,,MattMcClellan03,6,1,7,8,3,11,0.166667,0.040123,0,0,0,0
8982,,,ZoneSportsNet,3,1,4,3,1,4,0.333333,0.020061,0,0,0,0
8983,,,DangOniichan,0,1,1,0,1,1,0,0,1,1,1,0
8984,,,ZombiesAreBad,0,1,1,0,1,1,0,0,1,1,1,0
8985,,,EvaMarie73,0,1,1,0,1,1,0,0,1,1,1,0
8986,,,Wasatchbay,0,1,1,0,1,1,0,0,1,1,1,0
8987,,,moonlours,0,1,1,0,1,1,0,0,1,1,1,0
8988,,,shadyxiaofacts,1,1,2,1,1,2,0,0.006687,0,0,0,0
8989,,,crystal4obama,0,2,2,0,2,2,0,0,1,1,1,0
8990,,,MIR0HANJl,5,1,6,5,1,6,0.2,0.033436,0,0,0,0
8991,,,Sukiyanyuzu__,0,2,2,0,2,2,0,0,1,1,1,0
8992,,,_negativeGOE,0,1,1,0,1,1,0,0,1,1,1,0
8993,,,YorozuyaPaako,0,1,1,0,1,1,0,0,1,1,1,0
8994,,,DiyaGeuse,0,1,1,0,1,1,0,0,1,1,1,0
8995,,,seungscience,1,1,2,1,1,2,0,0.006687,0,0,0,0
8996,,,kyrazyyy,0,1,1,0,1,1,0,0,1,1,1,0
8997,,,shannernanner21,0,1,1,0,1,1,0,0,1,1,1,0
8998,,,EX9ishome,0,1,1,0,1,1,0,0,1,1,1,0
8999,,,chaeyafucker69,1,1,2,1,1,2,0,0.006687,0,0,0,0
9000,,,Xtrme4,5,1,6,5,1,6,0.2,0.033436,0,0,0,0
9001,,,maestrasjd,0,1,1,0,1,1,0,0,1,1,1,0
9002,,,keikiichan,2,1,3,2,1,3,0.5,0.016869,0,0,0,0
9003,,,ichigoluvrs,1,3,4,1,3,4,0.333333,0.006687,1,1,1,0
9004,,,schubertquartet,3,1,4,3,1,4,0.333333,0.020061,0,0,0,0
9005,,,JJ1neLove5,0,1,1,0,1,1,0,0,1,1,1,0
9006,,,legitcrix,1,1,2,1,1,2,0,0.006687,0,0,0,0
9007,,,candymh46,5,1,6,5,1,6,0.2,0.033436,0,0,0,0
9008,,,cCNudID3hG1xxT4,0,1,1,0,1,1,0,0,1,1,1,0
9009,,,__Moonlight00,0,1,1,0,1,1,0,0,1,1,1,0
9010,,,MaMonty,0,1,1,0,1,1,0,0,1,1,1,0
9011,,,BrendaEliaLara1,0,1,1,0,1,1,0,0,1,1,1,0
9012,,,wastelands_baby,3,1,4,3,1,4,0.333333,0.020061,0,0,0,0
9013,,,seuIie,0,1,1,0,1,1,0,0,1,1,1,0
9014,,,AmirahCuenca,0,1,1,0,1,1,0,0,1,1,1,0
9015,,,coughdropsh,2,1,3,2,1,3,0.5,0.013374,0,0,0,0
9016,,,tru_selfie_king,2,1,3,2,1,3,0.5,0.013374,0,0,0,0
9017,,,milkzoro,0,1,1,0,1,1,0,0,1,1,1,0
9018,,,dilfboob,0,1,1,0,1,1,0,0,1,1,1,0
9019,,,jungkookmcqueen,0,1,1,0,1,1,0,0,1,1,1,0
9020,,,victorli2000,0,1,1,0,1,1,0,0,1,1,1,0
9021,,,totallynotpetit,0,1,1,0,1,1,0,0,1,1,1,0
9022,,,hongswn,0,1,1,0,1,1,0,0,1,1,1,0
9023,,,TheHiveSports,1,1,2,1,1,2,0,0.006687,0,0,0,0
9024,,,Saulzy15,1,1,2,1,1,2,0,0.006687,0,0,0,0
9025,,,markburgerenerg,0,1,1,0,1,1,0,0,1,1,1,0
9026,,,PattyQuain,0,1,1,0,1,1,0,0,1,1,1,0
9027,,,Ese_Chely,0,1,1,0,1,1,0,0,1,1,1,0
9028,,,ryan_lofthouse,0,1,1,0,1,1,0,0,1,1,1,0
9029,,,JaneOwenMurphy1,0,1,1,0,1,1,0,0,1,1,1,0
9030,,,pingpong512,0,1,1,0,1,1,0,0,1,1,1,0
9031,,,wellbeing4you,0,1,1,0,1,1,0,0,1,1,1,0
9032,,,EdwardHiguera5,0,1,1,0,1,1,0,0,1,1,1,0
9033,,,PirAteezQueen04,0,1,1,0,1,1,0,0,1,1,1,0
9034,,,AnzuYazli,0,1,1,0,1,1,0,0,1,1,1,0
9035,,,kiwinot,0,1,1,0,1,1,0,0,1,1,1,0
9036,,,corbinbleu4eva,0,1,1,0,1,1,0,0,1,1,1,0
9037,,,orangehood,0,1,1,0,1,1,0,0,1,1,1,0
9038,,,George03974714,0,1,1,0,1,1,0,0,1,1,1,0
9039,,,megumegumoni,0,1,1,0,1,1,0,0,1,1,1,0
9040,,,keanu_nini,0,2,2,0,2,2,0,0,1,1,1,0
9041,,,dynamite_gold,0,1,1,0,1,1,0,0,1,1,1,0
9042,,,r_adreamer,0,1,1,0,1,1,0,0,1,1,1,0
9043,,,Innieinn,0,1,1,0,1,1,0,0,2,0.6,0.666667,0
9044,,,xuanyiiii,0,1,1,0,1,1,0,0,2,0.6,0.666667,0
9045,,,louavullcard,0,1,1,0,1,1,0,0,2,0.6,0.666667,0
9046,,,DBootcheck,0,1,1,0,1,1,0,0,2,0.6,0.666667,0
9047,,,Evamalerka,0,1,1,0,1,1,0,0,2,0.6,0.666667,0
9048,,,manicmondaiz,2,1,3,2,1,3,0.5,0.013374,0,0,0,0
9049,,,SongsOfLaredo,0,1,1,0,1,1,0,0,1,1,1,0
9050,,,pointofviewyug,6,1,7,6,1,7,0.166667,0.040123,0,0,0,0
9051,,,Kimgtrue2me,0,1,1,0,1,1,0,0,1,1,1,0
9052,,,charlesmok,0,1,1,0,1,1,0,0,1,1,1,0
9053,,,sukunamu,0,1,1,0,1,1,0,0,1,1,1,0
9054,,,yummi_yanni,0,1,1,0,1,1,0,0,1,1,1,0
9055,,,_amisas95,0,1,1,0,1,1,0,0,1,1,1,0
9056,,,Aidan_V_U,0,1,1,0,1,1,0,0,1,1,1,0
9057,,,Mark_Kawada,0,1,1,0,1,1,0,0,1,1,1,0
9058,,,1ll_be_that,0,1,1,0,1,1,0,0,3,0.5,0.611111,0
9059,,,mgrosey,0,1,1,0,1,1,0,0,3,0.5,0.611111,0
9060,,,SerendipitySays,0,1,1,0,2,2,0,0,3,0.5,0.611111,0
9061,,,pikahyuni,0,1,1,0,1,1,0,0,1,1,1,0
9062,,,ntrinehart,2,1,3,2,1,3,0.5,0.013374,0,0,0,0
9063,,,Bonbon202020,0,1,1,0,1,1,0,0,1,1,1,0
9064,,,chanlixcat,2,1,3,2,1,3,0.5,0.013374,0,0,0,0
9065,,,barbarella88,0,1,1,0,1,1,0,0,1,1,1,0
9066,,,liamigatita,4,1,5,4,1,5,0.25,0.033737,0,0,0,0
9067,,,pettecal72,2,1,3,2,1,3,0.5,0.013374,0,0,0,0
9068,,,AlainaAppaloosa,0,1,1,0,1,1,0,0,1,1,1,0
9069,,,kingoftiredness,1,1,2,1,1,2,0,0.006687,0,0,0,0
9070,,,pyuIily,1,1,2,1,1,2,0,0.006687,0,0,0,0
9071,,,bigfunnystweets,2,1,3,2,1,3,0.5,0.013374,0,0,0,0
9072,,,Lennyfrigginleo,0,1,1,0,1,1,0,0,1,1,1,0
9073,,,KyPro7,0,1,1,0,1,1,0,0,1,1,1,0
9074,,,pridepcy,0,1,1,0,1,1,0,0,1,1,1,0
9075,,,jminvantae,6,1,7,6,1,7,0.166667,0.047111,0,0,0,0
9076,,,vinivinidogo,0,1,1,0,1,1,0,0,1,1,1,0
9077,,,dizzydaydreame,0,1,1,0,1,1,0,0,1,1,1,0
9078,,,tgcfhualiiian,0,1,1,0,1,1,0,0,1,1,1,0
9079,,,1947Granny,0,1,1,0,1,1,0,0,1,1,1,0
9080,,,adorelews,1,2,3,1,2,3,0.5,0.006687,1,1,1,0
9081,,,peoplestyle,3,1,4,3,1,4,0.333333,0.020061,0,0,0,0
9082,,,MiliPCar,0,1,1,0,1,1,0,0,1,1,1,0
9083,,,honeydewdiet,6,1,7,6,1,7,0.166667,0.047111,0,0,0,0
9084,,,JudyCar77801078,0,1,1,0,1,1,0,0,1,1,1,0
9085,,,xmhveri,2,3,5,2,3,5,0.25,0.013374,1,1,1,2
9086,,,Zeddie101,0,1,1,0,1,1,0,0,1,1,1,0
9087,,,LambchopJustin,7,1,8,7,1,8,0.142857,0.081752,0,0,0,0
9088,,,shoejunkiez,0,1,1,0,1,1,0,0,1,1,1,0
9089,,,professorfun,5,1,6,6,2,8,0.2,0.040424,0,0,0,0
9090,,,hyxflop,2,2,4,3,3,6,0.333333,0.013374,1,1,1,1
9091,,,RImmy2pointO,0,1,1,0,1,1,0,0,1,1,1,0
9092,,,sKate2412,0,1,1,0,1,1,0,0,1,1,1,0
9093,,,elena_solovei5,0,1,1,0,1,1,0,0,1,1,1,0
9094,,,kenkircher1,0,4,4,0,4,4,0,0,1,1,1,0
9095,,,iamkingtobster,0,1,1,0,1,1,0,0,1,1,1,0
9096,,,Observa35589017,0,1,1,0,1,1,0,0,1,1,1,0
9097,,,Shadowchild05,0,1,1,0,1,1,0,0,1,1,1,0
9098,,,MichCorsilles,0,1,1,0,1,1,0,0,1,1,1,0
9099,,,IRWDnews,5,1,6,5,1,6,0.2,0.033436,0,0,0,0
9100,,,prxxtyu,0,1,1,0,1,1,0,0,1,1,1,0
9101,,,noturchilde,0,1,1,0,1,1,0,0,1,1,1,0
9102,,,shoutosneezing,6,1,7,6,1,7,0.166667,0.040123,0,0,0,0
9103,,,Jamilahm,0,1,1,0,1,1,0,0,1,1,1,0
9104,,,GabrielO4Sho,0,1,1,0,1,1,0,0,1,1,1,0
9105,,,Karamelliee_pbi,0,1,1,0,1,1,0,0,1,1,1,0
9106,,,angelheart2015,0,1,1,0,1,1,0,0,1,1,1,0
9107,,,reginaaorozcoo,0,2,2,0,2,2,0,0,1,1,1,0
9108,,,MorganLowersTV,1,1,2,1,1,2,0,0.006687,0,0,0,0
9109,,,naydcasart,6,1,7,6,1,7,0.166667,0.055634,0,0,0,0
9110,,,itsbright4win,0,1,1,0,1,1,0,0,1,1,1,0
9111,,,wajin_3_,0,1,1,0,1,1,0,0,1,1,1,0
9112,,,rachelkhong,2,1,3,2,1,3,0.5,0.013374,0,0,0,0
9113,,,Liu_James,0,1,1,0,1,1,0,0,1,1,1,0
9114,,,bikerbf,5,1,6,5,1,6,0.2,0.033436,0,0,0,0
9115,,,scandallk,0,1,1,0,1,1,0,0,1,1,1,0
9116,,,fuyudoII,0,1,1,0,1,1,0,0,1,1,1,0
9117,,,DYNGBLUE,0,3,3,0,3,3,0,0,1,1,1,0
9118,,,missnotyou,0,1,1,0,1,1,0,0,1,1,1,0
9119,,,always_michyeo,0,1,1,0,1,1,0,0,2,0.571429,0.625,0
9120,,,YuzuWith_Vick,0,11,11,0,15,15,0.009091,0,3,0.642857,0.777778,0
9121,,,euwhoriea,0,1,1,0,1,1,0,0,2,0.571429,0.625,0
9122,,,Travelaviator,0,1,1,0,1,1,0,0,2,0.571429,0.625,0
9123,,,TheXingor,6,1,7,7,1,8,0.166667,0.040123,0,0,0,0
9124,,,Paul_Rottenberg,0,1,1,0,2,2,0,0,1,1,1,0
9125,,,MySunshineSUN00,0,1,1,0,1,1,0,0,1,1,1,0
9126,,,dmjvpi,0,1,1,0,1,1,0,0,1,1,1,0
9127,,,shut_up_joshua,0,1,1,0,1,1,0,0,1,1,1,0
9128,,,Jawbrea88693293,0,1,1,0,1,1,0,0,1,1,1,0
9129,,,Squirrel_MA,0,1,1,0,1,1,0,0,1,1,1,0
9130,,,ShopsyO,4,1,5,4,1,5,0.25,0.026749,0,0,0,0
9131,,,GeoJiamin,0,1,1,0,1,1,0,0,1,1,1,0
9132,,,SportsREDEF,1,1,2,1,1,2,0,0.006687,0,0,0,0
9133,,,mimichard417,0,1,1,0,1,1,0,0,3,0.428571,0.5,0
9134,,,tonichelleak,0,1,1,0,1,1,0,0,3,0.428571,0.5,0
9135,,,nancypa53220704,0,1,1,0,1,1,0,0,3,0.428571,0.5,0
9136,,,SolarisSystema,0,1,1,0,1,1,0,0,3,0.428571,0.5,0
9137,,,infernalvanity,0,1,1,0,1,1,0,0,1,1,1,0
9138,,,mypublicmike,0,1,1,0,1,1,0,0,1,1,1,0
9139,,,brett5355sports,0,1,1,0,1,1,0,0,1,1,1,0
9140,,,scottas,0,1,1,0,1,1,0,0,1,1,1,0
9141,,,Kaefanny,0,1,1,0,1,1,0,0,1,1,1,0
9142,,,MrMcPhallus,1,1,2,1,1,2,0,0.006687,0,0,0,0
9143,,,perryxperry,3,1,4,3,1,4,0.333333,0.020061,0,0,0,0
9144,,,sagir42,0,2,2,0,2,2,0,0,1,1,1,0
9145,,,DAYDREAMER2640,4,1,5,4,1,5,0.25,0.026749,0,0,0,0
9146,,,Jaquebelle,0,1,1,0,1,1,0,0,1,1,1,0
9147,,,StarryNight_097,0,2,2,0,2,2,0,0,1,1,1,0
9148,,,ljanesherrera,0,1,1,0,1,1,0,0,1,1,1,0
9149,,,RosaDiaz2000,7,1,8,8,1,9,0.142857,0.04681,0,0,0,0
9150,,,petegiven68,0,1,1,0,2,2,0,0,1,1,1,0
9151,,,kikoyuh,0,1,1,0,1,1,0,0,1,1,1,0
9152,,,deepvard,0,1,1,0,1,1,0,0,1,1,1,0
9153,,,LoveisCthulhu,0,1,1,0,1,1,0,0,1,1,1,0
9154,,,cyborrrg_,0,1,1,0,1,1,0,0,1,1,1,0
9155,,,pvkh_twt,1,1,2,1,1,2,0,0.006687,0,0,0,0
9156,,,SportsEngine,7,1,8,7,1,8,0.142857,0.060787,0,0,0,0
9157,,,RMonoRkives,0,1,1,0,1,1,0,0,1,1,1,0
9158,,,TheBrianPark,0,1,1,0,1,1,0,0,1,1,1,0
9159,,,krivzmirror,0,1,1,0,1,1,0,0,1,1,1,0
9160,,,Anna44787170,0,1,1,0,1,1,0,0,1,1,1,0
9161,,,luv_mydachshund,0,1,1,0,1,1,0,0,1,1,1,0
9162,,,BondageLand,1,1,2,1,1,2,0,0.006687,0,0,0,0
9163,,,Iynnvely,1,1,2,1,1,2,0,0.006687,0,0,0,0
9164,,,fwis2356,0,1,1,0,1,1,0,0,1,1,1,0
9165,,,EmmaKropf,0,1,1,0,1,1,0,0,1,1,1,0
9166,,,ot8minho,5,1,6,5,1,6,0.2,0.033436,0,0,0,0
9167,,,dtr1879,0,1,1,0,1,1,0,0,1,1,1,0
9168,,,junsu_simp,0,1,1,0,1,1,0,0,1,1,1,0
9169,,,floravinn,0,1,1,0,1,1,0,0,1,1,1,0
9170,,,rachelyohee,2,1,3,2,1,3,0.5,0.02701,0,0,0,0
9171,,,ilyPurplehearts,5,3,8,5,3,8,0.017857,0.0198,1,1,1,14
9172,,,ohpointfivefics,6,1,7,7,2,9,0.166667,0.040123,0,0,0,0
9173,,,1marcomuoz,0,1,1,0,1,1,0,0,1,1,1,0
9174,,,lm9382,0,1,1,0,1,1,0,0,1,1,1,0
9175,,,Veniceeeeqt,0,1,1,0,1,1,0,0,1,1,1,0
9176,,,helgaurwashere,0,1,1,0,1,1,0,0,1,1,1,0
9177,,,stephaniemlee,0,1,1,0,1,1,0,0,1,1,1,0
9178,,,jive_king,6,1,7,7,1,8,0.2,0.053759,0,0,0,0
9179,,,robinandandyfan,0,1,1,0,1,1,0,0,1,1,1,0
9180,,,DonnaPerrotta,0,1,1,0,1,1,0,0,1,1,1,0
9181,,,AdamPascalFan,0,1,1,0,1,1,0,0,1,1,1,0
9182,,,StevenKnezevich,4,1,5,5,2,7,0.25,0.026749,0,0,0,0
9183,,,myukkgarue,0,1,1,0,1,1,0,0,1,1,1,0
9184,,,twobaskets,0,1,1,0,1,1,0,0,1,1,1,0
9185,,,Aminujungudo13,0,1,1,0,1,1,0,0,1,1,1,0
9186,,,baeksupreme5,2,1,3,2,1,3,0.5,0.013374,0,0,0,0
9187,,,FPLBraveheart,4,1,5,4,1,5,0.25,0.026749,0,0,0,0
9188,,,GobletEcho184,0,1,1,0,1,1,0,0,1,1,1,0
9189,,,jimgillis5,0,1,1,0,1,1,0,0,1,1,1,0
9190,,,minimonividas,0,1,1,0,1,1,0,0,1,1,1,0
9191,,,peacockTV,2,1,3,3,1,4,0.5,0.013374,0,0,0,0
9192,,,nasmax,0,1,1,0,1,1,0,0,1,1,1,0
9193,,,bellainamorata6,3,1,4,3,1,4,0.333333,0.020061,0,0,0,0
9194,,,AbdikaniAbdira1,0,1,1,0,1,1,0,0,1,1,1,0
9195,,,Marilyn93225865,0,1,1,0,1,1,0,0,1,1,1,0
9196,,,gzr529,0,1,1,0,1,1,0,0,1,1,1,0
9197,,,Woo2Kaz,0,1,1,0,1,1,0,0,1,1,1,0
9198,,,IShowHezi,0,1,1,0,1,1,0,0,1,1,1,0
9199,,,rosemary_night,0,1,1,0,1,1,0,0,1,1,1,0
9200,,,Legilimensss,0,1,1,0,1,1,0,0,1,1,1,0
9201,,,cutebutpsycho55,0,1,1,0,1,1,0,0,1,1,1,0
9202,,,totoroops,1,1,2,1,1,2,0,0.006687,0,0,0,0
9203,,,doyin86515319,0,1,1,0,1,1,0,0,1,1,1,0
9204,,,Swarthy_Bastard,0,1,1,0,1,1,0,0,1,1,1,0
9205,,,DaveBedore1,0,1,1,0,1,1,0,0,1,1,1,0
9206,,,Kanzo_Ba,0,1,1,0,1,1,0,0,1,1,1,0
9207,,,affinity_EA,0,1,1,0,1,1,0,0,1,1,1,0
9208,,,BridgestoneUS,2,1,3,2,1,3,0.5,0.013374,0,0,0,0
9209,,,AtropineD,0,1,1,0,1,1,0,0,1,1,1,0
9210,,,_seize_today_,0,1,1,0,1,1,0,0,1,1,1,0
9211,,,don_harris1,0,1,1,0,1,1,0,0,1,1,1,0
9212,,,redgeot,0,1,1,0,1,1,0,0,1,1,1,0
9213,,,atse12345,3,1,4,3,1,4,0.333333,0.051509,0,0,0,0
9214,,,Irene4MKE,13,1,14,14,1,15,0.076923,0.086933,0,0,0,0
9215,,,opssmyevans,0,1,1,0,1,1,0,0,1,1,1,0
9216,,,Gloucestergal2,0,1,1,0,1,1,0,0,1,1,1,0
9217,,,Elizabe29599604,0,1,1,0,1,1,0,0,1,1,1,0
9218,,,soralovesexo,0,1,1,0,1,1,0,0,1,1,1,0
9219,,,DAVID72309694,0,2,2,0,2,2,0,0,1,1,1,0
9220,,,shoma_uno_,0,3,3,0,3,3,0,0,1,1,1,0
9221,,,joshuworm,0,1,1,0,1,1,0,0,1,1,1,0
9222,,,ex0islifeu,0,1,1,0,1,1,0,0,1,1,1,0
9223,,,AprilYao20,0,1,1,0,2,2,0,0,1,1,1,0
9224,,,chiminieparkk,0,1,1,0,1,1,0,0,1,1,1,0
9225,,,bluebirdshay,0,1,1,0,1,1,0,0,1,1,1,0
9226,,,dailynewskit1,16,1,17,16,1,17,0.0625,0.176083,0,0,0,0
9227,,,mp3yves,0,2,2,0,2,2,0,0,1,1,1,0
9228,,,barnesdesign,0,1,1,0,1,1,0,0,1,1,1,0
9229,,,mollysmcdonough,0,1,1,0,1,1,0,0,1,1,1,0
9230,,,smhwhatevs,0,1,1,0,1,1,0,0,1,1,1,0
9231,,,Sonali_Kohli,0,1,1,0,1,1,0,0,1,1,1,0
9232,,,RaVinCha_,0,1,1,0,1,1,0,0,1,1,1,0
9233,,,wenjunhui26,0,1,1,0,1,1,0,0,1,1,1,0
9234,,,fyre__storm,0,1,1,0,1,1,0,0,1,1,1,0
9235,,,Yiling130613,0,1,1,0,1,1,0,0,1,1,1,0
9236,,,SS1GNORA,0,1,1,0,1,1,0,0,1,1,1,0
9237,,,Derekjohnjensen,0,1,1,0,1,1,0,0,1,1,1,0
9238,,,JMeinco,0,1,1,0,1,1,0,0,1,1,1,0
9239,,,Edward73601105,0,1,1,0,1,1,0,0,1,1,1,0
9240,,,Lorin_J_Smith,9,1,10,10,1,11,0.111111,0.063679,0,0,0,0
9241,,,zhaoyuecenter,0,1,1,0,1,1,0,0,1,1,1,0
9242,,,latimes,1,3,4,1,3,4,0.333333,0.006687,1,1,1,0
9243,,,patrickjd,0,1,1,0,1,1,0,0,1,1,1,0
9244,,,heelovecube,0,1,1,0,1,1,0,0,1,1,1,0
9245,,,poopwon,7,1,8,7,1,8,0.142857,0.04681,0,0,0,0
9246,,,actwoozi,0,1,1,0,1,1,0,0,1,1,1,0
9247,,,parritasoy,0,1,1,0,1,1,0,0,1,1,1,0
9248,,,shelly35160,0,2,2,0,2,2,0,0,1,1,1,0
9249,,,pixiegoos,0,1,1,0,1,1,0,0,1,1,1,0
9250,,,RealCaliSteve,0,1,1,0,1,1,0,0,1,1,1,0
9251,,,seabisquick,0,1,1,0,1,1,0,0,1,1,1,0
9252,,,HYDElST,0,2,2,0,2,2,0,0,1,1,1,0
9253,,,httpweareoneExo,0,1,1,0,1,1,0,0,1,1,1,0
9254,,,dewgong2008,0,1,1,0,1,1,0,0,1,1,1,0
9255,,,smadygo,0,1,1,0,1,1,0,0,1,1,1,0
9256,,,_carrrrrrrrrrrr,2,1,3,2,1,3,0.5,0.013374,0,0,0,0
9257,,,CEinChiIL,0,1,1,0,1,1,0,0,1,1,1,0
9258,,,borichilde,2,1,3,2,1,3,0.5,0.013374,0,0,0,0
9259,,,SteveStevens47,0,1,1,0,1,1,0,0,1,1,1,0
9260,,,JudgeThree,2,1,3,2,1,3,0.5,0.013374,0,0,0,0
9261,,,maddsapphic,0,1,1,0,1,1,0,0,1,1,1,0
9262,,,hyunhosgf,1,1,2,1,1,2,0,0.006687,0,0,0,0
9263,,,mayleechai,1,1,2,1,1,2,0,0.006687,0,0,0,0
9264,,,vulture,1,1,2,1,1,2,0,0.006687,0,0,0,0
9265,,,syunadayoo,0,1,1,0,1,1,0,0,1,1,1,0
9266,,,yomyomf,0,1,1,0,1,1,0,0,1,1,1,0
9267,,,char_nee,0,1,1,0,1,1,0,0,1,1,1,0
9268,,,saraht6581,13,1,14,14,2,16,0.076923,0.128864,0,0,0,0
9269,,,ImJohnNorman,2,1,3,2,1,3,0.5,0.013374,0,0,0,0
9270,,,autodog5150,0,1,1,0,1,1,0,0,1,1,1,0
9271,,,panty_splash,3,1,4,3,1,4,0.333333,0.020061,0,0,0,0
9272,,,YKid1olcExq2r0Y,0,1,1,0,1,1,0,0,1,1,1,0
9273,,,nezryma,0,1,1,0,1,1,0,0,1,1,1,0
9274,,,saradianebrown,4,1,5,4,1,5,0.25,0.04422,0,0,0,0
9275,,,maybeawriter,0,1,1,0,1,1,0,0,1,1,1,0
9276,,,filmactually,0,1,1,0,1,1,0,0,1,1,1,0
9277,,,kaalap,3,1,4,3,1,4,0.333333,0.020061,0,0,0,0
9278,,,kjyawe,0,1,1,0,1,1,0,0,1,1,1,0
9279,,,TerryMcSweeney,0,2,2,0,2,2,0,0,2,0.5625,0.611111,0
9280,,,helenwan1,4,3,7,4,3,7,0.166667,0.026749,1,1,1,6
9281,,,DianeEMeier,0,1,1,0,1,1,0,0,2,0.6,0.666667,0
9282,,,nanooMonroe,0,1,1,0,1,1,0,0,2,0.6,0.666667,0
9283,,,Lily628,0,1,1,0,1,1,0,0,2,0.6,0.666667,0
9284,,,Icy_Joeey,0,1,1,0,1,1,0,0,1,1,1,0
9285,,,JohnDalySports,1,1,2,1,1,2,0,0.006687,0,0,0,0
9286,,,JohnDalyNews,1,1,2,1,1,2,0,0.006687,0,0,0,0
9287,,,johndalytv,1,1,2,1,1,2,0,0.006687,0,0,0,0
9288,,,haramjoong,1,1,2,1,1,2,0,0.006687,0,0,0,0
9289,,,jengiford,0,1,1,0,1,1,0,0,1,1,1,0
9290,,,lisaussy,1,1,2,1,1,2,0,0.006687,0,0,0,0
9291,,,SportsbookBTC,1,1,2,1,1,2,0,0.006687,0,0,0,0
9292,,,BerkleyBearNews,2,1,3,2,1,3,0.5,0.013374,0,0,0,0
9293,,,jonbailiff,0,1,1,0,1,1,0,0,1,1,1,0
9294,,,BetFastcom,1,1,2,1,1,2,0,0.006687,0,0,0,0
9295,,,smfvk,1,1,2,1,1,2,0,0.006687,0,0,0,0
9296,,,TRANS_W0MAN,1,1,2,1,1,2,0,0.006687,0,0,0,0
9297,,,cynthia_cscslew,0,2,2,0,2,2,0,0,3,0.444444,0.541667,0
9298,,,19spyderman98,0,1,1,0,1,1,0,0,3,0.411765,0.47619,0
9299,,,NBCPhiladelphia,1,1,2,2,2,4,0,0.006687,0,0,0,0
9300,,,Bigtmoney25,0,1,1,0,1,1,0,0,3,0.5,0.583333,0
9301,,,youngmasato,1,1,2,1,1,2,0,0.006687,0,0,0,0
9302,,,owwnberg,3,1,4,3,1,4,0.333333,0.020061,0,0,0,0
9303,,,AgNews_Otto,0,1,1,0,1,1,0,0,1,1,1,0
9304,,,rpeter99,0,1,1,0,1,1,0,0,1,1,1,0
9305,,,samariel13,6,1,7,6,1,7,0.166667,0.040123,0,0,0,0
9306,,,tetepathykoo,0,1,1,0,1,1,0,0,1,1,1,0
9307,,,JohnMar22341402,0,1,1,0,1,1,0,0,1,1,1,0
9308,,,vladduthiersCBS,0,1,1,0,1,1,0,0,1,1,1,0
9309,,,baekniaz,0,1,1,0,1,1,0,0,1,1,1,0
9310,,,zbusng,6,1,7,7,2,9,0.166667,0.09603,0,0,0,0
9311,,,KKKKK_0131,0,1,1,0,1,1,0,0,1,1,1,0
9312,,,RayChipman,0,1,1,0,1,1,0,0,1,1,1,0
9313,,,brandysissyslut,0,1,1,0,1,1,0,0,1,1,1,0
9314,,,deMelo142,0,1,1,0,1,1,0,0,1,1,1,0
9315,,,PtkzNelson,0,1,1,0,1,1,0,0,1,1,1,0
9316,,,The_Andy_Bob,0,1,1,0,1,1,0,0,1,1,1,0
9317,,,zhang_yueting,0,1,1,0,1,1,0,0,1,1,1,0
9318,,,w0nwoogay,0,1,1,0,1,1,0,0,1,1,1,0
9319,,,livinlov,0,1,1,0,1,1,0,0,1,1,1,0
9320,,,puffel_pup,0,1,1,0,1,1,0,0,1,1,1,0
9321,,,KayHarty1,0,1,1,0,1,1,0,0,1,1,1,0
9322,,,elizabethtoni,0,1,1,0,1,1,0,0,1,1,1,0
9323,,,ale_gde_ya,0,1,1,0,1,1,0,0,1,1,1,0
9324,,,tanyaagler,8,1,9,8,1,9,0.125,0.077957,0,0,0,0
9325,,,gowonsatellite,3,3,6,3,3,6,0.2,0.020061,1,1,1,4
9326,,,yeonjdere,0,1,1,0,1,1,0,0,1,1,1,0
9327,,,palanina_,0,1,1,0,1,1,0,0,1,1,1,0
9328,,,momsaway79,0,1,1,0,1,1,0,0,1,1,1,0
9329,,,beyondyasmin,0,2,2,0,2,2,0,0,2,0.75,0.833333,0
9330,,,AnitaPeck11,0,1,1,0,1,1,0,0,1,1,1,0
9331,,,Brett_Fujioka,2,1,3,2,1,3,0.5,0.013374,0,0,0,0
9332,,,xandiecat,2,1,3,2,1,3,0.5,0.013374,0,0,0,0
9333,,,thechrisflyer,0,1,1,0,1,1,0,0,1,1,1,0
9334,,,HuffPost,1,1,2,1,1,2,0,0.006687,0,0,0,0
9335,,,CuratorPunished,1,1,2,1,1,2,0,0.006687,0,0,0,0
9336,,,LIXGRAM,4,1,5,4,1,5,0.25,0.026749,0,0,0,0
9337,,,sbregman87,0,1,1,0,1,1,0,0,1,1,1,0
9338,,,quean_bee,0,1,1,0,1,1,0,0,1,1,1,0
9339,,,kryzetano,0,1,1,0,1,1,0,0,2,0.6,0.666667,0
9340,,,Carolzyb,0,1,1,0,1,1,0,0,2,0.6,0.666667,0
9341,,,natsfert,6,1,7,6,1,7,0.166667,0.048918,0,0,0,0
9342,,,hobiballoon,0,1,1,0,1,1,0,0,1,1,1,0
9343,,,cherriebIossoms,0,1,1,0,1,1,0,0,1,1,1,0
9344,,,bevleonard,0,1,1,0,1,1,0,0,1,1,1,0
9345,,,PEABRAlNS,0,1,1,0,1,1,0,0,1,1,1,0
9346,,,tokyomonoh,0,1,1,0,1,1,0,0,1,1,1,0
9347,,,AkanneSTorres,0,1,1,0,1,1,0,0,1,1,1,0
9348,,,vynussy,0,1,1,0,1,1,0,0,1,1,1,0
9349,,,smallbeegirl,0,1,1,0,1,1,0,0,1,1,1,0
9350,,,HarvardCBAR,0,1,1,0,1,1,0,0,1,1,1,0
9351,,,BlueTinySock,0,1,1,0,1,1,0,0,1,1,1,0
9352,,,temaki1231,0,1,1,0,1,1,0,0,1,1,1,0
9353,,,whereszoro,0,1,1,0,1,1,0,0,3,0.444444,0.541667,0
9354,,,suyay_castro,0,1,1,0,1,1,0,0,3,0.444444,0.541667,0
9355,,,ashley3fleury,5,1,6,5,1,6,0.2,0.033436,0,0,0,0
9356,,,jennuinn,0,1,1,0,1,1,0,0,1,1,1,0
9357,,,kztyz,0,1,1,0,1,1,0,0,1,1,1,0
9358,,,luvitydreams,0,1,1,0,1,1,0,0,1,1,1,0
9359,,,gahye0nie,0,1,1,0,1,1,0,0,1,1,1,0
9360,,,whitecrow43,0,1,1,0,1,1,0,0,1,1,1,0
9361,,,chivalricblssm,0,1,1,0,1,1,0,0,1,1,1,0
9362,,,infondoal_Mar,0,1,1,0,1,1,0,0,1,1,1,0
9363,,,BoycottAhava,0,1,1,0,1,1,0,0,1,1,1,0
9364,,,edoster19,0,3,3,0,3,3,0,0,3,0.526316,0.566667,0
9365,,,Pompom_chaan,0,1,1,0,1,1,0,0,1,1,1,0
9366,,,resplendicity,0,1,1,0,1,1,0,0,1,1,1,0
9367,,,jessa_bateman,8,1,9,9,1,10,0.125,0.122598,0,0,0,0
9368,,,gyubeombeom,0,1,1,0,1,1,0,0,1,1,1,0
9369,,,Vanitha90586822,0,1,1,0,1,1,0,0,1,1,1,0
9370,,,prettyrainboy,3,2,5,3,2,5,0.25,0.020061,1,1,1,2
9371,,,astro_heather,0,1,1,0,1,1,0,0,1,1,1,0
9372,,,2015_Project,0,1,1,0,1,1,0,0,1,1,1,0
9373,,,rat_rsk,1,1,2,1,1,2,0,0.006687,0,0,0,0
9374,,,amethyst_bright,0,1,1,0,1,1,0,0,2,0.555556,0.6,0
9375,,,janellewang,3,1,4,4,2,6,0.333333,0.051509,0,0,0,0
9376,,,jaehyunturro,0,1,1,0,2,2,0,0,1,1,1,0
9377,,,Raluca13795980,0,1,1,0,1,1,0,0,1,1,1,0
9378,,,Pismom,0,1,1,0,1,1,0,0,1,1,1,0
9379,,,SpaceArtAl,0,1,1,0,1,1,0,0,1,1,1,0
9380,,,gyumbaIl,2,1,3,2,1,3,0.5,0.013374,0,0,0,0
9381,,,ChesterAllen2,0,1,1,0,1,1,0,0,1,1,1,0
9382,,,elvcathy,0,1,1,0,1,1,0,0,2,0.666667,0.75,0
9383,,,missgirardot,0,1,1,0,1,1,0,0,2,0.666667,0.75,0
9384,,,www_wuxian,0,1,1,0,1,1,0,0,2,0.571429,0.625,0
9385,,,ryujunyeoI,0,1,1,0,1,1,0,0,2,0.571429,0.625,0
9386,,,KIMNAMJ1N,0,1,1,0,1,1,0,0,2,0.571429,0.625,0
9387,,,myukii__,0,1,1,0,1,1,0,0,2,0.571429,0.625,0
9388,,,sxeishorty,0,1,1,0,1,1,0,0,2,0.571429,0.625,0
9389,,,akiwahiranari,0,1,1,0,1,1,0,0,2,0.571429,0.625,0
9390,,,_lxanna,0,1,1,0,1,1,0,0,1,1,1,0
9391,,,ChanningKateum,0,1,1,0,1,1,0,0,1,1,1,0
9392,,,_DataLoy,0,1,1,0,1,1,0,0,1,1,1,0
9393,,,keshantii,0,1,1,0,1,1,0,0,1,1,1,0
9394,,,sweeney_tx,1,1,2,1,1,2,0,0.006687,0,0,0,0
9395,,,quriouswish,1,1,2,1,1,2,0,0.006687,0,0,0,0
9396,,,ingrid_rizzolo,5,1,6,5,1,6,0.2,0.033436,0,0,0,0
9397,,,mothecrackhead,0,1,1,0,1,1,0,0,1,1,1,0
9398,,,taemiinx,0,1,1,0,1,1,0,0,1,1,1,0
9399,,,FatemaHelia,3,1,4,3,1,4,0.333333,0.023556,0,0,0,0
9400,,,RandomPark,0,1,1,0,1,1,0,0,1,1,1,0
9401,,,moonpupmoss,2,1,3,2,1,3,0.5,0.013374,0,0,0,0
9402,,,Ninzu__,0,1,1,0,1,1,0,0,1,1,1,0
9403,,,yoongsfilter,1,1,2,1,1,2,0,0.006687,0,0,0,0
9404,,,lsamsarax,4,1,5,5,2,7,0.25,0.026749,0,0,0,0
9405,,,merriemera,0,1,1,0,1,1,0,0,1,1,1,0
9406,,,estrellaplatina,0,1,1,0,1,1,0,0,1,1,1,0
9407,,,wallygbsa,0,1,1,0,1,1,0,0,1,1,1,0
9408,,,nwhlaila,0,1,1,0,1,1,0,0,1,1,1,0
9409,,,rice_is_kanin,0,1,1,0,1,1,0,0,1,1,1,0
9410,,,annajeansypolt1,0,1,1,0,1,1,0,0,1,1,1,0
9411,,,D3V1LD0M,0,1,1,0,1,1,0,0,1,1,1,0
9412,,,__flai,0,1,1,0,1,1,0,0,1,1,1,0
9413,,,jb_silverfox,0,1,1,0,1,1,0,0,1,1,1,0
9414,,,raphaelha67,0,1,1,0,1,1,0,0,1,1,1,0
9415,,,boopkoya,0,1,1,0,1,1,0,0,1,1,1,0
9416,,,Patigrl,0,1,1,0,1,1,0,0,1,1,1,0
9417,,,ChiChiWu8,1,1,2,1,1,2,0,0.006687,0,0,0,0
9418,,,20Rockford,4,1,5,4,1,5,0.25,0.026749,0,0,0,0
9419,,,seeu_pcy,0,1,1,0,1,1,0,0,1,1,1,0
9420,,,LokusPS4,0,1,1,0,1,1,0,0,1,1,1,0
9421,,,Adam_WVC,0,1,1,0,1,1,0,0,1,1,1,0
9422,,,pupkumori,8,1,9,8,1,9,0.125,0.067474,0,0,0,0
9423,,,derricott_mike,0,1,1,0,1,1,0,0,1,1,1,0
9424,,,emirimiri,0,1,1,0,1,1,0,0,1,1,1,0
9425,,,giannismarryme,0,1,1,0,1,1,0,0,1,1,1,0
9426,,,vantedrawss,0,1,1,0,1,1,0,0,1,1,1,0
9427,,,renjunlele,0,1,1,0,1,1,0,0,1,1,1,0
9428,,,ABCWorldNews,8,1,9,9,2,11,0.125,0.053497,0,0,0,0
9429,,,Rikachikachi,0,1,1,0,1,1,0,0,1,1,1,0
9430,,,Silent_Rain_,0,1,1,0,1,1,0,0,1,1,1,0
9431,,,Gri1161,0,1,1,0,1,1,0,0,1,1,1,0
9432,,,ImmigNewsDigest,2,1,3,2,1,3,0.5,0.013374,0,0,0,0
9433,,,artur_danielian,0,1,1,0,1,1,0,0,1,1,1,0
9434,,,Sweetangel009,4,1,5,4,1,5,0.25,0.061691,0,0,0,0
9435,,,tramlaw301,0,1,1,0,1,1,0,0,1,1,1,0
9436,,,choplawyer,0,1,1,0,1,1,0,0,1,1,1,0
9437,,,hutaomu,0,1,1,0,1,1,0,0,1,1,1,0
9438,,,it_nena_,0,1,1,0,1,1,0,0,1,1,1,0
9439,,,Flowers_9407,0,1,1,0,1,1,0,0,1,1,1,0
9440,,,traceyw22,0,1,1,0,1,1,0,0,1,1,1,0
9441,,,mshaffer5371,0,1,1,0,1,1,0,0,1,1,1,0
9442,,,meisterbuerger,0,1,1,0,1,1,0,0,1,1,1,0
9443,,,SOimLikeWord,0,1,1,0,1,1,0,0,1,1,1,0
9444,,,niniinthesea,0,1,1,0,1,1,0,0,1,1,1,0
9445,,,yuzuwh,0,1,1,0,1,1,0,0,1,1,1,0
9446,,,maoteddymao,0,1,1,0,1,1,0,0,1,1,1,0
9447,,,kslnewsradio,1,1,2,1,1,2,0,0.006687,0,0,0,0
9448,,,reikableu,0,1,1,0,1,1,0,0,1,1,1,0
9449,,,avoidchaos,0,1,1,0,1,1,0,0,1,1,1,0
9450,,,surewrap,0,1,1,0,1,1,0,0,1,1,1,0
9451,,,hitmanseokjin,0,1,1,0,1,1,0,0,1,1,1,0
9452,,,aaldef,3,2,5,3,2,5,0.25,0.020061,1,1,1,2
9453,,,catchinawave13,2,1,3,2,1,3,0.5,0.013374,0,0,0,0
9454,,,ShivaGa16335092,0,1,1,0,1,1,0,0,1,1,1,0
9455,,,yulinling001,0,1,1,0,1,1,0,0,3,0.5,0.583333,0
9456,,,DebSeligsohn,1,1,2,1,1,2,0,0.006687,0,0,0,0
9457,,,Olympics,2,1,3,2,1,3,0.5,0.013374,0,0,0,0
9458,,,ZMV9253,0,1,1,0,1,1,0,0,1,1,1,0
9459,,,seahorse_tls,5,1,6,5,1,6,0.2,0.075366,0,0,0,0
9460,,,YEUNGKAHCHUN,0,1,1,0,1,1,0,0,1,1,1,0
9461,,,chiichii2525,0,1,1,0,1,1,0,0,1,1,1,0
9462,,,fuyubaij,0,1,1,0,1,1,0,0,1,1,1,0
9463,,,heelsiblings,4,1,5,4,1,5,0.25,0.026749,0,0,0,0
9464,,,luli030130,0,1,1,0,1,1,0,0,1,1,1,0
9465,,,EmmaLea87901281,0,1,1,0,1,1,0,0,1,1,1,0
9466,,,miri77265855,0,1,1,0,1,1,0,0,1,1,1,0
9467,,,lattefrog_,1,1,2,1,1,2,0,0.006687,0,0,0,0
9468,,,mauriezn,0,1,1,0,1,1,0,0,1,1,1,0
9469,,,DanaGoldstein,2,1,3,2,1,3,0.5,0.013374,0,0,0,0
9470,,,beepbopwine,0,1,1,0,1,1,0,0,1,1,1,0
9471,,,saturniidaemon,1,1,2,1,1,2,0,0.006687,0,0,0,0
9472,,,seventeen,6,1,7,6,1,7,0.166667,0.040123,0,0,0,0
9473,,,ShadowslightC,0,1,1,0,1,1,0,0,1,1,1,0
9474,,,llleejinki,0,1,1,0,1,1,0,0,1,1,1,0
9475,,,djabronx,0,1,1,0,1,1,0,0,1,1,1,0
9476,,,AOnusu,0,1,1,0,1,1,0,0,1,1,1,0
9477,,,MiLaPearx,0,1,1,0,1,1,0,0,1,1,1,0
9478,,,itsannuhhhh,6,1,7,6,1,7,0.166667,0.040123,0,0,0,0
9479,,,tripl_ee3,0,1,1,0,1,1,0,0,1,1,1,0
9480,,,ThomasJankow,0,1,1,0,1,1,0,0,1,1,1,0
9481,,,cogrannie,0,1,1,0,1,1,0,0,1,1,1,0
9482,,,CHOS0S,0,1,1,0,1,1,0,0,1,1,1,0
9483,,,ellnlvll,9,1,10,9,1,10,0.111111,0.060184,0,0,0,0
9484,,,aphotomama,0,1,1,0,1,1,0,0,1,1,1,0
9485,,,mymirei25,0,1,1,0,1,1,0,0,1,1,1,0
9486,,,m_warshaw,0,1,1,0,1,1,0,0,1,1,1,0
9487,,,TeckKim1,0,1,1,0,1,1,0,0,1,1,1,0
9488,,,yasnayasun,0,1,1,0,1,1,0,0,1,1,1,0
9489,,,RGurrrr,0,1,1,0,1,1,0,0,1,1,1,0
9490,,,shuixihuan,0,1,1,0,1,1,0,0,1,1,1,0
9491,,,JeffmChicago,0,1,1,0,1,1,0,0,1,1,1,0
9492,,,bunniyspit,0,1,1,0,1,1,0,0,1,1,1,0
9493,,,murielcooperI,0,1,1,0,1,1,0,0,1,1,1,0
9494,,,cindychangLA,0,1,1,0,1,1,0,0,1,1,1,0
9495,,,NetAesthetic,0,1,1,0,1,1,0,0,1,1,1,0
9496,,,TonyVen91213747,0,2,2,0,2,2,0,0,1,1,1,0
9497,,,KoheiSakamoto88,0,1,1,0,1,1,0,0,1,1,1,0
9498,,,marieann66,6,1,7,6,1,7,0.166667,0.040123,0,0,0,0
9499,,,xxxseungriseyo2,0,1,1,0,1,1,0,0,1,1,1,0
9500,,,chentingyi16,0,1,1,0,1,1,0,0,1,1,1,0
9501,,,swttloey,0,1,1,0,1,1,0,0,1,1,1,0
9502,,,basicwhiteM0m,0,1,1,0,1,1,0,0,1,1,1,0
9503,,,Leopardvl,0,2,2,0,2,2,0,0,3,0.555556,0.666667,0
9504,,,emilamok,1,1,2,2,2,4,0,0.006687,0,0,0,0
9505,,,squishyyjks,0,1,1,0,1,1,0,0,3,0.5,0.583333,0
9506,,,lady_atreides,1,1,2,1,1,2,0,0.006687,0,0,0,0
9507,,,975Hans,13,1,14,14,1,15,0.076923,0.090427,0,0,0,0
9508,,,roseschacha,0,3,3,0,3,3,0,0,1,1,1,0
9509,,,Bigboomboomdumb,0,1,1,0,2,2,0,0,1,1,1,0
9510,,,Sei363,0,1,1,0,1,1,0,0,1,1,1,0
9511,,,RobertSteurer,0,1,1,0,1,1,0,0,1,1,1,0
9512,,,DeepOfPurple2,0,1,1,0,1,1,0,0,1,1,1,0
9513,,,princessaelli,0,2,2,0,2,2,0,0,1,1,1,0
9514,,,Mutuals_Issabel,0,1,1,0,1,1,0,0,1,1,1,0
9515,,,supremeMIN95,0,1,1,0,1,1,0,0,1,1,1,0
9516,,,DerickGreen27,0,1,1,0,1,1,0,0,1,1,1,0
9517,,,oohsehunsdior,0,1,1,0,1,1,0,0,1,1,1,0
9518,,,KevinKevintogo,5,1,6,6,2,8,0.2,0.064884,0,0,0,0
9519,,,InthemindofCP,0,1,1,0,1,1,0,0,1,1,1,0
9520,,,chimmiebomb,1,1,2,1,1,2,0,0.006687,0,0,0,0
9521,,,celebspkrs4u,3,1,4,3,1,4,0.333333,0.030544,0,0,0,0
9522,,,EVERVILLAINOUS,2,1,3,2,1,3,0.5,0.013374,0,0,0,0
9523,,,Idocki1,0,1,1,0,1,1,0,0,1,1,1,0
9524,,,zd_wen,0,1,1,0,2,2,0,0,1,1,1,0
9525,,,hotAbaby,0,10,10,0,10,10,0,0,2,0.916667,0.954545,0
9526,,,always_simping_,0,1,1,0,1,1,0,0,1,1,1,0
9527,,,selina_dulce,0,1,1,0,1,1,0,0,1,1,1,0
9528,,,jem3781,0,1,1,0,1,1,0,0,1,1,1,0
9529,,,haoyun11725880,0,1,1,0,1,1,0,0,1,1,1,0
9530,,,haleyyyyyei,3,1,4,3,1,4,0.333333,0.020061,0,0,0,0
9531,,,socalboy13,0,1,1,0,1,1,0,0,1,1,1,0
9532,,,YahooSportsNBA,0,1,1,0,1,1,0,0,1,1,1,0
9533,,,newspedy,3,1,4,4,2,6,0.333333,0.020061,0,0,0,0
9534,,,YachiRosso,0,1,1,0,1,1,0,0,1,1,1,0
9535,,,YahooSports,2,1,3,2,1,3,0.5,0.013374,0,0,0,0
9536,,,enbyinthemoon,0,1,1,0,1,1,0,0,1,1,1,0
9537,,,cupidcitrus,9,3,12,11,5,16,0.1,0.060184,1,1,1,15
9538,,,jerry56241107,0,1,1,0,1,1,0,0,1,1,1,0
9539,,,FlagsNews,6,1,7,6,1,7,0.166667,0.040123,0,0,0,0
9540,,,Phoebebebe47,0,1,1,0,1,1,0,0,1,1,1,0
9541,,,bassinfusion,0,1,1,0,1,1,0,0,1,1,1,0
9542,,,alamura_29,0,1,1,0,1,1,0,0,1,1,1,0
9543,,,taeselkook,0,1,1,0,1,1,0,0,1,1,1,0
9544,,,Reneebort,0,1,1,0,1,1,0,0,1,1,1,0
9545,,,hanyusann,7,1,8,7,1,8,0.142857,0.081752,0,0,0,0
9546,,,pyrothoma,0,1,1,0,1,1,0,0,1,1,1,0
9547,,,zakuro9,0,1,1,0,1,1,0,0,1,1,1,0
9548,,,IllusionSpinz,0,1,1,0,1,1,0,0,1,1,1,0
9549,,,loficraftian,0,1,1,0,1,1,0,0,1,1,1,0
9550,,,midtown_spidey,0,2,2,0,2,2,0,0,1,1,1,0
9551,,,angeIbreak,2,1,3,2,1,3,0.5,0.013374,0,0,0,0
9552,,,KaseyRowberry11,0,1,1,0,1,1,0,0,1,1,1,0
9553,,,simuzah,3,1,4,3,1,4,0.333333,0.020061,0,0,0,0
9554,,,r0bertz,0,1,1,0,1,1,0,0,1,1,1,0
9555,,,KocaFame,0,1,1,0,1,1,0,0,1,1,1,0
9556,,,CmontilaOU,2,1,3,2,1,3,0.5,0.013374,0,0,0,0
9557,,,SAndricsak,0,2,2,0,2,2,0,0,1,1,1,0
9558,,,BlackRhinoArts,0,1,1,0,1,1,0,0,1,1,1,0
9559,,,cindyb1333,0,1,1,0,1,1,0,0,1,1,1,0
9560,,,irwinsniaall,0,2,2,0,2,2,0,0,3,0.5,0.633333,0
9561,,,JAnn0308,0,1,1,0,1,1,0,0,1,1,1,0
9562,,,Chattaboogie713,4,1,5,4,1,5,0.25,0.026749,0,0,0,0
9563,,,uglygabriel,0,2,2,0,2,2,0,0,1,1,1,0
9564,,,heidicullinan,0,1,1,0,1,1,0,0,1,1,1,0
9565,,,socksp0,6,1,7,8,1,9,0.166667,0.047111,0,0,0,0
9566,,,bluemiIf,0,1,1,0,1,1,0,0,1,1,1,0
9567,,,nancykric,8,1,9,9,2,11,0.125,0.053497,0,0,0,0
9568,,,Raberyne,0,1,1,0,1,1,0,0,1,1,1,0
9569,,,Enjoyfood_,0,1,1,0,1,1,0,0,1,1,1,0
9570,,,Vya4ko,0,1,1,0,1,1,0,0,1,1,1,0
9571,,,Hana_star_,0,1,1,0,1,1,0,0,1,1,1,0
9572,,,saralab75,0,1,1,0,1,1,0,0,1,1,1,0
9573,,,granni9,0,2,2,0,2,2,0,0,2,0.666667,0.75,0
9574,,,Quaferu,0,1,1,0,1,1,0,0,1,1,1,0
9575,,,XinWei57337546,2,1,3,2,1,3,0.5,0.013374,0,0,0,0
9576,,,Brwn_Samurai,4,1,5,4,1,5,0.25,0.026749,0,0,0,0
9577,,,stacy5832,0,1,1,0,1,1,0,0,1,1,1,0
9578,,,CEOofCATBOY,4,1,5,5,2,7,0.25,0.026749,0,0,0,0
9579,,,BoazDuane,0,1,1,0,1,1,0,0,1,1,1,0
9580,,,maniee_ANNIE,0,1,1,0,1,1,0,0,1,1,1,0
9581,,,WWKingsBTS,0,1,1,0,1,1,0,0,1,1,1,0
9582,,,oopbigboobs,8,1,9,10,1,11,0.142857,0.403724,0,0,0,0
9583,,,vaculb,0,1,1,0,1,1,0,0,1,1,1,0
9584,,,SherAhm37630426,0,1,1,0,1,1,0,0,1,1,1,0
9585,,,2SEOO,0,1,1,0,1,1,0,0,1,1,1,0
9586,,,guxuan05,0,1,1,0,1,1,0,0,1,1,1,0
9587,,,Ronniesweatt0,0,2,2,0,3,3,0.5,0,2,0.75,0.833333,0
9588,,,Rosalind_tsyj,0,1,1,0,1,1,0,0,2,0.6,0.666667,0
9589,,,ClevelandChip,0,1,1,0,1,1,0,0,2,0.6,0.666667,0
9590,,,kclyle1,0,1,1,0,1,1,0,0,2,0.6,0.666667,0
9591,,,weiweimian,0,1,1,0,1,1,0,0,2,0.6,0.666667,0
9592,,,victoriamldnd_,0,1,1,0,1,1,0,0,2,0.6,0.666667,0
9593,,,babsn1228,0,1,1,0,1,1,0,0,2,0.6,0.666667,0
9594,,,MAIOUI,0,1,1,0,1,1,0,0,1,1,1,0
9595,,,strawberryy_sun,0,1,1,0,1,1,0,0,1,1,1,0
9596,,,girly_blues,0,1,1,0,1,1,0,0,2,0.666667,0.75,0
9597,,,AmyBrew23405257,3,1,4,3,1,4,0.333333,0.020061,0,0,0,0
9598,,,SimonMendes889,0,1,1,0,1,1,0,0,1,1,1,0
9599,,,georgeiskaruma,0,1,1,0,1,1,0,0,1,1,1,0
9600,,,junh_776,0,2,2,0,2,2,0,0,1,1,1,0
9601,,,Believe_N_USA,0,1,1,0,1,1,0,0,1,1,1,0
9602,,,slythersofia,0,1,1,0,1,1,0,0,1,1,1,0
9603,,,sebIackers,0,1,1,0,1,1,0,0,1,1,1,0
9604,,,stopifnot,0,1,1,0,1,1,0,0,1,1,1,0
9605,,,Lenny507MN,0,1,1,0,1,1,0,0,1,1,1,0
9606,,,AliAlexAli1234,0,1,1,0,1,1,0,0,1,1,1,0
9607,,,ajassimanwar,0,1,1,0,1,1,0,0,1,1,1,0
9608,,,Btabcj,0,1,1,0,1,1,0,0,1,1,1,0
9609,,,ninemond,0,1,1,0,1,1,0,0,1,1,1,0
9610,,,hirotiksst,0,2,2,0,2,2,0,0,1,1,1,0
9611,,,eric_m_phillips,0,1,1,0,1,1,0,0,1,1,1,0
9612,,,hillcrester,0,1,1,0,1,1,0,0,1,1,1,0
9613,,,Back_dafucup,0,1,1,0,1,1,0,0,1,1,1,0
9614,,,obithoes,0,1,1,0,1,1,0,0,1,1,1,0
9615,,,suh_premacy,0,1,1,0,1,1,0,0,1,1,1,0
9616,,,YaleFedSoc,0,1,1,0,1,1,0,0,1,1,1,0
9617,,,mitsuyanti,0,1,1,0,1,1,0,0,1,1,1,0
9618,,,JohnFahy7,0,1,1,0,1,1,0,0,1,1,1,0
9619,,,PalmerDouglas9,0,2,2,0,2,2,0,0,1,1,1,0
9620,,,shannyqt,0,1,1,0,1,1,0,0,1,1,1,0
9621,,,ZaqsPolitics,1,1,2,1,1,2,0,0.006687,0,0,0,0
9622,,,Saudi_Gazette,9,1,10,9,1,10,0.111111,0.103018,0,0,0,0
9623,,,CarrieLeBeau3,0,1,1,0,1,1,0,0,1,1,1,0
9624,,,cabbaby1,0,2,2,0,2,2,0,0,1,1,1,0
9625,,,_DinosaurChen,0,1,1,0,1,1,0,0,1,1,1,0
9626,,,honibeon,0,1,1,0,1,1,0,0,1,1,1,0
9627,,,Iamjrco,0,1,1,0,1,1,0,0,1,1,1,0
9628,,,do_ritan,0,1,1,0,1,1,0,0,1,1,1,0
9629,,,USCPF,10,1,11,10,1,11,0.1,0.066871,0,0,0,0
9630,,,birdgirlprobs,0,1,1,0,1,1,0,0,1,1,1,0
9631,,,SouthseaScene,0,1,1,0,1,1,0,0,1,1,1,0
9632,,,hivmiko,0,3,3,0,4,4,0,0,2,0.8,0.875,0
9633,,,plee62,0,1,1,0,1,1,0,0,1,1,1,0
9634,,,kataideen,0,1,1,0,1,1,0,0,1,1,1,0
9635,,,helO_v_,0,1,1,0,1,1,0,0,1,1,1,0
9636,,,fukurouchi,0,1,1,0,1,1,0,0,1,1,1,0
9637,,,mitochonderina,0,1,1,0,1,1,0,0,1,1,1,0
9638,,,briandb03,3,2,5,3,2,5,0.25,0.020061,2,0.6,0.666667,6
9639,,,noneofyours99,0,1,1,0,1,1,0,0,3,0.444444,0.541667,0
9640,,,pairofdicegreg,11,1,12,11,1,12,0.090909,0.073559,0,0,0,0
9641,,,moonkatsa,0,1,1,0,1,1,0,0,1,1,1,0
9642,,,dumptruck333,0,1,1,0,1,1,0,0,1,1,1,0
9643,,,RIOK660581291,0,1,1,0,1,1,0,0,1,1,1,0
9644,,,toyama912,0,1,1,0,1,1,0,0,1,1,1,0
9645,,,LinxyCi,0,1,1,0,1,1,0,0,1,1,1,0
9646,,,ahah_ravioli,0,1,1,0,1,1,0,0,1,1,1,0
9647,,,RoxannePappas,0,1,1,0,1,1,0,0,1,1,1,0
9648,,,LaSitora,0,1,1,0,1,1,0,0,1,1,1,0
9649,,,kunibe2hy,0,1,1,0,1,1,0,0,1,1,1,0
9650,,,rgm323,5,1,6,5,1,6,0.2,0.033436,0,0,0,0
9651,,,MadisonPearman,0,1,1,0,1,1,0,0,1,1,1,0
9652,,,francineorr,0,1,1,0,1,1,0,0,1,1,1,0
9653,,,AmanCreates,3,1,4,3,1,4,0.333333,0.020061,0,0,0,0
9654,,,NkkP0tTlGy6yLjH,0,1,1,0,1,1,0,0,1,1,1,0
9655,,,masamiiiiiiii,0,1,1,0,1,1,0,0,1,1,1,0
9656,,,albedo_my_love,0,2,2,0,2,2,0,0,1,1,1,0
9657,,,second_coin,0,1,1,0,1,1,0,0,1,1,1,0
9658,,,aznbicom,5,3,8,6,4,10,0.142857,0.047413,1,1,1,12
9659,,,kristiekusch,0,1,1,0,1,1,0,0,2,0.6,0.666667,0
9660,,,keedanewss,2,1,3,2,1,3,0.5,0.013374,0,0,0,0
9661,,,keying0907,0,1,1,0,1,1,0,0,1,1,1,0
9662,,,hunnifruit,2,1,3,3,2,5,0.5,0.013374,0,0,0,0
9663,,,Chiho_neko,0,2,2,0,2,2,0,0,1,1,1,0
9664,,,Morecoldbeer,1,1,2,1,1,2,0,0.006687,0,0,0,0
9665,,,hoseoksreally,3,1,4,3,1,4,0.333333,0.020061,0,0,0,0
9666,,,MichaelCThompso,0,3,3,0,5,5,0,0,1,1,1,0
9667,,,hnbc1,0,1,1,0,1,1,0,0,1,1,1,0
9668,,,hard2decide,1,2,3,1,2,3,0.5,0.006687,1,1,1,0
9669,,,etrnlyateez,0,1,1,0,1,1,0,0,1,1,1,0
9670,,,MirthalaCabrera,6,1,7,6,1,7,0.166667,0.040123,0,0,0,0
9671,,,ribako,0,1,1,0,1,1,0,0,1,1,1,0
9672,,,pinoko306,0,1,1,0,1,1,0,0,1,1,1,0
9673,,,_defenestracjaa,0,1,1,0,1,1,0,0,1,1,1,0
9674,,,craigmatsuda,0,4,4,0,4,4,0,0,1,1,1,0
9675,,,funkyartist,0,1,1,0,1,1,0,0,1,1,1,0
9676,,,312sjay,1,1,2,1,1,2,0,0.006687,0,0,0,0
9677,,,hwngmenu,1,1,2,1,1,2,0,0.006687,0,0,0,0
9678,,,kingtiashe,0,2,2,0,2,2,0,0,2,0.75,0.833333,0
9679,,,Vvbards,0,1,1,0,1,1,0,0,1,1,1,0
9680,,,GoodyAwards,1,1,2,1,1,2,0,0.006687,0,0,0,0
9681,,,melinda_mosheim,6,1,7,6,1,7,0.166667,0.040123,0,0,0,0
9682,,,Entangle2030,0,1,1,0,1,1,0,0,1,1,1,0
9683,,,maryroseketchum,0,1,1,0,1,1,0,0,1,1,1,0
9684,,,FiremanBob5,0,1,1,0,1,1,0,0,1,1,1,0
9685,,,Eamon0303,0,1,1,0,1,1,0,0,1,1,1,0
9686,,,BradPorcellato,2,1,3,2,1,3,0.5,0.013374,0,0,0,0
9687,,,RRossachacj,0,1,1,0,1,1,0,0,1,1,1,0
9688,,,thatsaltyasian,6,1,7,6,1,7,0.166667,0.040123,0,0,0,0
9689,,,BasicallyBTS3,0,1,1,0,1,1,0,0,1,1,1,0
9690,,,vivxtae,0,1,1,0,1,1,0,0,1,1,1,0
9691,,,maryalynx,0,1,1,0,1,1,0,0,1,1,1,0
9692,,,TQiw0wQeL8JSvoN,0,2,2,0,2,2,0,0,1,1,1,0
9693,,,Downtown11201,0,1,1,0,1,1,0,0,1,1,1,0
9694,,,certified_dilf,5,1,6,5,1,6,0.2,0.033436,0,0,0,0
9695,,,alocasiava,0,1,1,0,1,1,0,0,1,1,1,0
9696,,,zuvaati,0,1,1,0,1,1,0,0,1,1,1,0
9697,,,euphoriarchives,0,1,1,0,1,1,0,0,1,1,1,0
9698,,,clovertin_22_22,0,1,1,0,1,1,0,0,1,1,1,0
9699,,,Nobodylikesugab,0,1,1,0,1,1,0,0,1,1,1,0
9700,,,alliaks,0,1,1,0,1,1,0,0,1,1,1,0
9701,,,solacelands,0,1,1,0,1,1,0,0,1,1,1,0
9702,,,aghos7ina,0,1,1,0,1,1,0,0,1,1,1,0
9703,,,coupsofsvt,0,1,1,0,1,1,0,0,1,1,1,0
9704,,,micHELLezibby,0,1,1,0,1,1,0,0,1,1,1,0
9705,,,tekmds,0,1,1,0,1,1,0,0,1,1,1,0
9706,,,FDRLST,3,2,5,3,2,5,0.25,0.020061,1,1,1,2
9707,,,Mooggiiepoo,0,1,1,0,1,1,0,0,2,0.666667,0.75,0
9708,,,shoottheshoes,0,1,1,0,1,1,0,0,2,0.666667,0.75,0
9709,,,yoccorasho,0,1,1,0,1,1,0,0,1,1,1,0
9710,,,heartishurts,0,1,1,0,1,1,0,0,1,1,1,0
9711,,,donotbeordinary,0,3,3,0,3,3,0,0,4,0.5,0.680556,0
9712,,,TottenBill,0,1,1,0,1,1,0,0,1,1,1,0
9713,,,squishylixie,3,1,4,3,1,4,0.333333,0.020061,0,0,0,0
9714,,,_248tears,0,1,1,0,1,1,0,0,1,1,1,0
9715,,,TheREALMessyMom,0,1,1,0,1,1,0,0,1,1,1,0
9716,,,Energizer_Girl,0,1,1,0,1,1,0,0,1,1,1,0
9717,,,unlewis,0,1,1,0,1,1,0,0,1,1,1,0
9718,,,becool_tokyo,0,1,1,0,1,1,0,0,1,1,1,0
9719,,,PramitWorld,0,1,1,0,1,1,0,0,1,1,1,0
9720,,,kwakooly,2,1,3,3,2,5,0.5,0.013374,0,0,0,0
9721,,,godyih,3,1,4,3,1,4,0.333333,0.020061,0,0,0,0
9722,,,ChaosKilledtheD,0,1,1,0,1,1,0,0,1,1,1,0
9723,,,DeeAG_,0,1,1,0,1,1,0,0,1,1,1,0
9724,,,itschammiee,2,2,4,2,2,4,0.333333,0.013374,1,1,1,1
9725,,,Michael16304480,0,1,1,0,1,1,0,0,2,0.666667,0.75,0
9726,,,Ann_k128,0,2,2,0,2,2,0,0,2,0.75,0.833333,0
9727,,,agabis_,0,1,1,0,1,1,0,0,2,0.666667,0.75,0
9728,,,JiallCoran,6,1,7,6,1,7,0.166667,0.040123,0,0,0,0
9729,,,SueTuman,0,1,1,0,1,1,0,0,1,1,1,0
9730,,,zhongguoxin88,0,1,1,0,1,1,0,0,1,1,1,0
9731,,,AmiraDevant,0,2,2,0,2,2,0,0,1,1,1,0
9732,,,isabelguardiol3,0,1,1,0,1,1,0,0,1,1,1,0
9733,,,ErikVCW,0,1,1,0,1,1,0,0,1,1,1,0
9734,,,thunderflam,0,1,1,0,1,1,0,0,1,1,1,0
9735,,,happypumkin2003,0,1,1,0,1,1,0,0,1,1,1,0
9736,,,Lilmaranon,0,1,1,0,1,1,0,0,1,1,1,0
9737,,,MrFLOTUS,0,1,1,0,1,1,0,0,1,1,1,0
9738,,,pooh_8_2,0,2,2,0,2,2,0,0,1,1,1,0
9739,,,ChiJelly02,0,4,4,0,5,5,0,0,1,1,1,0
9740,,,iwyunho,1,1,2,1,1,2,0,0.006687,0,0,0,0
9741,,,Leila38_,6,1,7,7,2,9,0.166667,0.040123,0,0,0,0
9742,,,chiako__0330,0,1,1,0,1,1,0,0,1,1,1,0
9743,,,logbooth,0,1,1,0,1,1,0,0,1,1,1,0
9744,,,ozeuorz,0,1,1,0,1,1,0,0,1,1,1,0
9745,,,kazuncha,0,3,3,0,3,3,0,0,1,1,1,0
9746,,,constancecoys,1,1,2,1,1,2,0,0.006687,0,0,0,0
9747,,,will_barrcode,4,1,5,4,1,5,0.25,0.026749,0,0,0,0
9748,,,andrewlynds,0,1,1,0,1,1,0,0,1,1,1,0
9749,,,11305i12,0,1,1,0,1,1,0,0,1,1,1,0
9750,,,suga__kou,0,1,1,0,1,1,0,0,1,1,1,0
9751,,,PortiaColorado,2,1,3,2,1,3,0.5,0.013374,0,0,0,0
9752,,,bettegt1,0,1,1,0,1,1,0,0,1,1,1,0
9753,,,phillipethao,3,1,4,3,1,4,0.333333,0.020061,0,0,0,0
9754,,,Moto_Diablo666,6,1,7,6,1,7,0.166667,0.09603,0,0,0,0
9755,,,da67honey,0,1,1,0,1,1,0,0,1,1,1,0
9756,,,mymelodypcy,0,1,1,0,1,1,0,0,1,1,1,0
9757,,,aczhang0,0,1,1,0,1,1,0,0,1,1,1,0
9758,,,seoqueenist,0,1,1,0,1,1,0,0,1,1,1,0
9759,,,casienitrate,6,1,7,6,1,7,0.166667,0.040123,0,0,0,0
9760,,,aceitunawena,0,1,1,0,1,1,0,0,1,1,1,0
9761,,,PamelaRiii8628,0,1,1,0,1,1,0,0,1,1,1,0
9762,,,hightide172,0,1,1,0,1,1,0,0,1,1,1,0
9763,,,wsVo2Cpi6pbcBqm,0,1,1,0,1,1,0,0,1,1,1,0
9764,,,lesbwwx,0,1,1,0,1,1,0,0,1,1,1,0
9765,,,GiovanniAlbert,0,1,1,0,1,1,0,0,1,1,1,0
9766,,,GlRLGENERATlON,3,1,4,3,1,4,0.333333,0.020061,0,0,0,0
9767,,,StandupVoteBlu1,0,1,1,0,1,1,0,0,1,1,1,0
9768,,,Eveverse,0,1,1,0,1,1,0,0,1,1,1,0
9769,,,mishtilychee,2,1,3,2,1,3,0.5,0.013374,0,0,0,0
9770,,,ryuscupid,0,1,1,0,1,1,0,0,1,1,1,0
9771,,,dekeriverscp,2,1,3,2,1,3,0.5,0.013374,0,0,0,0
9772,,,dig_nkt_v2,0,1,1,0,1,1,0,0,1,1,1,0
9773,,,BachtoBach2,2,1,3,2,1,3,0.5,0.013374,0,0,0,0
9774,,,danstamm,0,1,1,0,1,1,0,0,1,1,1,0
9775,,,RNromatrump,1,1,2,1,1,2,0,0.006687,0,0,0,0
9776,,,Leznver,8,1,9,8,1,9,0.125,0.053497,0,0,0,0
9777,,,beatdiss3,0,1,1,0,1,1,0,0,1,1,1,0
9778,,,JulieSalesses,0,1,1,0,1,1,0,0,1,1,1,0
9779,,,cmodowd,0,1,1,0,1,1,0,0,1,1,1,0
9780,,,kentuckygrandma,0,1,1,0,1,1,0,0,1,1,1,0
9781,,,Xareee1Xareee,0,1,1,0,1,1,0,0,1,1,1,0
9782,,,candy95042350,0,1,1,0,1,1,0,0,1,1,1,0
9783,,,GeorgeWept,1,1,2,1,1,2,0,0.006687,0,0,0,0
9784,,,caffeinct,0,1,1,0,1,1,0,0,1,1,1,0
9785,,,ProFootballLive,1,1,2,1,1,2,0,0.006687,0,0,0,0
9786,,,wonbokie,8,1,9,8,1,9,0.125,0.056224,0,0,0,0
9787,,,NotxMe,0,1,1,0,1,1,0,0,1,1,1,0
9788,,,_jessywang,1,1,2,1,1,2,0,0.00396,1,1,1,1
9789,,,g0thlixie_,0,1,1,0,1,1,0,0,1,1,1,0
9790,,,Liehl11,0,1,1,0,1,1,0,0,1,1,1,0
9791,,,i_hereview,0,1,1,0,1,1,0,0,1,1,1,0
9792,,,TodoSports2021,17,2,19,20,5,25,0.055556,0.117176,3,0.5,0.611111,48
9793,,,kyoongvibes,0,1,1,0,1,1,0,0,4,0.4,0.520833,0
9794,,,hillmacmagill,0,1,1,0,1,1,0,0,4,0.4,0.520833,0
9795,,,hanyuballade1,0,1,1,0,1,1,0,0,2,0.666667,0.75,0
9796,,,ajsdrw,0,1,1,0,1,1,0,0,2,0.666667,0.75,0
9797,,,ArhinSamuel_A,0,3,3,0,3,3,0,0,2,0.8,0.875,0
9798,,,Buckysmiles,0,2,2,0,2,2,0,0,1,1,1,0
9799,,,RedloraineV,0,1,1,0,1,1,0,0,1,1,1,0
9800,,,evgeniabot,2,1,3,2,1,3,0.5,0.013374,0,0,0,0
9801,,,PatriceHCarr1,0,1,1,0,1,1,0,0,1,1,1,0
9802,,,feathersborn,17,1,18,23,6,29,0.058824,0.124164,0,0,0,0
9803,,,ccarneym,0,1,1,0,1,1,0,0,1,1,1,0
9804,,,suchaslacker,0,1,1,0,1,1,0,0,1,1,1,0
9805,,,zhanghsa,0,1,1,0,1,1,0,0,1,1,1,0
9806,,,SeriousSpidey,0,1,1,0,1,1,0,0,1,1,1,0
9807,,,TwisterFairy,9,1,10,11,1,12,0.111111,0.060184,0,0,0,0
9808,,,meerabee,0,2,2,0,2,2,0,0,1,1,1,0
9809,,,Sofia04052020,0,1,1,0,2,2,0,0,1,1,1,0
9810,,,kittiejiminie,0,1,1,0,1,1,0,0,1,1,1,0
9811,,,uniqtoeijaewon,0,1,1,0,1,1,0,0,1,1,1,0
9812,,,ElfanyXD,0,1,1,0,1,1,0,0,1,1,1,0
9813,,,Moons_of_Avalon,0,2,2,0,2,2,0,0,1,1,1,0
9814,,,godjihyopark,0,1,1,0,1,1,0,0,2,0.666667,0.75,0
9815,,,floppydog24,0,1,1,0,1,1,0,0,2,0.666667,0.75,0
9816,,,Jasminmarie_,0,1,1,0,1,1,0,0,2,0.666667,0.75,0
9817,,,iyunogf,0,1,1,0,1,1,0,0,2,0.666667,0.75,0
9818,,,mr_ushe,0,1,1,0,1,1,0,0,2,0.666667,0.75,0
9819,,,DlLFCHIGO,1,1,2,1,1,2,0,0.006687,0,0,0,0
9820,,,grandma_sus,1,1,2,1,1,2,0,0.006687,0,0,0,0
9821,,,broke_but_woke_,5,1,6,5,1,6,0.2,0.033436,0,0,0,0
9822,,,abc_styles_27,0,1,1,0,1,1,0,0,1,1,1,0
9823,,,shibuiyay,0,1,1,0,1,1,0,0,1,1,1,0
9824,,,PamMelissaSell,3,1,4,3,1,4,0.333333,0.020061,0,0,0,0
9825,,,jjoywifey,0,1,1,0,1,1,0,0,1,1,1,0
9826,,,reneelin01,0,1,1,0,1,1,0,0,1,1,1,0
9827,,,baked_reegatoni,2,1,3,2,1,3,0.5,0.013374,0,0,0,0
9828,,,imkookt,0,2,2,0,2,2,0,0,1,1,1,0
9829,,,marlee_gordon,2,1,3,2,1,3,0.5,0.013374,0,0,0,0
9830,,,1203_mel,0,1,1,0,1,1,0,0,1,1,1,0
9831,,,xianIedianxia,2,1,3,2,1,3,0.5,0.013374,0,0,0,0
9832,,,njervis65,0,1,1,0,1,1,0,0,1,1,1,0
9833,,,sunflower_hawks,0,4,4,0,6,6,0,0,2,0.833333,0.9,0
9834,,,shnghoo,1,1,2,1,1,2,0,0.006687,0,0,0,0
9835,,,chaoticmanek,3,1,4,3,1,4,0.333333,0.020061,0,0,0,0
9836,,,saul_simcha,0,1,1,0,1,1,0,0,1,1,1,0
9837,,,tsukasemu,0,1,1,0,1,1,0,0,1,1,1,0
9838,,,BrentNYT,6,1,7,6,1,7,0.166667,0.040123,0,0,0,0
9839,,,wasabistrippp,0,1,1,0,1,1,0,0,1,1,1,0
9840,,,chanyeoluxury,0,2,2,0,2,2,0,0,2,0.75,0.833333,0
9841,,,ILYOONGI1993,0,1,1,0,1,1,0,0,1,1,1,0
9842,,,hellavenvall,0,1,1,0,1,1,0,0,1,1,1,0
9843,,,greenbullsports,1,1,2,1,1,2,0,0.006687,0,0,0,0
9844,,,wtfmarcusha,7,1,8,8,1,9,0.142857,0.074883,0,0,0,0
9845,,,ambrosiapjm,0,1,1,0,1,1,0,0,1,1,1,0
9846,,,BOOPALETTE,0,1,1,0,1,1,0,0,1,1,1,0
9847,,,merten6565,0,1,1,0,1,1,0,0,1,1,1,0
9848,,,SushiandS,0,1,1,0,1,1,0,0,1,1,1,0
9849,,,HaiqalHimbo,0,4,4,0,5,5,0,0,1,1,1,0
9850,,,guywwallace,0,1,1,0,1,1,0,0,1,1,1,0
9851,,,zeze__y,0,1,1,0,1,1,0,0,1,1,1,0
9852,,,Juanoscar38Juan,0,1,1,0,1,1,0,0,1,1,1,0
9853,,,JeanPodrasky,1,1,2,1,1,2,0,0.006687,0,0,0,0
9854,,,romydigregory,4,1,5,4,1,5,0.25,0.026749,0,0,0,0
9855,,,kimixkimi,0,1,1,0,1,1,0,0,1,1,1,0
9856,,,Tirtha01Tirtha,0,1,1,0,1,1,0,0,1,1,1,0
9857,,,livissauro,0,1,1,0,1,1,0,0,1,1,1,0
9858,,,vyn_bel0ved,9,1,10,9,1,10,0.111111,0.060184,0,0,0,0
9859,,,gaspyeth,0,3,3,0,3,3,0,0,1,1,1,0
9860,,,booplesnoot95,0,1,1,0,1,1,0,0,1,1,1,0
9861,,,taehyungxjisoo,0,1,1,0,1,1,0,0,1,1,1,0
9862,,,nanloser,0,1,1,0,1,1,0,0,1,1,1,0
9863,,,kazuh4love,0,2,2,0,2,2,0,0,1,1,1,0
9864,,,basilbeeboy,0,1,1,0,1,1,0,0,1,1,1,0
9865,,,angelina,2,1,3,2,1,3,0.5,0.013374,0,0,0,0
9866,,,7_lokiworl7,0,1,1,0,1,1,0,0,1,1,1,0
9867,,,yajasunim,5,1,6,5,1,6,0.2,0.055935,0,0,0,0
9868,,,zospace_,0,1,1,0,1,1,0,0,1,1,1,0
9869,,,miranda_eliza28,0,3,3,0,3,3,0,0,1,1,1,0
9870,,,Patriziahorses,0,1,1,0,1,1,0,0,1,1,1,0
9871,,,buhler118,6,2,8,6,2,8,0.142857,0.045577,1,1,1,7
9872,,,bit_fairytale,1,1,2,1,1,2,0,0.006687,0,0,0,0
9873,,,maymeit76,0,1,1,0,1,1,0,0,2,0.666667,0.75,0
9874,,,ert02794711,0,1,1,0,1,1,0,0,2,0.666667,0.75,0
9875,,,hanpenpiglet,0,1,1,0,1,1,0,0,2,0.666667,0.75,0
9876,,,ludosopinions,0,1,1,0,1,1,0,0,2,0.666667,0.75,0
9877,,,jiminiievel,0,1,1,0,1,1,0,0,2,0.666667,0.75,0
9878,,,PenguinSquad51,4,2,6,4,2,6,0.25,0.026749,1,1,1,2
9879,,,blamethegeese,0,1,1,0,1,1,0,0,2,0.666667,0.75,0
9880,,,yoongicela,0,1,1,0,1,1,0,0,1,1,1,0
9881,,,iris_mutiu,0,1,1,0,1,1,0,0,1,1,1,0
9882,,,newranter,0,1,1,0,1,1,0,0,1,1,1,0
9883,,,d4da_,0,1,1,0,1,1,0,0,1,1,1,0
9884,,,FaeryQuene,6,11,17,6,11,17,0.0625,0.040123,1,1,1,50
9885,,,hbecerraLATimes,4,1,5,4,1,5,0.25,0.026749,0,0,0,0
9886,,,hhannahroseee,0,1,1,0,1,1,0,0,1,1,1,0
9887,,,TJShopeforAZ,0,1,1,0,1,1,0,0,1,1,1,0
9888,,,Solandus,0,1,1,0,1,1,0,0,1,1,1,0
9889,,,contrary1un,10,1,11,10,1,11,0.1,0.066871,0,0,0,0
9890,,,lomlrenjunn,0,1,1,0,1,1,0,0,1,1,1,0
9891,,,kageurazoe,0,1,1,0,1,1,0,0,1,1,1,0
9892,,,RamblinFan,0,1,1,0,1,1,0,0,1,1,1,0
9893,,,yingw9598,0,1,1,0,1,1,0,0,1,1,1,0
9894,,,kazudiamond_,0,1,1,0,1,1,0,0,1,1,1,0
9895,,,Graffiti_SF,0,2,2,0,2,2,0,0,2,0.75,0.833333,0
9896,,,helloddeulgii,0,1,1,0,1,1,0,0,1,1,1,0
9897,,,cloudberryfox,0,1,1,0,1,1,0,0,1,1,1,0
9898,,,AmbiiMoore,0,1,1,0,1,1,0,0,2,0.666667,0.75,0
9899,,,notthegodofwar,0,1,1,0,1,1,0,0,2,0.666667,0.75,0
9900,,,Para_Doc,0,1,1,0,1,1,0,0,1,1,1,0
9901,,,FanSided,6,1,7,6,1,7,0.166667,0.040123,0,0,0,0
9902,,,historyKehoe,0,1,1,0,1,1,0,0,1,1,1,0
9903,,,dari_seo_a,0,1,1,0,1,1,0,0,1,1,1,0
9904,,,jaxgarry,0,1,1,0,1,1,0,0,1,1,1,0
9905,,,723_1276,0,1,1,0,1,1,0,0,1,1,1,0
9906,,,guardianspir1ts,0,1,1,0,1,1,0,0,1,1,1,0
9907,,,annetheman,3,1,4,3,1,4,0.333333,0.020061,0,0,0,0
9908,,,DianeAlt1,0,1,1,0,1,1,0,0,1,1,1,0
9909,,,LorriethThier,0,1,1,0,1,1,0,0,1,1,1,0
9910,,,grant11955,10,1,11,10,1,11,0.1,0.070366,0,0,0,0
9911,,,fylovescy,0,1,1,0,1,1,0,0,1,1,1,0
9912,,,blanxxking,0,1,1,0,1,1,0,0,1,1,1,0
9913,,,yulhanisoo2,0,1,1,0,1,1,0,0,1,1,1,0
9914,,,DuffertTim,0,1,1,0,1,1,0,0,1,1,1,0
9915,,,vantaeartist,0,1,1,0,1,1,0,0,1,1,1,0
9916,,,bakugorobloxero,3,1,4,3,1,4,0.333333,0.020061,0,0,0,0
9917,,,bellebratzilla,0,1,1,0,1,1,0,0,1,1,1,0
9918,,,usghxxx,0,1,1,0,1,1,0,0,1,1,1,0
9919,,,katsully90,1,1,2,1,1,2,0,0.006687,0,0,0,0
9920,,,dhivilmancryby,1,2,3,1,2,3,0.5,0.006687,1,1,1,0
9921,,,LATAAPICaucus,5,1,6,5,1,6,0.2,0.033436,0,0,0,0
9922,,,yugaqi,0,4,4,0,4,4,0,0,3,0.666667,0.805556,0
9923,,,_Jakashi,0,1,1,0,1,1,0,0,1,1,1,0
9924,,,IceColdKilla9,0,1,1,0,1,1,0,0,1,1,1,0
9925,,,05adamlover0129,0,1,1,0,1,1,0,0,1,1,1,0
9926,,,smoskow498,0,1,1,0,1,1,0,0,1,1,1,0
9927,,,a_ha256,0,2,2,0,2,2,0,0,1,1,1,0
9928,,,aImighty_key,1,1,2,1,1,2,0,0.006687,0,0,0,0
9929,,,norby_joni,0,1,1,0,1,1,0,0,1,1,1,0
9930,,,R3lGEN,0,1,1,0,1,1,0,0,1,1,1,0
9931,,,squishy_soo,0,1,1,0,1,1,0,0,1,1,1,0
9932,,,Alinadronen1105,0,1,1,0,1,1,0,0,1,1,1,0
9933,,,Caddyweese,1,1,2,1,1,2,0,0.006687,0,0,0,0
9934,,,keelyybrown,0,1,1,0,1,1,0,0,2,0.666667,0.75,0
9935,,,tisthedamnFra,0,1,1,0,1,1,0,0,2,0.666667,0.75,0
9936,,,Tatiana_Torre15,0,1,1,0,1,1,0,0,2,0.666667,0.75,0
9937,,,GaryDow23369438,0,1,1,0,1,1,0,0,2,0.666667,0.75,0
9938,,,tetcherie,2,2,4,2,2,4,0,0.00792,2,0.6,0.666667,12
9939,,,MaybellRomero,3,1,4,3,1,4,0.333333,0.020061,0,0,0,0
9940,,,HyejiPark5,0,1,1,0,1,1,0,0,1,1,1,0
9941,,,tarakon_1712,0,1,1,0,1,1,0,0,1,1,1,0
9942,,,TorreyJaeckle,2,1,3,2,1,3,0.5,0.013374,0,0,0,0
9943,,,stanJungs,0,1,1,0,1,1,0,0,1,1,1,0
9944,,,HardFactorWill,5,1,6,5,1,6,0.2,0.033436,0,0,0,0
9945,,,guisodeporotos,0,1,1,0,1,1,0,0,1,1,1,0
9946,,,milagroszeva7,0,1,1,0,1,1,0,0,1,1,1,0
9947,,,mingisthottie,0,1,1,0,1,1,0,0,1,1,1,0
9948,,,_oronine,0,1,1,0,1,1,0,0,1,1,1,0
9949,,,prvwitt,0,1,1,0,1,1,0,0,1,1,1,0
9950,,,ssamplern,0,1,1,0,1,1,0,0,1,1,1,0
9951,,,The_VillageMom,0,1,1,0,1,1,0,0,1,1,1,0
9952,,,woolllimz,0,1,1,0,1,1,0,0,1,1,1,0
9953,,,triviawake_,0,1,1,0,1,1,0,0,1,1,1,0
9954,,,S0ULMI,0,1,1,0,1,1,0,0,1,1,1,0
9955,,,DavidMcGraw60,0,1,1,0,1,1,0,0,1,1,1,0
9956,,,natsuzo,0,1,1,0,1,1,0,0,1,1,1,0
9957,,,njakraja,0,1,1,0,1,1,0,0,1,1,1,0
9958,,,unbonvinblanc,0,2,2,0,2,2,0,0,1,1,1,0
9959,,,kendalllllbaaby,0,1,1,0,1,1,0,0,1,1,1,0
9960,,,AnalyticsCapper,3,1,4,3,1,4,0.333333,0.020061,0,0,0,0
9961,,,micheleweldon,0,1,1,0,1,1,0,0,1,1,1,0
9962,,,anothdayn,0,1,1,0,1,1,0,0,1,1,1,0
9963,,,Edson52368657,1,1,2,1,1,2,0,0.006687,0,0,0,0
9964,,,AlisaQ,12,1,13,12,1,13,0.083333,0.080246,0,0,0,0
9965,,,AllenHopson2,0,1,1,0,1,1,0,0,1,1,1,0
9966,,,jayann_leyson,0,1,1,0,1,1,0,0,1,1,1,0
9967,,,riu_white,0,1,1,0,1,1,0,0,1,1,1,0
9968,,,DopamineWriter,0,1,1,0,1,1,0,0,1,1,1,0
9969,,,YRGHFan,0,1,1,0,1,1,0,0,1,1,1,0
9970,,,Deadspin,0,1,1,0,1,1,0,0,1,1,1,0
9971,,,kingtrbl_,0,1,1,0,1,1,0,0,1,1,1,0
9972,,,RandomAnaSun,0,1,1,0,1,1,0,0,1,1,1,0
9973,,,MariBXBKgirl,0,1,1,0,1,1,0,0,1,1,1,0
9974,,,DE3x2ydy_dx,4,1,5,4,1,5,0.25,0.026749,0,0,0,0
9975,,,rujwhy,0,1,1,0,1,1,0,0,1,1,1,0
9976,,,abu701,0,1,1,0,1,1,0,0,1,1,1,0
9977,,,chillinginmela1,0,1,1,0,1,1,0,0,1,1,1,0
9978,,,tounginuh,4,2,6,4,2,6,0.2,0.026749,1,1,1,3
9979,,,SylviaB96106855,0,1,1,0,1,1,0,0,2,0.666667,0.75,0
9980,,,puuchiiuu,1,1,2,1,1,2,0,0.006687,0,0,0,0
9981,,,soobreadi,5,1,6,5,1,6,0.2,0.058442,0,0,0,0
9982,,,CMcStacey,0,1,1,0,1,1,0,0,1,1,1,0
9983,,,yerimaltese,0,1,1,0,1,1,0,0,1,1,1,0
9984,,,FAlRYOFSOOBlN,0,1,1,0,1,1,0,0,1,1,1,0
9985,,,MJSEyesOpened,0,1,1,0,1,1,0,0,1,1,1,0
9986,,,MarkSteagall1,0,1,1,0,1,1,0,0,1,1,1,0
9987,,,4nn11n4,0,1,1,0,1,1,0,0,1,1,1,0
9988,,,emc_mcdonald,0,2,2,0,2,2,0,0,1,1,1,0
9989,,,sltribsports,10,1,11,10,1,11,0.1,0.070366,0,0,0,0
9990,,,Ten272Lee,0,2,2,0,2,2,0,0,1,1,1,0
9991,,,hwabean0416,0,1,1,0,1,1,0,0,1,1,1,0
9992,,,Steph_BloomingT,0,1,1,0,1,1,0,0,1,1,1,0
9993,,,MattieTimmer,0,1,1,0,1,1,0,0,1,1,1,0
9994,,,bunny_x_bangtan,0,1,1,0,1,1,0,0,1,1,1,0
9995,,,rrhaley59,0,1,1,0,1,1,0,0,1,1,1,0
9996,,,q_stuy,0,1,1,0,1,1,0,0,1,1,1,0
9997,,,maniccarpincho,4,1,5,4,1,5,0.25,0.026749,0,0,0,0
9998,,,imchiw,0,1,1,0,1,1,0,0,1,1,1,0
9999,,,proputzr715,0,1,1,0,1,1,0,0,1,1,1,0
10000,,,GpaHess,0,1,1,0,1,1,0,0,1,1,1,0
10001,,,Nicolehoe4jihyo,0,1,1,0,1,1,0,0,1,1,1,0
10002,,,tatianatheninja,1,1,2,1,1,2,0,0.006687,0,0,0,0
10003,,,WTHRcom,3,1,4,3,1,4,0.333333,0.020061,0,0,0,0
10004,,,CarolAn36681966,0,1,1,0,1,1,0,0,1,1,1,0
10005,,,starryame,0,1,1,0,1,1,0,0,2,0.666667,0.75,0
10006,,,aashushaahee,0,1,1,0,1,1,0,0,2,0.666667,0.75,0
10007,,,plutoyunho,1,1,2,1,1,2,0,0.006687,0,0,0,0
10008,,,mbokopunishment,0,1,1,0,1,1,0,0,1,1,1,0
10009,,,tomayakis,0,1,1,0,1,1,0,0,1,1,1,0
10010,,,brianpoliakoff,0,1,1,0,1,1,0,0,1,1,1,0
10011,,,FLATASH3LL,0,1,1,0,1,1,0,0,1,1,1,0
10012,,,Michael94514323,5,1,6,5,1,6,0.2,0.033436,0,0,0,0
10013,,,sergcg,0,1,1,0,1,1,0,0,1,1,1,0
10014,,,ChuQiao18,0,1,1,0,1,1,0,0,1,1,1,0
10015,,,_plain_white_t,0,1,1,0,1,1,0,0,1,1,1,0
10016,,,pvaati1,0,1,1,0,1,1,0,0,1,1,1,0
10017,,,milkndroses,3,1,4,3,1,4,0.333333,0.020061,0,0,0,0
10018,,,JOHNDOL73741017,0,1,1,0,1,1,0,0,1,1,1,0
10019,,,LaLaLArtsyy,0,1,1,0,1,1,0,0,1,1,1,0
10020,,,A1Policy,4,1,5,4,1,5,0.25,0.026749,0,0,0,0
10021,,,stlplace,0,1,1,0,1,1,0,0,1,1,1,0
10022,,,cmcnguyen,2,1,3,2,1,3,0.5,0.013374,0,0,0,0
10023,,,choeyun81355452,0,2,2,0,2,2,0,0,1,1,1,0
10024,,,1004risu,1,1,2,1,1,2,0,0.006687,0,0,0,0
10025,,,gloompolaris,0,1,1,0,1,1,0,0,1,1,1,0
10026,,,NikkiCr08379221,0,1,1,0,1,1,0,0,1,1,1,0
10027,,,LaMonicaBuzz,0,1,1,0,1,1,0,0,1,1,1,0
10028,,,ultravoxing,0,1,1,0,1,1,0,0,1,1,1,0
10029,,,musiclover1909,0,2,2,0,2,2,0,0,1,1,1,0
10030,,,CoyWire,4,2,6,4,2,6,0.2,0.026749,1,1,1,3
10031,,,Profilo3Marco,0,2,2,0,2,2,0,0,1,1,1,0
10032,,,gmamarosa,0,1,1,0,1,1,0,0,1,1,1,0
10033,,,bmangh,0,1,1,0,1,1,0,0,1,1,1,0
10034,,,AnaGomestouch,0,2,2,0,2,2,0,0,2,0.75,0.833333,0
10035,,,jenchentran,0,1,1,0,1,1,0,0,2,0.666667,0.75,0
10036,,,buIIetproofskz,19,1,20,19,1,20,0.052632,0.134044,0,0,0,0
10037,,,delphiwoman,0,1,1,0,1,1,0,0,1,1,1,0
10038,,,shaereo123,0,1,1,0,1,1,0,0,1,1,1,0
10039,,,DuranSports,0,1,1,0,1,1,0,0,1,1,1,0
10040,,,_Daedaehyunnn,0,1,1,0,1,1,0,0,1,1,1,0
10041,,,Yarravilleemma,0,1,1,0,1,1,0,0,1,1,1,0
10042,,,slowcoldrain,0,1,1,0,1,1,0,0,1,1,1,0
10043,,,19augg,0,1,1,0,1,1,0,0,1,1,1,0
10044,,,tetetails,0,1,1,0,1,1,0,0,1,1,1,0
10045,,,taetae_loml,0,1,1,0,1,1,0,0,1,1,1,0
10046,,,axocya,0,1,1,0,1,1,0,0,1,1,1,0
10047,,,mrstsitsipas,0,1,1,0,1,1,0,0,1,1,1,0
10048,,,54poste55,0,1,1,0,1,1,0,0,1,1,1,0
10049,,,Maren31_Uhl,0,1,1,0,1,1,0,0,1,1,1,0
10050,,,scene_enuff,0,1,1,0,1,1,0,0,1,1,1,0
10051,,,agoldrand,0,1,1,0,1,1,0,0,1,1,1,0
10052,,,OliveLogos,24,1,25,24,1,25,0.041667,0.160491,0,0,0,0
10053,,,BonB1971,0,1,1,0,1,1,0,0,1,1,1,0
10054,,,diabloroh,0,1,1,0,1,1,0,0,1,1,1,0
10055,,,marywaters61,0,1,1,0,1,1,0,0,1,1,1,0
10056,,,Dave_Pitinga,0,1,1,0,1,1,0,0,1,1,1,0
10057,,,DrMac85,0,1,1,0,1,1,0,0,1,1,1,0
10058,,,annachristian_,0,1,1,0,1,1,0,0,1,1,1,0
10059,,,rhiles2760,0,2,2,0,2,2,0,0,2,0.75,0.833333,0
10060,,,willthewordguy,0,1,1,0,1,1,0,0,1,1,1,0
10061,,,sumirei0430,0,1,1,0,1,1,0,0,1,1,1,0
10062,,,haebalagi_nana,0,1,1,0,1,1,0,0,1,1,1,0
10063,,,Reshaud,0,1,1,0,1,1,0,0,1,1,1,0
10064,,,maviedemia,0,1,1,0,1,1,0,0,1,1,1,0
10065,,,Spookeynotion,0,2,2,0,2,2,0,0,1,1,1,0
10066,,,Sch531,0,1,1,0,1,1,0,0,1,1,1,0
10067,,,DarkLudvik,0,1,1,0,1,1,0,0,1,1,1,0
10068,,,AyanAyan21,0,2,2,0,2,2,0,0,1,1,1,0
10069,,,wants_cheese,3,1,4,3,1,4,0.333333,0.020061,0,0,0,0
10070,,,_crashl3y,0,1,1,0,1,1,0,0,1,1,1,0
10071,,,davidfolkenflik,0,1,1,0,1,1,0,0,1,1,1,0
10072,,,jyostna59883008,4,1,5,5,2,7,0.25,0.026749,0,0,0,0
10073,,,n_yang,1,1,2,1,1,2,0,0.006687,0,0,0,0
10074,,,boyswerelectric,0,1,1,0,1,1,0,0,1,1,1,0
10075,,,ZSinein,0,1,1,0,1,1,0,0,1,1,1,0
10076,,,PULSOFORMULA,0,1,1,0,1,1,0,0,1,1,1,0
10077,,,thatasianannie,0,1,1,0,1,1,0,0,1,1,1,0
10078,,,kookooprecia,0,1,1,0,1,1,0,0,1,1,1,0
10079,,,sarangajaa,0,1,1,0,1,1,0,0,1,1,1,0
10080,,,SteveWang251,0,1,1,0,1,1,0,0,1,1,1,0
10081,,,shoma_harinezum,0,1,1,0,1,1,0,0,1,1,1,0
10082,,,naomisbar,0,1,1,0,1,1,0,0,1,1,1,0
10083,,,MichaelSocolow,1,1,2,1,1,2,0,0.006687,0,0,0,0
10084,,,jenniwulu,0,1,1,0,1,1,0,0,1,1,1,0
10085,,,Josayhey,0,1,1,0,1,1,0,0,1,1,1,0
10086,,,johnnyixing,0,1,1,0,1,1,0,0,2,0.666667,0.75,0
10087,,,axsfgaRROJAwe8c,1,1,2,1,1,2,0,0.006687,0,0,0,0
10088,,,MkaayxJimin,0,1,1,0,1,1,0,0,1,1,1,0
10089,,,planetluciaa,0,1,1,0,1,1,0,0,1,1,1,0
10090,,,SENSIMILLIEA,0,1,1,0,1,1,0,0,1,1,1,0
10091,,,sringvenkq,3,2,5,3,2,5,0.25,0.020061,1,1,1,2
10092,,,MMCandyCheng,0,1,1,0,1,1,0,0,2,0.666667,0.75,0
10093,,,_i02jake,0,1,1,0,1,1,0,0,2,0.666667,0.75,0
10094,,,TheCabriolady,3,1,4,3,1,4,0.333333,0.020061,0,0,0,0
10095,,,pcykml,0,2,2,0,2,2,0,0,1,1,1,0
10096,,,anikashukla_,12,1,13,13,1,14,0.083333,0.080246,0,0,0,0
10097,,,leader_ashore,0,1,1,0,1,1,0,0,1,1,1,0
10098,,,Wonderful_Bae,0,1,1,0,1,1,0,0,1,1,1,0
10099,,,30ACTruth,0,1,1,0,1,1,0,0,1,1,1,0
10100,,,jminne23,0,2,2,0,2,2,0,0,1,1,1,0
10101,,,freespeak3,0,1,1,0,1,1,0,0,1,1,1,0
10102,,,m_j_Cruise,0,1,1,0,1,1,0,0,1,1,1,0
10103,,,wolf_in_fog,0,1,1,0,1,1,0,0,1,1,1,0
10104,,,BakedSpoonie,0,1,1,0,1,1,0,0,1,1,1,0
10105,,,Regista08313102,5,1,6,5,1,6,0.2,0.033436,0,0,0,0
10106,,,OshaberiMarion,0,1,1,0,1,1,0,0,1,1,1,0
10107,,,mycatsmom99,0,1,1,0,1,1,0,0,1,1,1,0
10108,,,wellitwt,0,1,1,0,1,1,0,0,1,1,1,0
10109,,,jkrenn11,0,1,1,0,1,1,0,0,1,1,1,0
10110,,,cake____1214,0,3,3,0,3,3,0,0,1,1,1,0
10111,,,DianaLucivero,0,1,1,0,1,1,0,0,1,1,1,0
10112,,,Mr_Ancientt,0,1,1,0,1,1,0,0,1,1,1,0
10113,,,Make_US_Equal,0,1,1,0,1,1,0,0,1,1,1,0
10114,,,jiejisungie,0,1,1,0,1,1,0,0,2,0.666667,0.75,0
10115,,,JennyPowell859,0,1,1,0,1,1,0,0,2,0.666667,0.75,0
10116,,,_MariaPetrova,0,1,1,0,1,1,0,0,2,0.666667,0.75,0
10117,,,BanquoDyar,0,1,1,0,1,1,0,0,2,0.666667,0.75,0
10118,,,amandabw425,1,1,2,1,1,2,0,0.006687,0,0,0,0
10119,,,ShyfishShy,0,1,1,0,1,1,0,0,1,1,1,0
10120,,,guytaur,0,1,1,0,1,1,0,0,1,1,1,0
10121,,,HumbertoZamoraR,0,1,1,0,1,1,0,0,1,1,1,0
10122,,,fromthestars__,10,1,11,10,1,11,0.1,0.077354,0,0,0,0
10123,,,jemnotgem_22,0,1,1,0,1,1,0,0,1,1,1,0
10124,,,minmik_a,0,1,1,0,1,1,0,0,1,1,1,0
10125,,,falconhamada_90,0,1,1,0,1,1,0,0,1,1,1,0
10126,,,funkeymonkey83,0,1,1,0,1,1,0,0,1,1,1,0
10127,,,pikuhannies,1,1,2,1,1,2,0,0.006687,0,0,0,0
10128,,,avoylefroy,13,1,14,13,1,14,0.076923,0.086933,0,0,0,0
10129,,,CuevasJailene,0,1,1,0,1,1,0,0,1,1,1,0
10130,,,kozhki,0,1,1,0,1,1,0,0,1,1,1,0
10131,,,Asante35250673,0,2,2,0,2,2,0,0,1,1,1,0
10132,,,beautifuIstorms,0,1,1,0,1,1,0,0,1,1,1,0
10133,,,MC13331,0,3,3,0,3,3,0,0,3,0.5,0.558824,0
10134,,,xxale26,0,1,1,0,1,1,0,0,1,1,1,0
10135,,,bleacherteens,1,1,2,1,1,2,0,0.006687,0,0,0,0
10136,,,kimtfiu,3,1,4,3,1,4,0.333333,0.020061,0,0,0,0
10137,,,JerryPo75030038,0,1,1,0,1,1,0,0,1,1,1,0
10138,,,littlekevinnn,0,1,1,0,1,1,0,0,1,1,1,0
10139,,,humankind,1,1,2,1,1,2,0,0.006687,0,0,0,0
10140,,,13434__,9,1,10,9,1,10,0.111111,0.068366,0,0,0,0
10141,,,DaniKlaus1206,0,1,1,0,1,1,0,0,1,1,1,0
10142,,,quadlutzed,3,2,5,3,2,5,0,0.01188,1,1,1,6
10143,,,garfield628,0,1,1,0,1,1,0,0,1,1,1,0
10144,,,kitwindigo,0,1,1,0,1,1,0,0,1,1,1,0
10145,,,reaial_,0,1,1,0,1,1,0,0,1,1,1,0
10146,,,special_em0308,0,3,3,0,3,3,0,0,1,1,1,0
10147,,,latebloomer4140,0,1,1,0,1,1,0,0,1,1,1,0
10148,,,ej_sea,6,1,7,6,1,7,0.166667,0.040123,0,0,0,0
10149,,,erinvalynn,0,1,1,0,1,1,0,0,1,1,1,0
10150,,,mariennneee,0,1,1,0,1,1,0,0,1,1,1,0
10151,,,puppyuyuyoo,0,1,1,0,1,1,0,0,1,1,1,0
10152,,,mnewla,3,1,4,3,1,4,0.333333,0.020061,0,0,0,0
10153,,,vibranium_ss,0,1,1,0,1,1,0,0,1,1,1,0
10154,,,real__cry,0,1,1,0,1,1,0,0,1,1,1,0
10155,,,MichaelEhrlich,5,1,6,5,1,6,0.2,0.033436,0,0,0,0
10156,,,madeusk2409,0,1,1,0,1,1,0,0,1,1,1,0
10157,,,_fallenstarborn,0,1,1,0,1,1,0,0,1,1,1,0
10158,,,manulem,0,1,1,0,1,1,0,0,1,1,1,0
10159,,,mushfiq_econ,1,1,2,1,1,2,0,0.006687,0,0,0,0
10160,,,AAPILegCaucus,7,1,8,7,1,8,0.142857,0.04681,0,0,0,0
10161,,,BDBgoldens3,0,1,1,0,1,1,0,0,1,1,1,0
10162,,,niko_komi,0,1,1,0,1,1,0,0,1,1,1,0
10163,,,shoubaksu,0,1,1,0,1,1,0,0,1,1,1,0
10164,,,weieieieiei,0,1,1,0,1,1,0,0,1,1,1,0
10165,,,mestuffs,0,1,1,0,1,1,0,0,1,1,1,0
10166,,,DebbieZackBaue2,0,1,1,0,1,1,0,0,1,1,1,0
10167,,,dariusbgibbs,18,1,19,19,1,20,0.055556,0.145375,0,0,0,0
10168,,,meganadb,0,1,1,0,1,1,0,0,1,1,1,0
10169,,,FlowerF71920491,0,1,1,0,1,1,0,0,1,1,1,0
10170,,,arenaroja,0,1,1,0,1,1,0,0,1,1,1,0
10171,,,barryzito2002,0,1,1,0,1,1,0,0,1,1,1,0
10172,,,straitpqd_,0,1,1,0,1,1,0,0,1,1,1,0
10173,,,bamietaem,0,3,3,0,3,3,0,0,1,1,1,0
10174,,,JusticeFenteng,0,1,1,0,2,2,0,0,1,1,1,0
10175,,,4_yo__,0,1,1,0,1,1,0,0,1,1,1,0
10176,,,Thungchan2,0,1,1,0,1,1,0,0,1,1,1,0
10177,,,MShimm3,0,1,1,0,1,1,0,0,1,1,1,0
10178,,,kw2134,0,1,1,0,1,1,0,0,1,1,1,0
10179,,,trash4venti,0,1,1,0,1,1,0,0,1,1,1,0
10180,,,bigsdrip,0,1,1,0,1,1,0,0,1,1,1,0
10181,,,tea_bloom,4,1,5,4,1,5,0.25,0.026749,0,0,0,0
10182,,,sunnyyunho,0,1,1,0,1,1,0,0,1,1,1,0
10183,,,ZJIE_Y,0,1,1,0,1,1,0,0,1,1,1,0
10184,,,tiasnart,0,1,1,0,1,1,0,0,1,1,1,0
10185,,,Woh32531274,0,1,1,0,1,1,0,0,1,1,1,0
10186,,,alehand72876631,7,1,8,7,1,8,0.142857,0.04681,0,0,0,0
10187,,,GaterMit,0,1,1,0,1,1,0,0,1,1,1,0
10188,,,AnnSchurman,0,1,1,0,1,1,0,0,1,1,1,0
10189,,,darkandsoft,0,1,1,0,1,1,0,0,1,1,1,0
10190,,,aaiyu,0,1,1,0,1,1,0,0,1,1,1,0
10191,,,Electric_AI,3,1,4,3,1,4,0.333333,0.020061,0,0,0,0
10192,,,AceAlyss,0,1,1,0,1,1,0,0,1,1,1,0
10193,,,XX0326XXMM,0,1,1,0,1,1,0,0,1,1,1,0
10194,,,fluffysamatoki,5,1,6,5,1,6,0.2,0.033436,0,0,0,0
10195,,,tinaryuryu,0,1,1,0,1,1,0,0,1,1,1,0
10196,,,taegoonew,0,1,1,0,1,1,0,0,1,1,1,0
10197,,,LetiAmb,0,1,1,0,1,1,0,0,1,1,1,0
10198,,,skysighed,0,1,1,0,1,1,0,0,1,1,1,0
10199,,,ritabee8,6,1,7,6,1,7,0.166667,0.040123,0,0,0,0
10200,,,spnwon,0,1,1,0,1,1,0,0,1,1,1,0
10201,,,uzuithot,0,1,1,0,1,1,0,0,1,1,1,0
10202,,,AmaryllisX,0,1,1,0,1,1,0,0,1,1,1,0
10203,,,jinkisbae,0,1,1,0,1,1,0,0,1,1,1,0
10204,,,i_roosma99,0,1,1,0,1,1,0,0,1,1,1,0
10205,,,LouzitaMF,4,1,5,4,1,5,0.25,0.026749,0,0,0,0
10206,,,EliHinze,0,1,1,0,1,1,0,0,1,1,1,0
10207,,,shotaroswhore,0,2,2,0,2,2,0,0,1,1,1,0
10208,,,TNbuttman,0,1,1,0,1,1,0,0,1,1,1,0
10209,,,Foodybob,2,1,3,2,1,3,0.5,0.013374,0,0,0,0
10210,,,inuft,0,1,1,0,1,1,0,0,1,1,1,0
10211,,,_secretarmy,3,1,4,3,1,4,0.333333,0.020061,0,0,0,0
10212,,,czenchn,0,1,1,0,1,1,0,0,1,1,1,0
10213,,,alphacuiter,0,2,2,0,2,2,0,0,1,1,1,0
10214,,,BBKyooooooooong,2,1,3,3,2,5,0.5,0.013374,0,0,0,0
10215,,,aki109691,0,2,2,0,2,2,0,0,1,1,1,0
10216,,,alansmurray,6,1,7,6,1,7,0.166667,0.040123,0,0,0,0
10217,,,satochi88,0,1,1,0,1,1,0,0,1,1,1,0
10218,,,ihwangrrl,0,1,1,0,1,1,0,0,1,1,1,0
10219,,,sandchair,0,1,1,0,1,1,0,0,1,1,1,0
10220,,,SunyaEts,0,1,1,0,1,1,0,0,1,1,1,0
10221,,,revraygreen,0,1,1,0,1,1,0,0,1,1,1,0
10222,,,NahG89,7,1,8,7,1,8,0.142857,0.109706,0,0,0,0
10223,,,FerL67,0,1,1,0,1,1,0,0,1,1,1,0
10224,,,7ichigo12,0,1,1,0,1,1,0,0,1,1,1,0
10225,,,08wgup,0,1,1,0,1,1,0,0,1,1,1,0
10226,,,shxxtiicee,0,1,1,0,1,1,0,0,1,1,1,0
10227,,,LyndaRubin2,1,1,2,1,1,2,0,0.006687,0,0,0,0
10228,,,BrebisLa,0,2,2,0,2,2,0,0,1,1,1,0
10229,,,krnroo,0,1,1,0,1,1,0,0,1,1,1,0
10230,,,beanz_lwjsimps,0,1,1,0,1,1,0,0,1,1,1,0
10231,,,juliehauk13,0,1,1,0,1,1,0,0,1,1,1,0
10232,,,hana_hana_smile,0,1,1,0,1,1,0,0,1,1,1,0
10233,,,EatSleepDiethx,0,1,1,0,1,1,0,0,1,1,1,0
10234,,,BauJosephine,4,2,6,4,2,6,0.2,0.026749,1,1,1,3
10235,,,TwoSpiritMoe,0,1,1,0,1,1,0,0,2,0.666667,0.75,0
10236,,,fushichous,0,1,1,0,1,1,0,0,2,0.666667,0.75,0
10237,,,CameronHillmer,0,1,1,0,1,1,0,0,2,0.666667,0.75,0
10238,,,EmmettEngle,0,1,1,0,1,1,0,0,1,1,1,0
10239,,,rowan_celeste,0,1,1,0,1,1,0,0,1,1,1,0
10240,,,LollyMolly75,0,1,1,0,1,1,0,0,1,1,1,0
10241,,,Huang62406429,12,1,13,12,1,13,0.083333,0.101211,0,0,0,0
10242,,,LavishTantrums,0,1,1,0,1,1,0,0,1,1,1,0
10243,,,KriskaLetuchaya,0,1,1,0,1,1,0,0,1,1,1,0
10244,,,yyangcity,0,1,1,0,1,1,0,0,1,1,1,0
10245,,,liliantioquia,0,1,1,0,1,1,0,0,1,1,1,0
10246,,,omargallardo,0,1,1,0,1,1,0,0,1,1,1,0
10247,,,ixsxnnyy_,0,1,1,0,1,1,0,0,1,1,1,0
10248,,,zetaz,0,1,1,0,1,1,0,0,1,1,1,0
10249,,,ansylcrackers,2,1,3,2,1,3,0.5,0.013374,0,0,0,0
10250,,,douteirashii,0,1,1,0,1,1,0,0,1,1,1,0
10251,,,taylorgrift,2,1,3,2,1,3,0.5,0.013374,0,0,0,0
10252,,,marcbauerCC,0,1,1,0,1,1,0,0,1,1,1,0
10253,,,MEOW_HELL_CAT_,3,1,4,3,1,4,0.333333,0.020061,0,0,0,0
10254,,,Coolkeikojp,0,1,1,0,1,1,0,0,1,1,1,0
10255,,,JAPANYAMANOTERA,2,1,3,2,1,3,0.5,0.013374,0,0,0,0
10256,,,douglasrivlin,0,1,1,0,1,1,0,0,1,1,1,0
10257,,,Yuzu57290309,34,1,35,34,1,35,0.029412,0.227363,0,0,0,0
10258,,,SproutJoon_,0,1,1,0,1,1,0,0,1,1,1,0
10259,,,rosynonie,0,1,1,0,1,1,0,0,1,1,1,0
10260,,,Fcristinzio,0,1,1,0,1,1,0,0,1,1,1,0
10261,,,rurimatsuri2711,0,1,1,0,1,1,0,0,1,1,1,0
10262,,,honeyboyjjay,0,1,1,0,1,1,0,0,1,1,1,0
10263,,,2021_free,0,1,1,0,1,1,0,0,1,1,1,0
10264,,,bostonvancouver,0,1,1,0,1,1,0,0,1,1,1,0
10265,,,Monsuto_Z,0,1,1,0,1,1,0,0,1,1,1,0
10266,,,smyrcella,0,1,1,0,1,1,0,0,1,1,1,0
10267,,,pk_z,0,1,1,0,1,1,0,0,1,1,1,0
10268,,,uQayR3M9tJ5z7eZ,0,1,1,0,1,1,0,0,1,1,1,0
10269,,,nictasha28,0,1,1,0,1,1,0,0,1,1,1,0
10270,,,dans_bananamilk,0,1,1,0,1,1,0,0,1,1,1,0
10271,,,SullivanJPhotog,0,1,1,0,1,1,0,0,1,1,1,0
10272,,,_takabo,0,2,2,0,2,2,0,0,1,1,1,0
10273,,,nymph_pi,0,2,2,0,2,2,0,0,1,1,1,0
10274,,,audseyy,0,1,1,0,1,1,0,0,1,1,1,0
10275,,,dadao_m,3,1,4,3,1,4,0.333333,0.020061,0,0,0,0
10276,,,Peterph1685,0,1,1,0,1,1,0,0,1,1,1,0
10277,,,rainbowhuii,0,1,1,0,1,1,0,0,1,1,1,0
10278,,,Big_McLrgHuge,2,1,3,2,1,3,0.5,0.013374,0,0,0,0
10279,,,whatanangell,0,1,1,0,1,1,0,0,1,1,1,0
10280,,,AbbyHegan,5,1,6,5,1,6,0.2,0.040424,0,0,0,0
10281,,,yukikakgae,2,2,4,2,2,4,0.333333,0.013374,1,1,1,1
10282,,,melissaklennon,0,1,1,0,1,1,0,0,1,1,1,0
10283,,,1601_double,0,1,1,0,1,1,0,0,1,1,1,0
10284,,,NancyClark99,3,1,4,3,1,4,0.333333,0.020061,0,0,0,0
10285,,,black_canary02,0,1,1,0,1,1,0,0,1,1,1,0
10286,,,_27_ninana,0,1,1,0,1,1,0,0,1,1,1,0
10287,,,DeborahARyan2,5,4,9,6,5,11,0.125,0.03889,1,1,1,18
10288,,,anarchie_lib,0,1,1,0,1,1,0,0,2,0.571429,0.625,0
10289,,,diilucssimp,2,1,3,2,1,3,0.5,0.013374,0,0,0,0
10290,,,ayeetshaa,0,1,1,0,1,1,0,0,1,1,1,0
10291,,,ohtaniquadaxel,0,1,1,0,1,1,0,0,1,1,1,0
10292,,,FanaticalFrog,0,1,1,0,1,1,0,0,1,1,1,0
10293,,,Evaporation1914,0,1,1,0,1,1,0,0,1,1,1,0
10294,,,MyBostonNews,0,3,3,0,3,3,0,0,1,1,1,0
10295,,,GREGORYABUTLER,0,1,1,0,1,1,0,0,1,1,1,0
10296,,,molu75,0,1,1,0,1,1,0,0,1,1,1,0
10297,,,Sassy60s1,0,1,1,0,1,1,0,0,1,1,1,0
10298,,,peter1951,0,1,1,0,1,1,0,0,1,1,1,0
10299,,,ArjunPatel20,0,1,1,0,1,1,0,0,1,1,1,0
10300,,,makyumie,0,1,1,0,1,1,0,0,1,1,1,0
10301,,,iItryIok,0,1,1,0,1,1,0,0,1,1,1,0
10302,,,jenryumi,0,1,1,0,1,1,0,0,1,1,1,0
10303,,,AmericasVoice,0,1,1,0,1,1,0,0,1,1,1,0
10304,,,taylorftnina,0,1,1,0,1,1,0,0,1,1,1,0
10305,,,bihahbohri,0,1,1,0,1,1,0,0,1,1,1,0
10306,,,wordsmithlegend,0,1,1,0,1,1,0,0,1,1,1,0
10307,,,Mtdisfan,1,1,2,1,1,2,0,0.006687,0,0,0,0
10308,,,sappysapphic,3,1,4,3,1,4,0.333333,0.020061,0,0,0,0
10309,,,tubintravelman,0,1,1,0,1,1,0,0,1,1,1,0
10310,,,williambakshi14,0,1,1,0,1,1,0,0,1,1,1,0
10311,,,fangquantum,3,1,4,3,1,4,0.333333,0.020061,0,0,0,0
10312,,,Fuyu4379,0,1,1,0,1,1,0,0,1,1,1,0
10313,,,Rosie_Posey108,0,1,1,0,1,1,0,0,1,1,1,0
10314,,,michele5353,3,1,4,3,1,4,0.333333,0.020061,0,0,0,0
10315,,,marcoadrianos,0,1,1,0,1,1,0,0,1,1,1,0
10316,,,thomalovesfei,0,1,1,0,1,1,0,0,2,0.666667,0.75,0
10317,,,tbz_v_,0,2,2,0,2,2,0,0,2,0.75,0.833333,0
10318,,,mit2ukou,0,2,2,0,2,2,0,0,2,0.75,0.833333,0
10319,,,dontbeinsane_,0,1,1,0,1,1,0,0,1,1,1,0
10320,,,knmjnlv,0,1,1,0,1,1,0,0,1,1,1,0
10321,,,susiebright,10,1,11,10,1,11,0.1,0.066871,0,0,0,0
10322,,,LaMiaPrima,0,1,1,0,1,1,0,0,1,1,1,0
10323,,,renesolos,0,1,1,0,1,1,0,0,1,1,1,0
10324,,,LorraineZiff,0,1,1,0,1,1,0,0,1,1,1,0
10325,,,minyxnkx039,0,1,1,0,1,1,0,0,1,1,1,0
10326,,,wabisuketsubaki,0,2,2,0,2,2,0,0,1,1,1,0
10327,,,flamingobabe201,0,1,1,0,1,1,0,0,1,1,1,0
10328,,,Riverstories7,0,1,1,0,1,1,0,0,1,1,1,0
10329,,,nbc6,5,1,6,7,3,10,0.2,0.033436,0,0,0,0
10330,,,shunnamoroll,0,1,1,0,1,1,0,0,1,1,1,0
10331,,,NancyRapoport,11,1,12,11,1,12,0.090909,0.077053,0,0,0,0
10332,,,elainejchen,0,1,1,0,1,1,0,0,1,1,1,0
10333,,,Tarkwamedikal,0,1,1,0,1,1,0,0,1,1,1,0
10334,,,daliexolot9,0,1,1,0,1,1,0,0,1,1,1,0
10335,,,trspjwoo,0,2,2,0,2,2,0,0,2,0.75,0.833333,0
10336,,,MikeReeseM,0,1,1,0,1,1,0,0,1,1,1,0
10337,,,peijie242,0,1,1,0,1,1,0,0,1,1,1,0
10338,,,drmfullsun,0,1,1,0,1,1,0,0,1,1,1,0
10339,,,myouill,10,1,11,11,1,12,0.1,0.087837,0,0,0,0
10340,,,orbltwols,0,1,1,0,1,1,0,0,1,1,1,0
10341,,,femirizos,0,1,1,0,1,1,0,0,1,1,1,0
10342,,,JHJM9495,0,1,1,0,1,1,0,0,1,1,1,0
10343,,,BordersSoccer,0,1,1,0,1,1,0,0,1,1,1,0
10344,,,TheVIPgypsy,0,1,1,0,2,2,0,0,1,1,1,0
10345,,,KKrisPor,0,1,1,0,1,1,0,0,1,1,1,0
10346,,,YonsterACB,0,1,1,0,1,1,0,0,1,1,1,0
10347,,,mariannelfranc2,0,1,1,0,1,1,0,0,1,1,1,0
10348,,,chrislongview,0,2,2,0,2,2,0,0,1,1,1,0
10349,,,Phanumas23,0,1,1,0,1,1,0,0,1,1,1,0
10350,,,Soriano310ms,0,1,1,0,1,1,0,0,1,1,1,0
10351,,,BweBreBee,0,1,1,0,1,1,0,0,1,1,1,0
10352,,,macapasta,6,1,7,6,1,7,0.166667,0.040123,0,0,0,0
10353,,,Acarnis,0,1,1,0,1,1,0,0,1,1,1,0
10354,,,7BNnE7,0,1,1,0,1,1,0,0,1,1,1,0
10355,,,gogiebutter,0,1,1,0,1,1,0,0,1,1,1,0
10356,,,ItsAnnaNegron,0,1,1,0,1,1,0,0,1,1,1,0
10357,,,xBri91x,0,1,1,0,1,1,0,0,1,1,1,0
10358,,,LinaxLight,0,1,1,0,1,1,0,0,1,1,1,0
10359,,,kyanmapi,0,1,1,0,1,1,0,0,1,1,1,0
10360,,,onigirizoe,4,1,5,4,1,5,0.25,0.047714,0,0,0,0
10361,,,palmboicek,0,1,1,0,1,1,0,0,1,1,1,0
10362,,,shemaiahonthebt,3,1,4,4,2,6,0.333333,0.02705,0,0,0,0
10363,,,MoCoRando,0,1,1,0,1,1,0,0,1,1,1,0
10364,,,InterDailyTV,2,1,3,2,1,3,0.5,0.013374,0,0,0,0
10365,,,chalzamora,0,1,1,0,1,1,0,0,1,1,1,0
10366,,,NECN,5,1,6,7,3,10,0.2,0.054401,0,0,0,0
10367,,,NBCConnecticut,6,1,7,8,3,11,0.166667,0.061088,0,0,0,0
10368,,,peacepeace7,0,1,1,0,1,1,0,0,1,1,1,0
10369,,,feng_xin_mq,0,1,1,0,1,1,0,0,1,1,1,0
10370,,,nbcchicago,7,1,8,9,3,12,0.142857,0.04681,0,0,0,0
10371,,,NBC10Boston,9,1,10,11,3,14,0.111111,0.060184,0,0,0,0
10372,,,NBCDFWSports,4,1,5,6,3,9,0.25,0.026749,0,0,0,0
10373,,,yeppeosix,3,1,4,3,1,4,0.333333,0.020061,0,0,0,0
10374,,,Yale_LabMed,5,1,6,5,1,6,0.2,0.033436,0,0,0,0
10375,,,7Lyssx,0,1,1,0,1,1,0,0,1,1,1,0
10376,,,eulasgfs,0,1,1,0,1,1,0,0,1,1,1,0
10377,,,NeuDaey,0,1,1,0,1,1,0,0,1,1,1,0
10378,,,Manboy_99,0,1,1,0,1,1,0,0,1,1,1,0
10379,,,JennieLouLeeder,4,1,5,4,1,5,0.25,0.026749,0,0,0,0
10380,,,velarisben,0,1,1,0,1,1,0,0,1,1,1,0
10381,,,PhatJhedi,0,2,2,0,2,2,0,0,2,0.75,0.833333,0
10382,,,kimberleydaly,1,1,2,1,1,2,0,0.006687,0,0,0,0
10383,,,PegasusDirector,9,1,10,9,1,10,0.111111,0.074161,0,0,0,0
10384,,,laperrademakima,0,2,2,0,2,2,0,0,1,1,1,0
10385,,,hyuazulx,0,1,1,0,1,1,0,0,1,1,1,0
10386,,,PoohPalooza,0,1,1,0,1,1,0,0,1,1,1,0
10387,,,ReneeRose723,0,1,1,0,1,1,0,0,1,1,1,0
10388,,,kurokenistan,0,1,1,0,1,1,0,0,1,1,1,0
10389,,,elm960,0,1,1,0,1,1,0,0,1,1,1,0
10390,,,haileyiceskater,0,1,1,0,1,1,0,0,2,0.666667,0.75,0
10391,,,jolselin,0,1,1,0,1,1,0,0,2,0.666667,0.75,0
10392,,,DeniseParringt4,0,1,1,0,1,1,0,0,2,0.666667,0.75,0
10393,,,mranti,0,1,1,0,1,1,0,0,2,0.666667,0.75,0
10394,,,MilenaZP_,0,1,1,0,1,1,0,0,2,0.666667,0.75,0
10395,,,InvestigatorCps,0,1,1,0,1,1,0,0,2,0.666667,0.75,0
10396,,,arvores_,0,1,1,0,1,1,0,0,2,0.666667,0.75,0
10397,,,Sevin53048220,0,1,1,0,1,1,0,0,2,0.666667,0.75,0
10398,,,wordofthelord_,11,1,12,11,1,12,0.090909,0.158202,0,0,0,0
10399,,,got7_ppjg,0,1,1,0,1,1,0,0,1,1,1,0
10400,,,yasintara,0,1,1,0,1,1,0,0,1,1,1,0
10401,,,PC41563323,0,1,1,0,1,1,0,0,1,1,1,0
10402,,,Debbiejcb51,0,1,1,0,1,1,0,0,1,1,1,0
10403,,,jashia_v_,0,1,1,0,1,1,0,0,1,1,1,0
10404,,,XmanNYC71,0,1,1,0,1,1,0,0,1,1,1,0
10405,,,Gabytagv,0,1,1,0,1,1,0,0,1,1,1,0
10406,,,EJGreene51,5,1,6,5,1,6,0.2,0.033436,0,0,0,0
10407,,,BruteForceSwim,0,1,1,0,1,1,0,0,1,1,1,0
10408,,,QuanYizhenn,0,1,1,0,1,1,0,0,1,1,1,0
10409,,,aporingyo,0,1,1,0,1,1,0,0,1,1,1,0
10410,,,sarahlbee28,1,1,2,1,1,2,0,0.006687,0,0,0,0
10411,,,jyggly,6,1,7,6,1,7,0.166667,0.040123,0,0,0,0
10412,,,kellydonlin,0,1,1,0,1,1,0,0,1,1,1,0
10413,,,mingissuga,0,1,1,0,1,1,0,0,1,1,1,0
10414,,,kiyojro,0,3,3,0,3,3,0,0,1,1,1,0
10415,,,KRDONC13,2,1,3,2,1,3,0.5,0.013374,0,0,0,0
10416,,,gnilwoce,1,1,2,1,1,2,0,0.006687,0,0,0,0
10417,,,Jan54215972,0,1,1,0,1,1,0,0,1,1,1,0
10418,,,DocYvetteHarris,0,1,1,0,1,1,0,0,1,1,1,0
10419,,,HilarieAshton,0,1,1,0,1,1,0,0,1,1,1,0
10420,,,ethanjsacks,0,1,1,0,1,1,0,0,1,1,1,0
10421,,,shirfire218,0,1,1,0,1,1,0,0,1,1,1,0
10422,,,funnybtsties,0,1,1,0,1,1,0,0,1,1,1,0
10423,,,lan_wangjin,0,1,1,0,1,1,0,0,1,1,1,0
10424,,,KonzOtis,0,2,2,0,2,2,0,0,1,1,1,0
10425,,,careelhyn_,0,1,1,0,1,1,0,0,1,1,1,0
10426,,,IceinlineDance,0,1,1,0,1,1,0,0,1,1,1,0
10427,,,otonaIs,0,1,1,0,1,1,0,0,1,1,1,0
10428,,,MarcyShea8,0,1,1,0,1,1,0,0,1,1,1,0
10429,,,chimin27964975,0,1,1,0,1,1,0,0,1,1,1,0
10430,,,keep_strong10,0,1,1,0,1,1,0,0,1,1,1,0
10431,,,lobacuqui,0,1,1,0,1,1,0,0,1,1,1,0
10432,,,nyxaholic,0,1,1,0,1,1,0,0,1,1,1,0
10433,,,googiecutie_,0,1,1,0,1,1,0,0,1,1,1,0
10434,,,ackerwvman,0,2,2,0,2,2,0,0,1,1,1,0
10435,,,FLYINGTOMIN,0,1,1,0,1,1,0,0,1,1,1,0
10436,,,Jooniesweethang,0,1,1,0,1,1,0,0,1,1,1,0
10437,,,galaxycat4011,0,1,1,0,1,1,0,0,1,1,1,0
10438,,,GallarelliLisa,0,1,1,0,1,1,0,0,1,1,1,0
10439,,,JonMcKinney689,0,1,1,0,1,1,0,0,1,1,1,0
10440,,,callajcnah,0,1,1,0,1,1,0,0,1,1,1,0
10441,,,pororocakewoo,0,1,1,0,1,1,0,0,1,1,1,0
10442,,,hyukjagia,0,1,1,0,1,1,0,0,1,1,1,0
10443,,,siriusMOonlte,0,1,1,0,1,1,0,0,1,1,1,0
10444,,,blue5ccc,0,1,1,0,1,1,0,0,1,1,1,0
10445,,,balabonka,0,1,1,0,1,1,0,0,1,1,1,0
10446,,,potatoSoobin,0,1,1,0,1,1,0,0,1,1,1,0
10447,,,PamGrier,0,1,1,0,1,1,0,0,1,1,1,0
10448,,,oycae1999,0,1,1,0,1,1,0,0,1,1,1,0
10449,,,_aellinne_,0,2,2,0,2,2,0,0,1,1,1,0
10450,,,21centurygays,0,2,2,0,2,2,0,0,2,0.75,0.833333,0
10451,,,islandlife2014,0,1,1,0,1,1,0,0,2,0.666667,0.75,0
10452,,,Seulbabbyx,0,1,1,0,1,1,0,0,2,0.666667,0.75,0
10453,,,1doodlelopez,0,1,1,0,1,1,0,0,2,0.666667,0.75,0
10454,,,zakarak88,0,1,1,0,1,1,0,0,2,0.666667,0.75,0
10455,,,majaloca,0,1,1,0,1,1,0,0,2,0.666667,0.75,0
10456,,,th_hun14,0,1,1,0,1,1,0,0,2,0.666667,0.75,0
10457,,,tofufever,0,1,1,0,1,1,0,0,2,0.666667,0.75,0
10458,,,will_yale,2,1,3,2,1,3,0.5,0.013374,0,0,0,0
10459,,,twitzyloonatic,0,1,1,0,1,1,0,0,1,1,1,0
10460,,,crosstogalaxy,3,1,4,3,1,4,0.333333,0.020061,0,0,0,0
10461,,,KBOver2020,0,1,1,0,1,1,0,0,1,1,1,0
10462,,,paulineinspace,0,1,1,0,1,1,0,0,1,1,1,0
10463,,,jikook_is_life,0,1,1,0,1,1,0,0,1,1,1,0
10464,,,carolynryan,0,1,1,0,1,1,0,0,1,1,1,0
10465,,,Kreeti57764638,0,1,1,0,1,1,0,0,1,1,1,0
10466,,,AudreyLauryn2,0,1,1,0,1,1,0,0,1,1,1,0
10467,,,jinmkk,0,1,1,0,1,1,0,0,1,1,1,0
10468,,,tampraiwin30,0,1,1,0,1,1,0,0,1,1,1,0
10469,,,oranginlovee,0,1,1,0,1,1,0,0,1,1,1,0
10470,,,ImblondeItravel,4,1,5,4,1,5,0.25,0.026749,0,0,0,0
10471,,,pkimery,0,1,1,0,1,1,0,0,1,1,1,0
10472,,,LJShiman,0,1,1,0,1,1,0,0,1,1,1,0
10473,,,nanananafn,4,1,5,5,1,6,0.25,0.026749,0,0,0,0
10474,,,ppin2000s,0,1,1,0,1,1,0,0,1,1,1,0
10475,,,missythefae,0,1,1,0,1,1,0,0,1,1,1,0
10476,,,quanpunchman,1,1,2,1,1,2,0,0.006687,0,0,0,0
10477,,,ErieNewsNow,10,1,11,12,2,14,0.1,0.091416,0,0,0,0
10478,,,tarosnows,0,2,2,0,2,2,0,0,1,1,1,0
10479,,,soapyyoongi,0,1,1,0,1,1,0,0,1,1,1,0
10480,,,curtisc5105,0,1,1,0,1,1,0,0,1,1,1,0
10481,,,fairyfshampoo,9,1,10,9,1,10,0,0.03564,1,1,1,9
10482,,,cecilia16888,2,1,3,2,1,3,0.5,0.013374,0,0,0,0
10483,,,pkhinkle,0,1,1,0,1,1,0,0,1,1,1,0
10484,,,annatata1234,4,1,5,4,1,5,0.25,0.026749,0,0,0,0
10485,,,agui_ki,0,1,1,0,1,1,0,0,1,1,1,0
10486,,,Frogrings,0,1,1,0,1,1,0,0,1,1,1,0
10487,,,PLNG103,0,1,1,0,1,1,0,0,2,0.666667,0.75,0
10488,,,Kay88by49286,0,1,1,0,1,1,0,0,1,1,1,0
10489,,,rachel_yuh,0,1,1,0,1,1,0,0,1,1,1,0
10490,,,natechinen,10,1,11,10,1,11,0.1,0.07386,0,0,0,0
10491,,,IAmLunaStella,0,1,1,0,1,1,0,0,1,1,1,0
10492,,,BUBEEEEE,0,1,1,0,1,1,0,0,1,1,1,0
10493,,,transylvanialuv,0,1,1,0,1,1,0,0,1,1,1,0
10494,,,xiuforyou,0,2,2,0,2,2,0,0,1,1,1,0
10495,,,musicisdigital,0,1,1,0,1,1,0,0,1,1,1,0
10496,,,I_fan_of_kpop,0,1,1,0,1,1,0,0,1,1,1,0
10497,,,Tooooralalalaa,0,1,1,0,1,1,0,0,1,1,1,0
10498,,,oshiology,0,1,1,0,1,1,0,0,1,1,1,0
10499,,,javaglee,0,1,1,0,1,1,0,0,2,0.6,0.666667,0
10500,,,dannyctzen,11,1,12,12,1,13,0.090909,0.087535,0,0,0,0
10501,,,321_5556,0,1,1,0,1,1,0,0,1,1,1,0
10502,,,Dchu07559344,0,1,1,0,1,1,0,0,1,1,1,0
10503,,,observing_rat,0,1,1,0,1,1,0,0,1,1,1,0
10504,,,jinjiggleme,0,3,3,0,3,3,0,0,1,1,1,0
10505,,,staywearsprada,0,1,1,0,1,1,0,0,1,1,1,0
10506,,,tunekiyo,0,1,1,0,1,1,0,0,1,1,1,0
10507,,,kanory_t,0,1,1,0,1,1,0,0,1,1,1,0
10508,,,CherryWoony,0,1,1,0,1,1,0,0,1,1,1,0
10509,,,abbyohlheiser,5,1,6,5,1,6,0.2,0.033436,0,0,0,0
10510,,,lazyglows,0,1,1,0,1,1,0,0,1,1,1,0
10511,,,papaya_jpeg,0,1,1,0,1,1,0,0,1,1,1,0
10512,,,SallieKraus,0,1,1,0,1,1,0,0,1,1,1,0
10513,,,PieperLee,14,1,15,14,1,15,0.071429,0.100608,0,0,0,0
10514,,,treasures_jades,0,1,1,0,1,1,0,0,1,1,1,0
10515,,,stlouisishome,0,2,2,0,2,2,0,0,1,1,1,0
10516,,,tohrusheart,0,1,1,0,1,1,0,0,1,1,1,0
10517,,,rosesdosmile,0,1,1,0,1,1,0,0,1,1,1,0
10518,,,DOWOOLOV,0,1,1,0,1,1,0,0,1,1,1,0
10519,,,f_sakurayama,0,1,1,0,1,1,0,0,1,1,1,0
10520,,,Tye_Dye14,0,1,1,0,1,1,0,0,1,1,1,0
10521,,,ana_dalzell,0,1,1,0,1,1,0,0,1,1,1,0
10522,,,ntnsL30,11,1,12,11,1,12,0.090909,0.073559,0,0,0,0
10523,,,hwatiny_1117,0,1,1,0,1,1,0,0,1,1,1,0
10524,,,itssummers,0,1,1,0,1,1,0,0,1,1,1,0
10525,,,javasleepbeetwt,0,1,1,0,1,1,0,0,1,1,1,0
10526,,,katescattergood,0,1,1,0,1,1,0,0,1,1,1,0
10527,,,xzhanyibotae,0,2,2,0,2,2,0,0,2,0.75,0.833333,0
10528,,,encatadaff,0,1,1,0,1,1,0,0,1,1,1,0
10529,,,EricHultgren,0,1,1,0,1,1,0,0,1,1,1,0
10530,,,VIRGINBL00D,0,1,1,0,1,1,0,0,1,1,1,0
10531,,,MGoFuel,0,1,1,0,1,1,0,0,1,1,1,0
10532,,,aaaricuny,3,1,4,3,1,4,0.333333,0.020061,0,0,0,0
10533,,,kramer_susan,0,1,1,0,1,1,0,0,1,1,1,0
10534,,,KooBunBaby,0,1,1,0,1,1,0,0,1,1,1,0
10535,,,billboard,5,1,6,5,1,6,0.2,0.033436,0,0,0,0
10536,,,JimBeattie18,0,1,1,0,1,1,0,0,1,1,1,0
10537,,,finstaiura,0,1,1,0,1,1,0,0,1,1,1,0
10538,,,EstherRG1,0,1,1,0,1,1,0,0,1,1,1,0
10539,,,TishCla34692966,0,1,1,0,1,1,0,0,1,1,1,0
10540,,,beatrizpaivade4,0,1,1,0,1,1,0,0,1,1,1,0
10541,,,alischashop,0,1,1,0,1,1,0,0,1,1,1,0
10542,,,Elikritchka_OHL,0,1,1,0,1,1,0,0,1,1,1,0
10543,,,IncognitoWombat,0,1,1,0,1,1,0,0,1,1,1,0
10544,,,fearnot,0,1,1,0,1,1,0,0,1,1,1,0
10545,,,cottonlibrary,0,1,1,0,1,1,0,0,1,1,1,0
10546,,,luismontesbrito,1,1,2,1,1,2,0,0.006687,0,0,0,0
10547,,,grandrusset,5,1,6,5,1,6,0.2,0.033436,0,0,0,0
10548,,,marucha27978022,0,1,1,0,1,1,0,0,1,1,1,0
10549,,,jcpegger69,0,1,1,0,1,1,0,0,1,1,1,0
10550,,,outfoxed_toni,1,1,2,1,1,2,0,0.006687,0,0,0,0
10551,,,oum2mi,10,2,12,12,3,15,0.090909,0.113404,1,1,1,26
10552,,,GlNLUVR,0,1,1,0,1,1,0,0,2,0.666667,0.75,0
10553,,,gcmxiaostark,0,3,3,0,3,3,0,0,2,0.8,0.875,0
10554,,,fewixes,0,1,1,0,1,1,0,0,2,0.666667,0.75,0
10555,,,na3A4T_4Lo,0,1,1,0,1,1,0,0,2,0.666667,0.75,0
10556,,,davisliumd,12,3,15,13,4,17,0.071429,0.096609,2,0.75,0.833333,51
10557,,,yembo__,2,1,3,2,1,3,0.5,0.013374,0,0,0,0
10558,,,huM1Nbeing,0,1,1,0,1,1,0,0,1,1,1,0
10559,,,betsyberns,1,1,2,1,1,2,0,0.006687,0,0,0,0
10560,,,jeffs92,1,1,2,1,1,2,0,0.006687,0,0,0,0
10561,,,SammysPuppyEyes,0,1,1,0,1,1,0,0,1,1,1,0
10562,,,escribanonavas,0,1,1,0,1,1,0,0,1,1,1,0
10563,,,bangtanschibu,0,1,1,0,1,1,0,0,1,1,1,0
10564,,,kmimiharu,0,1,1,0,1,1,0,0,1,1,1,0
10565,,,gr8tvalubeyonce,13,1,14,13,1,14,0.076923,0.092387,0,0,0,0
10566,,,zzairaaaa,0,1,1,0,1,1,0,0,1,1,1,0
10567,,,4ATENCHI,0,1,1,0,1,1,0,0,1,1,1,0
10568,,,saint_litchi,0,2,2,0,2,2,0,0,1,1,1,0
10569,,,naoyou_na,2,1,3,2,1,3,0,0.00792,1,1,1,2
10570,,,fun_fun36,0,1,1,0,1,1,0,0,1,1,1,0
10571,,,icecoldtee,0,2,2,0,2,2,0,0,1,1,1,0
10572,,,leonhu07,0,1,1,0,1,1,0,0,1,1,1,0
10573,,,Koyukiyusagi,0,1,1,0,1,1,0,0,1,1,1,0
10574,,,lost_in_mars,0,1,1,0,1,1,0,0,1,1,1,0
10575,,,HerrerosSoledad,0,1,1,0,1,1,0,0,1,1,1,0
10576,,,___foreverrain,0,1,1,0,1,1,0,0,1,1,1,0
10577,,,MrTonyAustin,1,1,2,1,1,2,0,0.006687,0,0,0,0
10578,,,snowqueen0411,3,1,4,3,1,4,0.333333,0.020061,0,0,0,0
10579,,,LuluBaroun,0,1,1,0,1,1,0,0,1,1,1,0
10580,,,imwoman11,0,1,1,0,1,1,0,0,1,1,1,0
10581,,,yumetine_,0,2,2,0,2,2,0,0,3,0.571429,0.708333,0
10582,,,vineyardvag,0,2,2,0,2,2,0,0,3,0.555556,0.666667,0
10583,,,CherrieBucknor,1,1,2,1,1,2,0,0.006687,0,0,0,0
10584,,,KristofferGair,15,1,16,15,1,16,0.066667,0.100307,0,0,0,0
10585,,,bluemingtone,0,1,1,0,1,1,0,0,1,1,1,0
10586,,,bryan__miguel,0,1,1,0,1,1,0,0,1,1,1,0
10587,,,kinako_f923,0,1,1,0,1,1,0,0,1,1,1,0
10588,,,shomano11,0,1,1,0,1,1,0,0,1,1,1,0
10589,,,Ourdemocracy5,0,1,1,0,1,1,0,0,1,1,1,0
10590,,,piyusha_botejuu,0,1,1,0,1,1,0,0,1,1,1,0
10591,,,apty101304,0,5,5,0,5,5,0,0,1,1,1,0
10592,,,WS57270049,0,1,1,0,1,1,0,0,1,1,1,0
10593,,,ItBeRenee,0,1,1,0,1,1,0,0,1,1,1,0
10594,,,Jreatsdung,0,1,1,0,1,1,0,0,1,1,1,0
10595,,,hyunjinstigma,10,2,12,10,2,12,0.090909,0.066871,1,1,1,9
10596,,,LEE2000JENO,0,1,1,0,1,1,0,0,2,0.666667,0.75,0
10597,,,kkim_dyo,0,1,1,0,1,1,0,0,2,0.666667,0.75,0
10598,,,IamNami28,0,1,1,0,1,1,0,0,2,0.666667,0.75,0
10599,,,hopesilverspoon,0,1,1,0,1,1,0,0,2,0.666667,0.75,0
10600,,,EversonCHB,0,1,1,0,1,1,0,0,2,0.666667,0.75,0
10601,,,vickieluvie,0,2,2,0,2,2,0,0,2,0.75,0.833333,0
10602,,,SnowPalsDotOrg,6,1,7,6,1,7,0.166667,0.047111,0,0,0,0
10603,,,90smarks,0,1,1,0,1,1,0,0,1,1,1,0
10604,,,Athena_AGA,0,1,1,0,1,1,0,0,1,1,1,0
10605,,,rabbitkookjeon,0,1,1,0,1,1,0,0,1,1,1,0
10606,,,Shadowolf2,0,1,1,0,1,1,0,0,1,1,1,0
10607,,,emfring,4,1,5,4,1,5,0.25,0.026749,0,0,0,0
10608,,,No_Jammm,0,1,1,0,1,1,0,0,1,1,1,0
10609,,,EdgeMediaNet,1,1,2,1,1,2,0,0.006687,0,0,0,0
10610,,,MINSSDIOR,0,1,1,0,1,1,0,0,1,1,1,0
10611,,,virtumoist,0,1,1,0,1,1,0,0,1,1,1,0
10612,,,CathleenKucz,0,1,1,0,1,1,0,0,1,1,1,0
10613,,,KEVINLY01703141,1,1,2,1,1,2,0,0.006687,0,0,0,0
10614,,,JeezyYeezy1234,0,1,1,0,1,1,0,0,1,1,1,0
10615,,,vivTmd,1,1,2,1,1,2,0,0.006687,0,0,0,0
10616,,,ruthsrevenge1,0,1,1,0,1,1,0,0,1,1,1,0
10617,,,SSinDeeLoo,0,1,1,0,1,1,0,0,1,1,1,0
10618,,,mirrornball,0,1,1,0,1,1,0,0,1,1,1,0
10619,,,freshwaterpurl,0,1,1,0,1,1,0,0,1,1,1,0
10620,,,satoruflakes,0,1,1,0,1,1,0,0,1,1,1,0
10621,,,kumyRuby,0,1,1,0,1,1,0,0,1,1,1,0
10622,,,nari0506,0,1,1,0,1,1,0,0,1,1,1,0
10623,,,EINGoldNews,14,1,15,14,1,15,0.071429,0.100608,0,0,0,0
10624,,,kookvglows,0,1,1,0,1,1,0,0,1,1,1,0
10625,,,ana_3304,0,1,1,0,1,1,0,0,1,1,1,0
10626,,,Rnckw,0,1,1,0,1,1,0,0,1,1,1,0
10627,,,VimislikAnne,0,1,1,0,1,1,0,0,1,1,1,0
10628,,,sheisbicth,0,1,1,0,1,1,0,0,1,1,1,0
10629,,,hamloner,0,1,1,0,1,1,0,0,1,1,1,0
10630,,,moonshadowie,0,1,1,0,1,1,0,0,1,1,1,0
10631,,,oneninefive2,0,1,1,0,1,1,0,0,1,1,1,0
10632,,,raoulvilla,2,2,4,2,2,4,0.333333,0.013374,1,1,1,1
10633,,,theonewhereSam,0,1,1,0,1,1,0,0,1,1,1,0
10634,,,weebleny,2,1,3,2,1,3,0.5,0.112866,0,0,0,0
10635,,,beysexuall,13,2,15,13,7,20,0.076923,0.133023,1,1,1,37
10636,,,Judy01690836,0,1,1,0,1,1,0,0,2,0.666667,0.75,0
10637,,,cathonpaper,0,1,1,0,1,1,0,0,2,0.666667,0.75,0
10638,,,maoao18,0,1,1,0,1,1,0,0,2,0.666667,0.75,0
10639,,,YaxueCao,5,1,6,5,1,6,0,0.066929,2,0.666667,0.75,42
10640,,,rapiwxk,0,1,1,0,1,1,0,0,2,0.666667,0.75,0
10641,,,begsxy,0,1,1,0,1,1,0,0,2,0.666667,0.75,0
10642,,,rjgarver,0,1,1,0,1,1,0,0,2,0.666667,0.75,0
10643,,,big_perez,0,1,1,0,1,1,0,0,2,0.666667,0.75,0
10644,,,sailuvzzz,14,1,15,14,1,15,0.071429,0.09362,0,0,0,0
10645,,,xiaomari_03,0,1,1,0,1,1,0,0,1,1,1,0
10646,,,newyorker_ny,0,1,1,0,1,1,0,0,1,1,1,0
10647,,,dkskio,0,1,1,0,1,1,0,0,1,1,1,0
10648,,,WLambdin,0,1,1,0,1,1,0,0,1,1,1,0
10649,,,BtsGucciTrash2,0,1,1,0,1,1,0,0,1,1,1,0
10650,,,16_4019,0,1,1,0,1,1,0,0,1,1,1,0
10651,,,jwbirth,0,1,1,0,1,1,0,0,1,1,1,0
10652,,,libbi_schnabell,0,1,1,0,1,1,0,0,1,1,1,0
10653,,,JUNGW0NG,5,1,6,5,1,6,0.2,0.033436,0,0,0,0
10654,,,shouqanai,0,1,1,0,1,1,0,0,1,1,1,0
10655,,,nel2008,0,3,3,0,3,3,0,0,1,1,1,0
10656,,,Jamie210,3,1,4,3,1,4,0.333333,0.020061,0,0,0,0
10657,,,bh0506cy,0,1,1,0,1,1,0,0,1,1,1,0
10658,,,hyyhfaerie,0,1,1,0,1,1,0,0,1,1,1,0
10659,,,95O7Ol_,0,1,1,0,1,1,0,0,1,1,1,0
10660,,,asiaonecom,4,1,5,4,1,5,0.25,0.026749,0,0,0,0
10661,,,Dheanysus,0,1,1,0,1,1,0,0,1,1,1,0
10662,,,yinngyae,0,1,1,0,1,1,0,0,1,1,1,0
10663,,,wdtnjohn,0,1,1,0,1,1,0,0,1,1,1,0
10664,,,jinsoultoelickr,1,1,2,1,1,2,0,0.006687,0,0,0,0
10665,,,JoonsMonoBonsai,0,1,1,0,1,1,0,0,1,1,1,0
10666,,,hazardsaxl,0,1,1,0,1,1,0,0,1,1,1,0
10667,,,PhiTauBill,0,1,1,0,1,1,0,0,1,1,1,0
10668,,,YEONJUNS_LVR,0,1,1,0,1,1,0,0,1,1,1,0
10669,,,kuya_khael,0,1,1,0,1,1,0,0,1,1,1,0
10670,,,ATinyCaratGoose,0,1,1,0,1,1,0,0,1,1,1,0
10671,,,hooniehour,0,1,1,0,1,1,0,0,1,1,1,0
10672,,,prplewings,0,1,1,0,1,1,0,0,1,1,1,0
10673,,,sabsss__,0,1,1,0,1,1,0,0,1,1,1,0
10674,,,Terryg1979,0,1,1,0,1,1,0,0,1,1,1,0
10675,,,KathyVullis,0,1,1,0,1,1,0,0,1,1,1,0
10676,,,dianxia_wei,0,1,1,0,1,1,0,0,1,1,1,0
10677,,,MarySny19776922,0,1,1,0,1,1,0,0,1,1,1,0
10678,,,3326washago,0,1,1,0,1,1,0,0,1,1,1,0
10679,,,medicated_dr,6,1,7,6,1,7,0.166667,0.040123,0,0,0,0
10680,,,NicholeGomezTV,0,1,1,0,1,1,0,0,1,1,1,0
10681,,,shyyoonie,0,1,1,0,1,1,0,0,1,1,1,0
10682,,,cttnbezs74HRxSg,0,1,1,0,1,1,0,0,1,1,1,0
10683,,,airycasTrials,0,1,1,0,1,1,0,0,1,1,1,0
10684,,,taegiball,0,1,1,0,1,1,0,0,1,1,1,0
10685,,,haechan1000,0,1,1,0,1,1,0,0,1,1,1,0
10686,,,n_th_n__ch_n,0,4,4,0,4,4,0,0,1,1,1,0
10687,,,VirginiaHumke,0,1,1,0,1,1,0,0,1,1,1,0
10688,,,jungshookie007,0,1,1,0,1,1,0,0,1,1,1,0
10689,,,itzgrIs,3,1,4,4,1,5,0.333333,0.020061,0,0,0,0
10690,,,rjsepiphany,0,4,4,0,5,5,0,0,5,0.459459,0.520588,0
10691,,,halfdoomd,0,1,1,0,1,1,0,0,1,1,1,0
10692,,,_TOKITOH,3,1,4,3,1,4,0.333333,0.020061,0,0,0,0
10693,,,love_nyans,0,1,1,0,1,1,0,0,1,1,1,0
10694,,,thehope_ofjuly,0,1,1,0,1,1,0,0,1,1,1,0
10695,,,suhanyumi,2,1,3,2,1,3,0.5,0.013374,0,0,0,0
10696,,,treviathrows,0,1,1,0,1,1,0,0,5,0.43662,0.474194,0
10697,,,seokfairv,0,1,1,0,1,1,0,0,2,0.666667,0.75,0
10698,,,baekksong,0,1,1,0,1,1,0,0,2,0.666667,0.75,0
10699,,,naaabsz,4,1,5,4,1,5,0.25,0.026749,0,0,0,0
10700,,,denmarkien,0,1,1,0,1,1,0,0,1,1,1,0
10701,,,kevin_ferraris,0,1,1,0,1,1,0,0,1,1,1,0
10702,,,GreyMessenger,0,1,1,0,1,1,0,0,1,1,1,0
10703,,,RichardDNeilson,0,1,1,0,1,1,0,0,1,1,1,0
10704,,,lucen_n,0,1,1,0,1,1,0,0,1,1,1,0
10705,,,kimtaegerlily,0,2,2,0,2,2,0,0,3,0.513514,0.54386,0
10706,,,ErinE99,0,1,1,0,1,1,0,0,1,1,1,0
10707,,,vindemiatryx98,0,1,1,0,1,1,0,0,1,1,1,0
10708,,,jackietest_,6,1,7,6,1,7,0.166667,0.040123,0,0,0,0
10709,,,Nerolin1970,0,1,1,0,1,1,0,0,1,1,1,0
10710,,,Andre_Woo,0,1,1,0,1,1,0,0,1,1,1,0
10711,,,thebanglatime,0,1,1,0,1,1,0,0,1,1,1,0
10712,,,fuyunodaffodil,0,1,1,0,1,1,0,0,1,1,1,0
10713,,,BeanFromPA,0,1,1,0,1,1,0,0,1,1,1,0
10714,,,Tonyvdgoten,0,1,1,0,1,1,0,0,1,1,1,0
10715,,,_addove,0,2,2,0,2,2,0,0,1,1,1,0
10716,,,JLSMITH1204,0,2,2,0,2,2,0,0,1,1,1,0
10717,,,conn_brown21,2,1,3,2,1,3,0.5,0.013374,0,0,0,0
10718,,,kazorientalbio,0,1,1,0,1,1,0,0,1,1,1,0
10719,,,edutt88,6,1,7,6,1,7,0.166667,0.040123,0,0,0,0
10720,,,RChitwood,0,1,1,0,1,1,0,0,1,1,1,0
10721,,,ZuzuHanyu,0,5,5,0,5,5,0,0,1,1,1,0
10722,,,anothercaos,0,1,1,0,1,1,0,0,1,1,1,0
10723,,,iheartdannon21,0,2,2,0,2,2,0,0,1,1,1,0
10724,,,csmeneghini,2,1,3,2,1,3,0.5,0.013374,0,0,0,0
10725,,,maxwannadiee,0,1,1,0,1,1,0,0,1,1,1,0
10726,,,KyleBloomMedia,3,1,4,3,1,4,0.333333,0.020061,0,0,0,0
10727,,,yuzurujuice,0,2,2,0,2,2,0,0,1,1,1,0
10728,,,MBRMark,0,1,1,0,1,1,0,0,1,1,1,0
10729,,,nicecxo,19,1,20,20,1,21,0.052632,0.127056,0,0,0,0
10730,,,2wicetxt,0,1,1,0,1,1,0,0,1,1,1,0
10731,,,Csysel,0,1,1,0,1,1,0,0,1,1,1,0
10732,,,gnfdear,0,1,1,0,1,1,0,0,1,1,1,0
10733,,,kiraxmyg,0,1,1,0,1,1,0,0,1,1,1,0
10734,,,daisyesus,0,1,1,0,1,1,0,0,1,1,1,0
10735,,,KWANBOOD,0,1,1,0,2,2,0,0,1,1,1,0
10736,,,ayenpewpew,0,1,1,0,1,1,0,0,1,1,1,0
10737,,,cafebourgeois,0,2,2,0,2,2,0,0,1,1,1,0
10738,,,707pcy_,0,1,1,0,1,1,0,0,1,1,1,0
10739,,,pjmugs,0,1,1,0,1,1,0,0,1,1,1,0
10740,,,DanSkinnerArt,0,3,3,0,3,3,0,0,1,1,1,0
10741,,,catie_girl727,0,1,1,0,1,1,0,0,1,1,1,0
10742,,,seektruth12345,0,1,1,0,1,1,0,0,1,1,1,0
10743,,,kikinland_,0,2,2,0,2,2,0,0,1,1,1,0
10744,,,rezillllik,0,1,1,0,1,1,0,0,1,1,1,0
10745,,,xseokjinx_,0,1,1,0,1,1,0,0,1,1,1,0
10746,,,Mallory51762611,0,1,1,0,1,1,0,0,1,1,1,0
10747,,,BlackIrishI,0,1,1,0,1,1,0,0,1,1,1,0
10748,,,vmnisluv,3,1,4,3,1,4,0.333333,0.020061,0,0,0,0
10749,,,reirne,0,2,2,0,2,2,0,0,1,1,1,0
10750,,,SheyInfiresMan,0,1,1,0,1,1,0,0,1,1,1,0
10751,,,min__ara,0,1,1,0,1,1,0,0,2,0.666667,0.75,0
10752,,,jimtyler48,0,1,1,0,1,1,0,0,2,0.666667,0.75,0
10753,,,shinminjoo1208,0,1,1,0,1,1,0,0,2,0.666667,0.75,0
10754,,,Pracken,0,1,1,0,1,1,0,0,2,0.666667,0.75,0
10755,,,WorldOpinionInd,6,1,7,6,1,7,0.166667,0.040123,0,0,0,0
10756,,,GO48484410,0,1,1,0,1,1,0,0,1,1,1,0
10757,,,churchlady320,0,2,2,0,2,2,0,0,1,1,1,0
10758,,,LevinChau,0,1,1,0,1,1,0,0,1,1,1,0
10759,,,gap_moe_shoma,0,2,2,0,2,2,0,0,1,1,1,0
10760,,,AmyYanni,6,1,7,6,1,7,0.166667,0.047111,0,0,0,0
10761,,,angelus_0923,0,1,1,0,1,1,0,0,1,1,1,0
10762,,,NuGabby,0,1,1,0,1,1,0,0,1,1,1,0
10763,,,Hilary_TV,0,2,2,0,2,2,0,0,1,1,1,0
10764,,,LChenDraws,3,1,4,3,1,4,0.333333,0.020061,0,0,0,0
10765,,,DevonRGoss,0,1,1,0,1,1,0,0,1,1,1,0
10766,,,KatsuhikoTsuda,0,1,1,0,1,1,0,0,1,1,1,0
10767,,,lunaee__,16,1,17,16,1,17,0.0625,0.106994,0,0,0,0
10768,,,Joanie46513368,0,1,1,0,1,1,0,0,1,1,1,0
10769,,,HiddenJules_,0,1,1,0,1,1,0,0,1,1,1,0
10770,,,The4DsinCO,0,1,1,0,1,1,0,0,1,1,1,0
10771,,,XeEvil_,0,1,1,0,1,1,0,0,1,1,1,0
10772,,,anipchan,0,1,1,0,1,1,0,0,1,1,1,0
10773,,,sigleave,0,1,1,0,1,1,0,0,1,1,1,0
10774,,,pandamin777,0,1,1,0,1,1,0,0,1,1,1,0
10775,,,CJMuras,0,1,1,0,1,1,0,0,1,1,1,0
10776,,,mr4edward,0,1,1,0,1,1,0,0,1,1,1,0
10777,,,guts_ya,0,1,1,0,1,1,0,0,1,1,1,0
10778,,,JustMin_Mine,0,1,1,0,1,1,0,0,1,1,1,0
10779,,,AllisaurusRex,0,1,1,0,1,1,0,0,1,1,1,0
10780,,,kyoshisells,0,1,1,0,1,1,0,0,1,1,1,0
10781,,,Shamgar1963,0,1,1,0,1,1,0,0,1,1,1,0
10782,,,shxntw,0,1,1,0,1,1,0,0,1,1,1,0
10783,,,cbmptbnp,0,1,1,0,1,1,0,0,1,1,1,0
10784,,,eastern_star_9,0,1,1,0,1,1,0,0,1,1,1,0
10785,,,fj3isback,0,1,1,0,1,1,0,0,1,1,1,0
10786,,,hyucktheace,0,1,1,0,1,1,0,0,1,1,1,0
10787,,,arimoto_kaori,0,1,1,0,1,1,0,0,1,1,1,0
10788,,,buritsch,0,1,1,0,1,1,0,0,1,1,1,0
10789,,,amanethectr,0,1,1,0,1,1,0,0,1,1,1,0
10790,,,daisies_night,0,1,1,0,1,1,0,0,1,1,1,0
10791,,,RickiMayhall,0,1,1,0,1,1,0,0,2,0.6,0.666667,0
10792,,,chikageDNI,0,1,1,0,1,1,0,0,2,0.6,0.666667,0
10793,,,the_squarrell,0,1,1,0,1,1,0,0,2,0.6,0.666667,0
10794,,,aotrantacc,0,1,1,0,1,1,0,0,3,0.46875,0.5,0
10795,,,ByunmiinaD,0,1,1,0,1,1,0,0,3,0.46875,0.5,0
10796,,,mk391419,0,1,1,0,1,1,0,0,3,0.46875,0.5,0
10797,,,yutakama,0,1,1,0,1,1,0,0,3,0.46875,0.5,0
10798,,,neoclachical,0,1,1,0,1,1,0,0,3,0.46875,0.5,0
10799,,,t_vandenburg,0,1,1,0,1,1,0,0,3,0.46875,0.5,0
10800,,,chaotictsumu,0,1,1,0,1,1,0,0,3,0.46875,0.5,0
10801,,,Fran101055,0,1,1,0,1,1,0,0,3,0.46875,0.5,0
10802,,,SCOTUSLaw,0,1,1,0,1,1,0,0,3,0.46875,0.5,0
10803,,,perchance99,0,1,1,0,1,1,0,0,3,0.46875,0.5,0
10804,,,Wanningfxcker,0,1,1,0,1,1,0,0,3,0.46875,0.5,0
10805,,,ArmyNae,0,1,1,0,1,1,0,0,3,0.46875,0.5,0
10806,,,BuabengOfficial,0,1,1,0,1,1,0,0,3,0.46875,0.5,0
10807,,,kuronekodaisuki,0,1,1,0,1,1,0,0,3,0.46875,0.5,0
10808,,,fltrjinie,0,1,1,0,1,1,0,0,3,0.46875,0.5,0
10809,,,hilonwheels,12,1,13,12,1,13,0.083333,0.080246,0,0,0,0
10810,,,ixiaokazuha,0,1,1,0,1,1,0,0,1,1,1,0
10811,,,bellucciyg,0,1,1,0,1,1,0,0,1,1,1,0
10812,,,toastyemblem,0,1,1,0,1,1,0,0,1,1,1,0
10813,,,wetbakyuuns,0,1,1,0,1,1,0,0,1,1,1,0
10814,,,frigganfrankie,0,1,1,0,1,1,0,0,1,1,1,0
10815,,,_K_i_K_i_k,0,1,1,0,1,1,0,0,1,1,1,0
10816,,,BCally,0,1,1,0,1,1,0,0,1,1,1,0
10817,,,ushiwhat,0,2,2,0,2,2,0,0,1,1,1,0
10818,,,Len0595249,0,1,1,0,1,1,0,0,1,1,1,0
10819,,,GeniusLabProd,0,1,1,0,1,1,0,0,1,1,1,0
10820,,,ThomasInLaJolla,0,1,1,0,1,1,0,0,1,1,1,0
10821,,,Eyu64724167,1,1,2,1,1,2,0,0.006687,0,0,0,0
10822,,,prettybtchy,1,1,2,1,1,2,0,0.006687,0,0,0,0
10823,,,AcctProgressive,0,1,1,0,1,1,0,0,2,0.666667,0.75,0
10824,,,pariwalkwayyuzu,14,1,15,15,1,16,0.071429,0.09362,0,0,0,0
10825,,,kawaimnida,0,1,1,0,1,1,0,0,1,1,1,0
10826,,,SharifDKingTV,0,1,1,0,2,2,0,0,1,1,1,0
10827,,,jonginhoneyy,0,1,1,0,1,1,0,0,1,1,1,0
10828,,,adrienxir,0,1,1,0,1,1,0,0,1,1,1,0
10829,,,TT_2002,0,4,4,0,4,4,0,0,2,0.833333,0.9,0
10830,,,tom_blome,0,1,1,0,1,1,0,0,1,1,1,0
10831,,,FictionLover2,0,1,1,0,1,1,0,0,1,1,1,0
10832,,,james_enfield21,0,1,1,0,1,1,0,0,1,1,1,0
10833,,,l0stballads,0,1,1,0,1,1,0,0,1,1,1,0
10834,,,AnswerMam,0,1,1,0,1,1,0,0,1,1,1,0
10835,,,yoongibbyyy,8,2,10,8,2,10,0.111111,0.060486,4,0.37931,0.44697,88
10836,,,LonerWarmth,0,1,1,0,1,1,0,0,5,0.292683,0.355556,0
10837,,,NickAtNighttt,0,1,1,0,1,1,0,0,5,0.292683,0.355556,0
10838,,,_shizuhana,0,1,1,0,1,1,0,0,5,0.292683,0.355556,0
10839,,,jikooksoulies,0,1,1,0,1,1,0,0,5,0.292683,0.355556,0
10840,,,bbharchiviste,0,1,1,0,1,1,0,0,5,0.292683,0.355556,0
10841,,,aroma_cklife,0,1,1,0,1,1,0,0,5,0.292683,0.355556,0
10842,,,BarbB0925,0,1,1,0,1,1,0,0,4,0.37931,0.44697,0
10843,,,rjsungie,0,1,1,0,1,1,0,0,1,1,1,0
10844,,,senkupotion,0,3,3,0,3,3,0,0,1,1,1,0
10845,,,B00BE4R,0,1,1,0,1,1,0,0,1,1,1,0
10846,,,fluffyyuzuru,0,1,1,0,1,1,0,0,1,1,1,0
10847,,,Tarou_Ent,0,1,1,0,1,1,0,0,1,1,1,0
10848,,,sgchubz,0,1,1,0,1,1,0,0,1,1,1,0
10849,,,Jen22102729,0,1,1,0,1,1,0,0,1,1,1,0
10850,,,sam_panpanic,0,1,1,0,1,1,0,0,1,1,1,0
10851,,,mjxote9,0,1,1,0,1,1,0,0,1,1,1,0
10852,,,DystopianGordon,0,1,1,0,1,1,0,0,1,1,1,0
10853,,,yuzuchen210,1,1,2,1,1,2,0,0.006687,0,0,0,0
10854,,,davisj1,5,2,7,5,2,7,0.166667,0.033436,1,1,1,4
10855,,,Portello16,0,1,1,0,1,1,0,0,2,0.666667,0.75,0
10856,,,sbtkow8,0,1,1,0,1,1,0,0,2,0.666667,0.75,0
10857,,,Maga4Justice,0,1,1,0,1,1,0,0,2,0.666667,0.75,0
10858,,,cvtiepie_bby,6,1,7,6,1,7,0,0.02376,3,0.5,0.583333,24
10859,,,queen_elsaY,0,1,1,0,1,1,0,0,3,0.5,0.583333,0
10860,,,KarlaSucgang,0,2,2,0,2,2,0,0,3,0.555556,0.666667,0
10861,,,ruck22,0,1,1,0,1,1,0,0,3,0.5,0.583333,0
10862,,,yayamiaya,0,1,1,0,1,1,0,0,3,0.5,0.583333,0
10863,,,SpoooKyra,0,1,1,0,1,1,0,0,3,0.5,0.583333,0
10864,,,ughirako,0,1,1,0,1,1,0,0,3,0.5,0.583333,0
10865,,,SND,0,1,1,0,1,1,0,0,3,0.5,0.583333,0
10866,,,RealNewArrival,0,1,1,0,1,1,0,0,3,0.5,0.583333,0
10867,,,hoonloveer,0,1,1,0,1,1,0,0,3,0.5,0.583333,0
10868,,,amma_naomi,13,1,14,13,1,14,0.076923,0.10091,0,0,0,0
10869,,,myyunique,0,1,1,0,1,1,0,0,1,1,1,0
10870,,,2cookie2mumble,0,2,2,0,2,2,0,0,1,1,1,0
10871,,,JudeFrisco,0,1,1,0,1,1,0,0,1,1,1,0
10872,,,nicole__768,0,1,1,0,1,1,0,0,1,1,1,0
10873,,,draiochtlive,0,1,1,0,1,1,0,0,1,1,1,0
10874,,,KandaAtsumu,0,1,1,0,1,1,0,0,1,1,1,0
10875,,,pupurenii,0,1,1,0,1,1,0,0,1,1,1,0
10876,,,bewitchedbaby,0,1,1,0,1,1,0,0,1,1,1,0
10877,,,forzyixing__07,0,1,1,0,1,1,0,0,1,1,1,0
10878,,,czacza__,0,1,1,0,1,1,0,0,1,1,1,0
10879,,,tanyachen,5,1,6,5,1,6,0.2,0.033436,0,0,0,0
10880,,,polaroidbutter,0,1,1,0,1,1,0,0,1,1,1,0
10881,,,florenticajoe,0,2,2,0,2,2,0,0,1,1,1,0
10882,,,soobielovebot,0,1,1,0,1,1,0,0,1,1,1,0
10883,,,jackierabbit_,0,1,1,0,1,1,0,0,1,1,1,0
10884,,,barrybrightinsc,9,1,10,9,1,10,0.111111,0.060184,0,0,0,0
10885,,,stick631,0,1,1,0,1,1,0,0,1,1,1,0
10886,,,MikeOutYonder,0,1,1,0,1,1,0,0,1,1,1,0
10887,,,kivy_,0,1,1,0,1,1,0,0,1,1,1,0
10888,,,brightdwt,0,1,1,0,1,1,0,0,1,1,1,0
10889,,,meaculpa321,0,1,1,0,1,1,0,0,1,1,1,0
10890,,,Dogger6337,0,1,1,0,1,1,0,0,1,1,1,0
10891,,,chirpyandsleepy,0,1,1,0,1,1,0,0,1,1,1,0
10892,,,FrontBoomer,2,1,3,2,1,3,0.5,0.013374,0,0,0,0
10893,,,InnahTall,7,1,8,7,1,8,0.142857,0.04681,0,0,0,0
10894,,,notcarryingon,0,1,1,0,1,1,0,0,1,1,1,0
10895,,,xcarlyymariex,0,1,1,0,1,1,0,0,1,1,1,0
10896,,,careerlink4jobs,0,1,1,0,1,1,0,0,1,1,1,0
10897,,,mcallsports,0,1,1,0,1,1,0,0,1,1,1,0
10898,,,Trends_in_USA,10,1,11,11,2,13,0.1,0.066871,0,0,0,0
10899,,,K1LLFORJIMIN,0,1,1,0,1,1,0,0,1,1,1,0
10900,,,wegoingcrazy,0,1,1,0,1,1,0,0,1,1,1,0
10901,,,veetalone,0,1,1,0,1,1,0,0,1,1,1,0
10902,,,TheGrrreenLlama,0,1,1,0,1,1,0,0,1,1,1,0
10903,,,CHILDETEAMO,0,1,1,0,1,1,0,0,1,1,1,0
10904,,,TheGlamourBuff,2,1,3,2,1,3,0.5,0.013374,0,0,0,0
10905,,,WatchSharif,0,1,1,0,1,1,0,0,1,1,1,0
10906,,,videomatome1,9,1,10,9,1,10,0.111111,0.060184,0,0,0,0
10907,,,beyondts7,0,1,1,0,1,1,0,0,1,1,1,0
10908,,,ptylovestae,0,1,1,0,1,1,0,0,1,1,1,0
10909,,,hoshiwokaru,0,1,1,0,1,1,0,0,1,1,1,0
10910,,,KrystleRoseKing,0,1,1,0,1,1,0,0,1,1,1,0
10911,,,Crumlinfinglas,0,1,1,0,1,1,0,0,1,1,1,0
10912,,,iiimuseichore,0,5,5,0,5,5,0,0,2,0.6,0.666667,0
10913,,,rogerpatmyers,1,1,2,1,1,2,0,0.006687,0,0,0,0
10914,,,yoonsiie,0,1,1,0,1,1,0,0,1,1,1,0
10915,,,mordormada,0,1,1,0,1,1,0,0,1,1,1,0
10916,,,wennjinx,0,1,1,0,1,1,0,0,1,1,1,0
10917,,,Alycia614,0,1,1,0,1,1,0,0,1,1,1,0
10918,,,TayciBear,0,1,1,0,1,1,0,0,1,1,1,0
10919,,,E__Strobel,0,1,1,0,1,1,0,0,1,1,1,0
10920,,,hangyulsea,0,1,1,0,1,1,0,0,1,1,1,0
10921,,,nyxsheaven,0,1,1,0,1,1,0,0,1,1,1,0
10922,,,endofplans,0,1,1,0,1,1,0,0,1,1,1,0
10923,,,HuffPostWomen,2,1,3,2,1,3,0.5,0.013374,0,0,0,0
10924,,,RealJohnLaurens,0,1,1,0,1,1,0,0,1,1,1,0
10925,,,NiveaSoftXX,18,1,19,18,1,19,0.055556,0.221036,0,0,0,0
10926,,,jaymann34,0,1,1,0,1,1,0,0,1,1,1,0
10927,,,ShirleyDong18,0,1,1,0,1,1,0,0,1,1,1,0
10928,,,MapleMuffYn,0,1,1,0,1,1,0,0,1,1,1,0
10929,,,lindalovesstuff,0,2,2,0,2,2,0,0,1,1,1,0
10930,,,vinzhais,0,3,3,0,3,3,0,0,2,0.8,0.875,0
10931,,,jasonRi64304181,0,1,1,0,1,1,0,0,1,1,1,0
10932,,,commonsense258,0,1,1,0,1,1,0,0,1,1,1,0
10933,,,Bailyboo11,0,1,1,0,1,1,0,0,1,1,1,0
10934,,,lidoljay,0,1,1,0,1,1,0,0,1,1,1,0
10935,,,rebel_hare,0,1,1,0,1,1,0,0,1,1,1,0
10936,,,kookoosaannn,0,2,2,0,2,2,0,0,1,1,1,0
10937,,,artesfantasia,0,1,1,0,1,1,0,0,1,1,1,0
10938,,,DrydenNovelette,0,2,2,0,2,2,0,0,2,0.75,0.833333,0
10939,,,thejoshuablog,0,1,1,0,1,1,0,0,1,1,1,0
10940,,,barbward804,7,1,8,7,1,8,0.142857,0.053798,0,0,0,0
10941,,,YuAnaZu,0,1,1,0,1,1,0,0,1,1,1,0
10942,,,DonnaFerry10,0,1,1,0,1,1,0,0,1,1,1,0
10943,,,4huaIian,2,2,4,2,2,4,0.333333,0.013374,1,1,1,1
10944,,,onekokiiro,0,1,1,0,1,1,0,0,1,1,1,0
10945,,,NOLADuchess,0,2,2,0,2,2,0,0,2,0.75,0.833333,0
10946,,,zomqiecat,0,1,1,0,1,1,0,0,1,1,1,0
10947,,,judeigwe10,0,1,1,0,1,1,0,0,1,1,1,0
10948,,,tayyymarie,0,1,1,0,1,1,0,0,1,1,1,0
10949,,,beichuchu,0,1,1,0,1,1,0,0,1,1,1,0
10950,,,tsblon2218,0,1,1,0,1,1,0,0,1,1,1,0
10951,,,jordangdavidson,19,1,20,19,1,20,0.052632,0.148021,0,0,0,0
10952,,,SCAM518,0,1,1,0,1,1,0,0,1,1,1,0
10953,,,blqkjeon,0,1,1,0,1,1,0,0,1,1,1,0
10954,,,gwaceallstar,0,1,1,0,1,1,0,0,1,1,1,0
10955,,,divine_jimin,0,2,2,0,2,2,0,0,1,1,1,0
10956,,,saraleottine,0,1,1,0,1,1,0,0,1,1,1,0
10957,,,JadeMitchell199,0,1,1,0,1,1,0,0,1,1,1,0
10958,,,SavannahThao99,0,1,1,0,1,1,0,0,1,1,1,0
10959,,,officialcorlaj,0,1,1,0,1,1,0,0,1,1,1,0
10960,,,luvsyuzu,0,1,1,0,1,1,0,0,1,1,1,0
10961,,,abacjourn,0,1,1,0,1,1,0,0,1,1,1,0
10962,,,lacy_0702,2,5,7,2,5,7,0.166667,0.013374,1,1,1,4
10963,,,ReillySpicer,0,1,1,0,1,1,0,0,1,1,1,0
10964,,,Reuters,23,1,24,24,2,26,0.043478,0.153804,0,0,0,0
10965,,,ohthatgirlanna,0,1,1,0,1,1,0,0,1,1,1,0
10966,,,cw413lem205,0,1,1,0,1,1,0,0,1,1,1,0
10967,,,maguetts,0,1,1,0,1,1,0,0,1,1,1,0
10968,,,LiterallySmash,0,1,1,0,1,1,0,0,1,1,1,0
10969,,,SteveHelwagen,0,1,1,0,1,1,0,0,1,1,1,0
10970,,,windycityevnts,7,1,8,8,1,9,0.142857,0.067775,0,0,0,0
10971,,,joonsrouba,0,1,1,0,1,1,0,0,1,1,1,0
10972,,,nanaa9394,0,1,1,0,1,1,0,0,1,1,1,0
10973,,,AnthonyBibbs19,0,2,2,0,2,2,0,0,1,1,1,0
10974,,,SweetiePieArmy,0,1,1,0,1,1,0,0,1,1,1,0
10975,,,terfsdie,2,1,3,2,1,3,0.5,0.013374,0,0,0,0
10976,,,vdblegal,0,1,1,0,1,1,0,0,1,1,1,0
10977,,,bunzify,1,1,2,1,1,2,0,0.006687,0,0,0,0
10978,,,HobixKei,7,3,10,7,3,10,0.111111,0.04681,1,1,1,12
10979,,,Asg_uwu,0,1,1,0,1,1,0,0,2,0.6,0.666667,0
10980,,,allanman1515,0,1,1,0,1,1,0,0,2,0.6,0.666667,0
10981,,,yuzulvrr,0,5,5,0,5,5,0,0,2,0.727273,0.8125,0
10982,,,rhode_hyz,0,1,1,0,1,1,0,0,2,0.6,0.666667,0
10983,,,YoongiB21072130,0,1,1,0,1,1,0,0,2,0.6,0.666667,0
10984,,,yc_all,10,1,11,11,1,12,0.1,0.066871,0,0,0,0
10985,,,maikkoy,0,1,1,0,1,1,0,0,1,1,1,0
10986,,,NancyMsschwartz,0,1,1,0,1,1,0,0,1,1,1,0
10987,,,ellendwu,0,1,1,0,1,1,0,0,1,1,1,0
10988,,,basoxtahu,0,1,1,0,1,1,0,0,1,1,1,0
10989,,,uwuxiu,0,1,1,0,1,1,0,0,1,1,1,0
10990,,,justjimini,0,1,1,0,1,1,0,0,1,1,1,0
10991,,,RaycholN,0,1,1,0,1,1,0,0,1,1,1,0
10992,,,PopulistDemand,0,1,1,0,2,2,0,0,1,1,1,0
10993,,,SenateTim,0,1,1,0,1,1,0,0,1,1,1,0
10994,,,mitsktan,1,1,2,2,2,4,0,0.006687,0,0,0,0
10995,,,GrantGinder,14,1,15,14,1,15,0.071429,0.09362,0,0,0,0
10996,,,VFlowingFineArt,0,1,1,0,1,1,0,0,1,1,1,0
10997,,,2keai,0,1,1,0,1,1,0,0,1,1,1,0
10998,,,GunnNicole,0,1,1,0,1,1,0,0,1,1,1,0
10999,,,LetMeChooseSmth,0,1,1,0,1,1,0,0,1,1,1,0
11000,,,Terrysspcsowers,0,1,1,0,1,1,0,0,1,1,1,0
11001,,,grapefruitism,0,1,1,0,1,1,0,0,1,1,1,0
11002,,,kellyjohnsonhas,0,1,1,0,1,1,0,0,1,1,1,0
11003,,,libra2libra,0,1,1,0,1,1,0,0,1,1,1,0
11004,,,DeasyKida,0,1,1,0,1,1,0,0,1,1,1,0
11005,,,pleaseimajoke,0,1,1,0,1,1,0,0,1,1,1,0
11006,,,zuzuger32,0,1,1,0,1,1,0,0,1,1,1,0
11007,,,ladysigel,8,1,9,8,1,9,0.125,0.053497,0,0,0,0
11008,,,nursebillion,0,1,1,0,1,1,0,0,1,1,1,0
11009,,,sevenumbrellass,0,1,1,0,1,1,0,0,1,1,1,0
11010,,,pumpthosebrks,0,2,2,0,2,2,0,0,1,1,1,0
11011,,,tzucrush,0,2,2,0,2,2,0,0,1,1,1,0
11012,,,Calendula_flos7,0,1,1,0,1,1,0,0,1,1,1,0
11013,,,Djfreezylee01,0,1,1,0,1,1,0,0,1,1,1,0
11014,,,BluePurpleMusic,2,1,3,2,1,3,0.5,0.013374,0,0,0,0
11015,,,taylor_schalk,0,1,1,0,1,1,0,0,1,1,1,0
11016,,,concert_next,6,1,7,6,1,7,0.166667,0.040123,0,0,0,0
11017,,,_strontium__,0,2,2,0,2,2,0,0,1,1,1,0
11018,,,MaoDa1Ch1,0,1,1,0,1,1,0,0,1,1,1,0
11019,,,WilliamGDonnel1,0,1,1,0,1,1,0,0,1,1,1,0
11020,,,SandyA00188448,0,1,1,0,1,1,0,0,1,1,1,0
11021,,,SmnWeekly,0,1,1,0,1,1,0,0,2,0.666667,0.75,0
11022,,,varicose1981,0,1,1,0,1,1,0,0,2,0.666667,0.75,0
11023,,,susanvela,0,1,1,0,1,1,0,0,2,0.666667,0.75,0
11024,,,cindylou111f,0,1,1,0,1,1,0,0,2,0.666667,0.75,0
11025,,,shimshimiya,0,1,1,0,1,1,0,0,2,0.666667,0.75,0
11026,,,orangefreckle,0,1,1,0,1,1,0,0,1,1,1,0
11027,,,thygergirl,0,1,1,0,1,1,0,0,1,1,1,0
11028,,,luv4tomford,0,1,1,0,1,1,0,0,1,1,1,0
11029,,,LluvTae_,0,1,1,0,1,1,0,0,1,1,1,0
11030,,,Dfizz85,0,1,1,0,1,1,0,0,1,1,1,0
11031,,,yuzubon0523,0,1,1,0,1,1,0,0,1,1,1,0
11032,,,_MissNessie_,0,1,1,0,1,1,0,0,1,1,1,0
11033,,,HITCnews,1,1,2,1,1,2,0,0.006687,0,0,0,0
11034,,,JoeR42,13,1,14,13,1,14,0.076923,0.118381,0,0,0,0
11035,,,butalwaysdark,0,1,1,0,1,1,0,0,1,1,1,0
11036,,,whimseyvenus,0,1,1,0,1,1,0,0,1,1,1,0
11037,,,revelwrld,0,1,1,0,1,1,0,0,1,1,1,0
11038,,,keayafruityy,0,1,1,0,1,1,0,0,1,1,1,0
11039,,,Equill,0,1,1,0,1,1,0,0,1,1,1,0
11040,,,mjdibatt,0,1,1,0,1,1,0,0,1,1,1,0
11041,,,hushj0hn,0,1,1,0,1,1,0,0,1,1,1,0
11042,,,knitterkim,1,1,2,1,1,2,0,0.006687,0,0,0,0
11043,,,NBC6intheMix,9,1,10,9,1,10,0.111111,0.060184,0,0,0,0
11044,,,euphelectronica,0,1,1,0,1,1,0,0,1,1,1,0
11045,,,mppcysws,0,1,1,0,1,1,0,0,1,1,1,0
11046,,,_tiffanydream,0,1,1,0,1,1,0,0,1,1,1,0
11047,,,JanHacker9,0,1,1,0,1,1,0,0,1,1,1,0
11048,,,RecRuth,0,1,1,0,1,1,0,0,1,1,1,0
11049,,,fairyjiboo,0,1,1,0,1,1,0,0,1,1,1,0
11050,,,ahri_best_Waifu,0,1,1,0,1,1,0,0,1,1,1,0
11051,,,fallencandles,0,1,1,0,1,1,0,0,1,1,1,0
11052,,,RAL9OO2,0,1,1,0,1,1,0,0,1,1,1,0
11053,,,m_ichelle_802,1,1,2,2,2,4,0,0.006687,0,0,0,0
11054,,,billboarddance,2,1,3,2,1,3,0.5,0.013374,0,0,0,0
11055,,,Disco__Bisco,0,1,1,0,1,1,0,0,1,1,1,0
11056,,,SBolic1,0,1,1,0,1,1,0,0,1,1,1,0
11057,,,perlaballerina,9,1,10,9,1,10,0.111111,0.060184,0,0,0,0
11058,,,ShuaiMara,0,1,1,0,1,1,0,0,1,1,1,0
11059,,,Roselacent,0,1,1,0,1,1,0,0,1,1,1,0
11060,,,Josh_ta_pose,0,1,1,0,1,1,0,0,1,1,1,0
11061,,,75103g,0,1,1,0,1,1,0,0,1,1,1,0
11062,,,DekkDaaa__,0,1,1,0,1,1,0,0,1,1,1,0
11063,,,btxtchartbullys,0,3,3,0,3,3,0,0,2,0.8,0.875,0
11064,,,luxim00n,0,3,3,0,3,3,0,0,1,1,1,0
11065,,,Sunshin21176498,0,1,1,0,1,1,0,0,1,1,1,0
11066,,,novnein,0,1,1,0,1,1,0,0,1,1,1,0
11067,,,amyignatow,2,1,3,2,1,3,0.5,0.016869,0,0,0,0
11068,,,Yale,4,1,5,4,1,5,0.25,0.026749,0,0,0,0
11069,,,shineeranwan,0,1,1,0,1,1,0,0,1,1,1,0
11070,,,jhwankyu,0,1,1,0,1,1,0,0,1,1,1,0
11071,,,crimson151,0,1,1,0,1,1,0,0,1,1,1,0
11072,,,NBCNewYork,9,1,10,13,4,17,0.111111,0.060184,0,0,0,0
11073,,,jamsiblue,0,1,1,0,1,1,0,0,1,1,1,0
11074,,,sasaracore,0,1,1,0,1,1,0,0,1,1,1,0
11075,,,younzzn,0,1,1,0,1,1,0,0,1,1,1,0
11076,,,trinicouz,0,1,1,0,1,1,0,0,1,1,1,0
11077,,,finallyinheaven,0,1,1,0,1,1,0,0,1,1,1,0
11078,,,MaMoosie,0,1,1,0,1,1,0,0,1,1,1,0
11079,,,multilurver,0,1,1,0,1,1,0,0,1,1,1,0
11080,,,leonkllr007,0,1,1,0,1,1,0,0,1,1,1,0
11081,,,kamemaro3640,0,3,3,0,4,4,0,0,1,1,1,0
11082,,,melissuke,0,1,1,0,1,1,0,0,1,1,1,0
11083,,,Milkychiapuddin,0,1,1,0,1,1,0,0,1,1,1,0
11084,,,joshiki5158,0,1,1,0,1,1,0,0,1,1,1,0
11085,,,RWLawsonFL,0,2,2,0,2,2,0,0,1,1,1,0
11086,,,imshivmgoyal,0,1,1,0,1,1,0,0,1,1,1,0
11087,,,F0GGYnoUMI,0,1,1,0,1,1,0,0,1,1,1,0
11088,,,beomjkoo,2,1,3,4,3,7,0.5,0.013374,0,0,0,0
11089,,,debtopka,0,1,1,0,1,1,0,0,1,1,1,0
11090,,,hashtagmaggie,2,1,3,2,1,3,0.5,0.013374,0,0,0,0
11091,,,aaangsti,0,1,1,0,1,1,0,0,1,1,1,0
11092,,,USATODAY,1,1,2,1,1,2,0,0.006687,0,0,0,0
11093,,,debr3322,0,1,1,0,1,1,0,0,1,1,1,0
11094,,,JonHale_CJ,2,1,3,2,1,3,0.5,0.013374,0,0,0,0
11095,,,ynaishteru,0,1,1,0,1,1,0,0,1,1,1,0
11096,,,tenshusband,10,1,11,11,2,13,0.1,0.150068,0,0,0,0
11097,,,chris_a_vu,0,1,1,0,1,1,0,0,1,1,1,0
11098,,,vewning,0,1,1,0,1,1,0,0,2,0.52381,0.545455,0
11099,,,6knQslRkjRcGctM,0,1,1,0,1,1,0,0,2,0.52381,0.545455,0
11100,,,pnsprkr,0,1,1,0,1,1,0,0,2,0.52381,0.545455,0
11101,,,lots_of_pops,2,1,3,2,1,3,0.5,0.013374,0,0,0,0
11102,,,Billy_Turner115,4,1,5,4,1,5,0.25,0.026749,0,0,0,0
11103,,,pavoncino,0,1,1,0,1,1,0,0,1,1,1,0
11104,,,hangsangdeprssd,0,1,1,0,1,1,0,0,1,1,1,0
11105,,,_mlissaxo,0,1,1,0,1,1,0,0,1,1,1,0
11106,,,47ylz,0,1,1,0,1,1,0,0,1,1,1,0
11107,,,irawamih_,0,1,1,0,1,1,0,0,1,1,1,0
11108,,,sor16386,0,1,1,0,1,1,0,0,1,1,1,0
11109,,,reilly_zoda,0,1,1,0,1,1,0,0,1,1,1,0
11110,,,joemikebud,0,1,1,0,1,1,0,0,1,1,1,0
11111,,,finallyirem,0,1,1,0,1,1,0,0,1,1,1,0
11112,,,badhachiko,0,1,1,0,1,1,0,0,1,1,1,0
11113,,,Mahogony_Stone,0,1,1,0,1,1,0,0,1,1,1,0
11114,,,minwheeinie,0,1,1,0,1,1,0,0,1,1,1,0
11115,,,Theultimatebab1,0,1,1,0,1,1,0,0,1,1,1,0
11116,,,shwur__,0,2,2,0,2,2,0,0,1,1,1,0
11117,,,someonegoogled,11,1,12,11,1,12,0.090909,0.073559,0,0,0,0
11118,,,Man1Anarchy,0,1,1,0,1,1,0,0,1,1,1,0
11119,,,BujaBrenda,0,1,1,0,1,1,0,0,1,1,1,0
11120,,,isuper2022,0,1,1,0,1,1,0,0,1,1,1,0
11121,,,fb_s_u,0,2,2,0,2,2,0,0,1,1,1,0
11122,,,2svtt,0,1,1,0,1,1,0,0,1,1,1,0
11123,,,Kate17Kazoo,0,1,1,0,1,1,0,0,1,1,1,0
11124,,,Immadlol1,0,1,1,0,1,1,0,0,1,1,1,0
11125,,,TopGrace,0,1,1,0,1,1,0,0,1,1,1,0
11126,,,suki3hunna,0,1,1,0,1,1,0,0,1,1,1,0
11127,,,catitcomb,0,1,1,0,1,1,0,0,1,1,1,0
11128,,,b_hyyh04,0,1,1,0,1,1,0,0,1,1,1,0
11129,,,outerspacemanII,0,1,1,0,1,1,0,0,1,1,1,0
11130,,,valsadie,0,1,1,0,1,1,0,0,1,1,1,0
11131,,,jellybunns,2,1,3,2,1,3,0.5,0.03434,0,0,0,0
11132,,,TheSceneSD,3,1,4,3,1,4,0.333333,0.020061,0,0,0,0
11133,,,szumerowska,0,1,1,0,1,1,0,0,1,1,1,0
11134,,,sekando789,5,1,6,5,1,6,0.2,0.033436,0,0,0,0
11135,,,gukblues,0,1,1,0,1,1,0,0,1,1,1,0
11136,,,jintrology,0,1,1,0,1,1,0,0,1,1,1,0
11137,,,jikookthatsit,0,1,1,0,1,1,0,0,1,1,1,0
11138,,,Brandon23994963,0,1,1,0,1,1,0,0,1,1,1,0
11139,,,cqrrnts,0,1,1,0,1,1,0,0,1,1,1,0
11140,,,juniortalent85,0,1,1,0,1,1,0,0,1,1,1,0
11141,,,collinstw,0,1,1,0,1,1,0,0,1,1,1,0
11142,,,NYim0922,0,1,1,0,1,1,0,0,1,1,1,0
11143,,,maineallyb,0,1,1,0,1,1,0,0,1,1,1,0
11144,,,minewns,0,1,1,0,1,1,0,0,1,1,1,0
11145,,,rainbowtbz,3,1,4,3,1,4,0.333333,0.020061,0,0,0,0
11146,,,baylaune,0,1,1,0,1,1,0,0,1,1,1,0
11147,,,catsumtsum,0,1,1,0,1,1,0,0,1,1,1,0
11148,,,_azupoo_,0,1,1,0,1,1,0,0,1,1,1,0
11149,,,MissLizLizLiz,0,1,1,0,1,1,0,0,1,1,1,0
11150,,,maviryu,0,1,1,0,1,1,0,0,1,1,1,0
11151,,,meixiuhua,0,1,1,0,1,1,0,0,1,1,1,0
11152,,,tjohnsonRecruit,2,1,3,2,1,3,0.5,0.013374,0,0,0,0
11153,,,ROZARIO1027,3,1,4,3,1,4,0.333333,0.041027,0,0,0,0
11154,,,amazayn_life,0,1,1,0,1,1,0,0,1,1,1,0
11155,,,newsoneplace,5,1,6,6,2,8,0.2,0.033436,0,0,0,0
11156,,,jbhaniger,0,1,1,0,1,1,0,0,1,1,1,0
11157,,,Chaaberry,0,1,1,0,1,1,0,0,1,1,1,0
11158,,,AyanTalTal,0,1,1,0,1,1,0,0,1,1,1,0
11159,,,nathanfenno,0,1,1,0,1,1,0,0,1,1,1,0
11160,,,MateCahoney,3,1,4,3,1,4,0.333333,0.020061,0,0,0,0
11161,,,WOOGIONICE,0,1,1,0,1,1,0,0,1,1,1,0
11162,,,aviarian,0,1,1,0,1,1,0,0,1,1,1,0
11163,,,CrowdVectors,4,1,5,5,1,6,0.25,0.026749,0,0,0,0
11164,,,FlavorYuta,0,1,1,0,1,1,0,0,1,1,1,0
11165,,,choe_lindsay,0,1,1,0,2,2,0,0,1,1,1,0
11166,,,yeshuaformosa,0,2,2,0,2,2,0,0,1,1,1,0
11167,,,karen_mosteller,7,1,8,7,1,8,0.142857,0.084311,0,0,0,0
11168,,,vuhlkyrie,4,2,6,5,3,8,0.2,0.111392,1,1,1,35
11169,,,hemslark,0,1,1,0,1,1,0,0,1,1,1,0
11170,,,joonie4pres,0,1,1,0,1,1,0,0,1,1,1,0
11171,,,2LQoQAUczHhNU1l,0,1,1,0,1,1,0,0,1,1,1,0
11172,,,LunchtimeSeries,3,1,4,3,1,4,0.333333,0.020061,0,0,0,0
11173,,,yaegigigi,0,1,1,0,1,1,0,0,1,1,1,0
11174,,,ughyoomgi,0,1,1,0,1,1,0,0,1,1,1,0
11175,,,lunarshitzz,6,1,7,6,1,7,0.166667,0.040123,0,0,0,0
11176,,,liveIaughmitski,0,2,2,0,2,2,0,0,1,1,1,0
11177,,,alsawalsa,0,1,1,0,1,1,0,0,1,1,1,0
11178,,,smile_vals,0,1,1,0,1,1,0,0,1,1,1,0
11179,,,MonicaOnline,0,1,1,0,1,1,0,0,1,1,1,0
11180,,,L0VESY00NIE,0,1,1,0,1,1,0,0,1,1,1,0
11181,,,StrangeCloverXI,0,1,1,0,1,1,0,0,1,1,1,0
11182,,,mimiscenery,0,1,1,0,1,1,0,0,1,1,1,0
11183,,,Jared69036156,0,1,1,0,1,1,0,0,1,1,1,0
11184,,,Ghosttopp,0,1,1,0,1,1,0,0,1,1,1,0
11185,,,llstrsnana,0,1,1,0,1,1,0,0,1,1,1,0
11186,,,kvlvrboy,0,2,2,0,2,2,0,0,1,1,1,0
11187,,,qyudimples,6,1,7,6,1,7,0.166667,0.040123,0,0,0,0
11188,,,Itsmaaaria22,0,1,1,0,1,1,0,0,1,1,1,0
11189,,,JustAnotherJo4J,0,1,1,0,1,1,0,0,1,1,1,0
11190,,,GalacTrisSquad,0,1,1,0,1,1,0,0,1,1,1,0
11191,,,reptiliancommie,0,1,1,0,1,1,0,0,1,1,1,0
11192,,,intonathanchen,32,1,33,33,1,34,0.03125,0.234954,0,0,0,0
11193,,,shouchan41,0,1,1,0,1,1,0,0,1,1,1,0
11194,,,indigoyunoh,0,1,1,0,1,1,0,0,1,1,1,0
11195,,,miaadorante,0,1,1,0,1,1,0,0,1,1,1,0
11196,,,babyleomark,0,1,1,0,1,1,0,0,1,1,1,0
11197,,,caffelatte114,0,1,1,0,1,1,0,0,1,1,1,0
11198,,,BlackDi04229689,0,1,1,0,1,1,0,0,1,1,1,0
11199,,,musicadanza,0,1,1,0,1,1,0,0,1,1,1,0
11200,,,HellsVox,0,1,1,0,1,1,0,0,1,1,1,0
11201,,,taesty7bts,0,1,1,0,1,1,0,0,1,1,1,0
11202,,,romes_are_rosie,0,1,1,0,1,1,0,0,1,1,1,0
11203,,,nancy_suddreth,0,1,1,0,1,1,0,0,1,1,1,0
11204,,,JimWitherspoon1,0,1,1,0,2,2,0,0,1,1,1,0
11205,,,PaulDRamone,0,1,1,0,1,1,0,0,1,1,1,0
11206,,,LoraAneM,0,1,1,0,1,1,0,0,1,1,1,0
11207,,,CaffeMocha1207,0,1,1,0,1,1,0,0,1,1,1,0
11208,,,monicasloves,0,3,3,0,3,3,0,0,1,1,1,0
11209,,,SpringDaeTae,0,1,1,0,1,1,0,0,1,1,1,0
11210,,,monodramajpeg,0,1,1,0,1,1,0,0,1,1,1,0
11211,,,JLindohf,0,1,1,0,1,1,0,0,1,1,1,0
11212,,,acckermanscult,0,1,1,0,1,1,0,0,1,1,1,0
11213,,,dbeggs13,0,1,1,0,1,1,0,0,1,1,1,0
11214,,,ElletteJames,0,1,1,0,1,1,0,0,1,1,1,0
11215,,,kinkassspam,0,1,1,0,1,1,0,0,1,1,1,0
11216,,,axwdd96s,0,1,1,0,1,1,0,0,1,1,1,0
11217,,,Deukaetan_gloss,0,1,1,0,1,1,0,0,1,1,1,0
11218,,,keiramore1,0,1,1,0,1,1,0,0,1,1,1,0
11219,,,anjarweeedua,0,1,1,0,1,1,0,0,1,1,1,0
11220,,,CSNCrowd,5,1,6,5,1,6,0.2,0.033436,0,0,0,0
11221,,,PacStandardTW,0,1,1,0,1,1,0,0,1,1,1,0
11222,,,verosies,0,1,1,0,1,1,0,0,1,1,1,0
11223,,,i_Scream6G,0,1,1,0,1,1,0,0,1,1,1,0
11224,,,stebniee,0,1,1,0,1,1,0,0,1,1,1,0
11225,,,studiogabli,2,1,3,2,1,3,0.5,0.013374,0,0,0,0
11226,,,taleamars,0,1,1,0,1,1,0,0,1,1,1,0
11227,,,reiichinose1,0,1,1,0,1,1,0,0,1,1,1,0
11228,,,olivia49433486,0,2,2,0,2,2,0,0,3,0.571429,0.708333,0
11229,,,tonymora52,0,2,2,0,2,2,0,0,1,1,1,0
11230,,,FuckFrancois,0,1,1,0,1,1,0,0,1,1,1,0
11231,,,_shtorrrka,0,1,1,0,1,1,0,0,1,1,1,0
11232,,,slip_stitch,0,1,1,0,1,1,0,0,1,1,1,0
11233,,,nyuheroes,0,1,1,0,1,1,0,0,1,1,1,0
11234,,,Jake_Seiner,0,1,1,0,1,1,0,0,1,1,1,0
11235,,,MagicSh46718476,0,1,1,0,1,1,0,0,1,1,1,0
11236,,,suzetterangel,3,1,4,3,1,4,0.333333,0.020061,0,0,0,0
11237,,,inmymind0,0,1,1,0,1,1,0,0,1,1,1,0
11238,,,evesully50,0,2,2,0,2,2,0,0,1,1,1,0
11239,,,horizonrry,0,1,1,0,1,1,0,0,2,0.571429,0.625,0
11240,,,_sunmoonstar_,0,1,1,0,1,1,0,0,2,0.571429,0.625,0
11241,,,hoseokzayn,0,1,1,0,1,1,0,0,2,0.571429,0.625,0
11242,,,kamponggirl87,0,1,1,0,1,1,0,0,2,0.571429,0.625,0
11243,,,jjk_biased01,0,1,1,0,1,1,0,0,2,0.571429,0.625,0
11244,,,erayeaa,0,1,1,0,1,1,0,0,2,0.571429,0.625,0
11245,,,MikeQuinlan5,0,1,1,0,1,1,0,0,2,0.571429,0.625,0
11246,,,nakyumist,1,2,3,1,2,3,0.5,0.006687,1,1,1,0
11247,,,claire_IDOL,6,1,7,6,1,7,0.166667,0.040123,0,0,0,0
11248,,,TwinklySoobin,0,1,1,0,1,1,0,0,1,1,1,0
11249,,,Donaldverger,0,1,1,0,1,1,0,0,1,1,1,0
11250,,,IDontSpeakWhine,0,2,2,0,2,2,0,0,2,0.75,0.833333,0
11251,,,ReginaPeele,0,1,1,0,1,1,0,0,1,1,1,0
11252,,,Bntruth1,0,1,1,0,1,1,0,0,1,1,1,0
11253,,,sparklyuzu,0,2,2,0,2,2,0,0,2,0.666667,0.75,0
11254,,,iamnikiforovs,0,1,1,0,1,1,0,0,2,0.6,0.666667,0
11255,,,softyuriko,0,1,1,0,1,1,0,0,2,0.6,0.666667,0
11256,,,mrrrrrrrr_r,0,1,1,0,1,1,0,0,2,0.6,0.666667,0
11257,,,_schuldig_fs,0,1,1,0,1,1,0,0,2,0.6,0.666667,0
11258,,,gguksmolly,0,1,1,0,1,1,0,0,2,0.6,0.666667,0
11259,,,NEWBJIN,27,1,28,27,1,28,0.037037,0.191036,0,0,0,0
11260,,,JackyChen1008,0,1,1,0,1,1,0,0,1,1,1,0
11261,,,camryn_2024,0,1,1,0,1,1,0,0,1,1,1,0
11262,,,DoubleWhitehous,0,1,1,0,1,1,0,0,1,1,1,0
11263,,,shashikantupadh,0,1,1,0,1,1,0,0,1,1,1,0
11264,,,kinj_e,0,1,1,0,1,1,0,0,1,1,1,0
11265,,,marshmyeonnie,0,1,1,0,1,1,0,0,1,1,1,0
11266,,,DAMIYERIM,0,1,1,0,1,1,0,0,1,1,1,0
11267,,,me10vely,0,2,2,0,2,2,0,0,1,1,1,0
11268,,,alittleninenai,0,1,1,0,1,1,0,0,1,1,1,0
11269,,,lomlreki,0,1,1,0,1,1,0,0,1,1,1,0
11270,,,yu_rion_zu,0,1,1,0,1,1,0,0,1,1,1,0
11271,,,An999oo,0,1,1,0,1,1,0,0,1,1,1,0
11272,,,RealGigiWilson,0,1,1,0,1,1,0,0,1,1,1,0
11273,,,Fromfarfaraway2,0,1,1,0,1,1,0,0,1,1,1,0
11274,,,JeffRoushPoetry,0,1,1,0,1,1,0,0,1,1,1,0
11275,,,awasemaru,0,1,1,0,1,1,0,0,1,1,1,0
11276,,,RandiKawakita,0,1,1,0,1,1,0,0,1,1,1,0
11277,,,Hyakki17,0,2,2,0,2,2,0,0,1,1,1,0
11278,,,norio__s,0,1,1,0,1,1,0,0,1,1,1,0
11279,,,uniccorn,0,1,1,0,1,1,0,0,1,1,1,0
11280,,,catboyuzuru,0,1,1,0,1,1,0,0,1,1,1,0
11281,,,yutaseviyorum,0,1,1,0,1,1,0,0,1,1,1,0
11282,,,aidyanixx,0,2,2,0,2,2,0,0,1,1,1,0
11283,,,dillidikudii,0,1,1,0,1,1,0,0,1,1,1,0
11284,,,fangkm31,0,1,1,0,1,1,0,0,1,1,1,0
11285,,,chileancarat,0,1,1,0,1,1,0,0,1,1,1,0
11286,,,Jenny60332258,0,1,1,0,1,1,0,0,1,1,1,0
11287,,,naminooto1106,0,1,1,0,1,1,0,0,1,1,1,0
11288,,,muqingzz,0,1,1,0,1,1,0,0,1,1,1,0
11289,,,TwaddleTwiter,0,1,1,0,1,1,0,0,1,1,1,0
11290,,,ultravioletraez,0,1,1,0,1,1,0,0,1,1,1,0
11291,,,Aarina63154672,0,1,1,0,1,1,0,0,1,1,1,0
11292,,,blueraindr0ps,0,1,1,0,1,1,0,0,1,1,1,0
11293,,,DEIDigest,0,1,1,0,1,1,0,0,1,1,1,0
11294,,,bellllxo,0,1,1,0,1,1,0,0,1,1,1,0
11295,,,sadbea_,0,1,1,0,1,1,0,0,1,1,1,0
11296,,,animalfarm1984a,0,1,1,0,1,1,0,0,1,1,1,0
11297,,,solarhyuck,0,1,1,0,1,1,0,0,1,1,1,0
11298,,,kyungkyll,3,2,5,3,2,5,0.25,0.020061,1,1,1,2
11299,,,AKIHOLlC,10,1,11,10,1,11,0.1,0.066871,0,0,0,0
11300,,,pucca182,0,2,2,0,2,2,0,0,1,1,1,0
11301,,,tacoda00,0,1,1,0,1,1,0,0,1,1,1,0
11302,,,CanadaSaysStop,0,1,1,0,1,1,0,0,1,1,1,0
11303,,,mikeykashi,0,1,1,0,1,1,0,0,1,1,1,0
11304,,,larryspeck9,0,1,1,0,1,1,0,0,1,1,1,0
11305,,,onsunday1028,0,1,1,0,1,1,0,0,1,1,1,0
11306,,,poohsan9405,0,1,1,0,1,1,0,0,1,1,1,0
11307,,,SoFarAwake7,0,1,1,0,1,1,0,0,1,1,1,0
11308,,,kristellvision,0,1,1,0,1,1,0,0,1,1,1,0
11309,,,btsEMx,0,1,1,0,1,1,0,0,1,1,1,0
11310,,,UGH_Marr,0,1,1,0,1,1,0,0,1,1,1,0
11311,,,Yuzu1207ru,0,1,1,0,1,1,0,0,1,1,1,0
11312,,,naonaove,0,1,1,0,1,1,0,0,1,1,1,0
11313,,,Charlot91872975,0,1,1,0,1,1,0,0,1,1,1,0
11314,,,xRecchanx,0,1,1,0,1,1,0,0,1,1,1,0
11315,,,Tree4justice,0,1,1,0,1,1,0,0,1,1,1,0
11316,,,comeg12,0,1,1,0,1,1,0,0,1,1,1,0
11317,,,ffxxxxng,0,1,1,0,1,1,0,0,1,1,1,0
11318,,,KayHenggeler,0,1,1,0,1,1,0,0,1,1,1,0
11319,,,_sunnydress_,0,1,1,0,1,1,0,0,1,1,1,0
11320,,,JLee_us,0,1,1,0,1,1,0,0,1,1,1,0
11321,,,KdflickDonna,0,1,1,0,1,1,0,0,1,1,1,0
11322,,,Hoeshi33,0,1,1,0,1,1,0,0,1,1,1,0
11323,,,weiping_du,0,1,1,0,1,1,0,0,1,1,1,0
11324,,,scroggie24,0,1,1,0,1,1,0,0,1,1,1,0
11325,,,vthkjk,0,1,1,0,1,1,0,0,1,1,1,0
11326,,,DianeBizier,0,1,1,0,1,1,0,0,1,1,1,0
11327,,,marcosmontilla,0,1,1,0,1,1,0,0,1,1,1,0
11328,,,pyrores,0,1,1,0,1,1,0,0,1,1,1,0
11329,,,andyjshultz,0,1,1,0,1,1,0,0,1,1,1,0
11330,,,NoKommen,0,2,2,0,2,2,0,0,1,1,1,0
11331,,,realTgirlshit,0,1,1,0,1,1,0,0,1,1,1,0
11332,,,Phillipmuliisa,16,1,17,17,1,18,0.0625,0.173385,0,0,0,0
11333,,,YunHaRin1,0,1,1,0,1,1,0,0,1,1,1,0
11334,,,TAEYE0NCATGIRL,0,1,1,0,1,1,0,0,1,1,1,0
11335,,,ck1809kc,0,1,1,0,1,1,0,0,1,1,1,0
11336,,,Witch_veil,0,1,1,0,1,1,0,0,1,1,1,0
11337,,,MarcusGMay1,0,1,1,0,1,1,0,0,1,1,1,0
11338,,,ProcrasinBean,0,1,1,0,1,1,0,0,1,1,1,0
11339,,,_ruu_ruu_,0,1,1,0,1,1,0,0,1,1,1,0
11340,,,rdentlove,0,1,1,0,1,1,0,0,1,1,1,0
11341,,,madeleine_OR,0,1,1,0,1,1,0,0,1,1,1,0
11342,,,sillenths,0,1,1,0,1,1,0,0,1,1,1,0
11343,,,jihowol,8,1,9,8,1,9,0.125,0.053497,0,0,0,0
11344,,,mandydugan,0,1,1,0,1,1,0,0,1,1,1,0
11345,,,Henrygissing,0,1,1,0,1,1,0,0,1,1,1,0
11346,,,majesdani,0,1,1,0,1,1,0,0,1,1,1,0
11347,,,4everg6,0,1,1,0,1,1,0,0,1,1,1,0
11348,,,JustVIP_OT5,0,1,1,0,1,1,0,0,1,1,1,0
11349,,,CurlySueChick19,5,1,6,5,1,6,0.2,0.033436,0,0,0,0
11350,,,deemrlo,0,1,1,0,1,1,0,0,1,1,1,0
11351,,,worldwidetwink,0,1,1,0,1,1,0,0,1,1,1,0
11352,,,cobrien2020,0,1,1,0,1,1,0,0,1,1,1,0
11353,,,kaepussy,0,1,1,0,1,1,0,0,4,0.37037,0.433333,0
11354,,,machidaandmeeco,0,1,1,0,1,1,0,0,4,0.37037,0.433333,0
11355,,,dilfzhongli_,0,1,1,0,1,1,0,0,4,0.37037,0.433333,0
11356,,,issupremapcy,0,1,1,0,1,1,0,0,4,0.37037,0.433333,0
11357,,,softkikker,1,1,2,1,1,2,0,0.006687,0,0,0,0
11358,,,jientho,0,1,1,0,1,1,0,0,2,0.666667,0.75,0
11359,,,kelli_king66,0,1,1,0,1,1,0,0,2,0.666667,0.75,0
11360,,,NeoMagentaPeach,0,1,1,0,1,1,0,0,2,0.666667,0.75,0
11361,,,GottschalkJune,0,1,1,0,1,1,0,0,2,0.666667,0.75,0
11362,,,tucolayesta,0,1,1,0,1,1,0,0,2,0.666667,0.75,0
11363,,,jamiemayres,0,1,1,0,1,1,0,0,2,0.666667,0.75,0
11364,,,jandoe23,0,1,1,0,1,1,0,0,2,0.666667,0.75,0
11365,,,upilsultann,0,1,1,0,1,1,0,0,2,0.666667,0.75,0
11366,,,QuitmanStephens,0,2,2,0,2,2,0,0,1,1,1,0
11367,,,CJujuThePotatoe,0,1,1,0,1,1,0,0,1,1,1,0
11368,,,inkigayoes,1,1,2,1,1,2,0,0.006687,0,0,0,0
11369,,,Enterta52735412,5,1,6,5,1,6,0.2,0.033436,0,0,0,0
11370,,,2015_flover,0,1,1,0,1,1,0,0,1,1,1,0
11371,,,TheFebrileMuse,0,1,1,0,1,1,0,0,1,1,1,0
11372,,,davidgodfrey,0,1,1,0,1,1,0,0,1,1,1,0
11373,,,Notisia365,1,1,2,1,1,2,0,0.006687,0,0,0,0
11374,,,chimcia,0,1,1,0,1,1,0,0,1,1,1,0
11375,,,MarotSeoane,0,1,1,0,1,1,0,0,1,1,1,0
11376,,,icecue,0,1,1,0,1,1,0,0,1,1,1,0
11377,,,HeardAndrew,5,1,6,5,1,6,0.2,0.033436,0,0,0,0
11378,,,kimseokje_anne,0,1,1,0,1,1,0,0,1,1,1,0
11379,,,honeyheIios,4,1,5,4,1,5,0.25,0.026749,0,0,0,0
11380,,,JoanB55,0,1,1,0,1,1,0,0,1,1,1,0
11381,,,galaxyz39planet,0,1,1,0,1,1,0,0,1,1,1,0
11382,,,SarahMya2000,0,1,1,0,1,1,0,0,1,1,1,0
11383,,,shajraa_zakii,0,2,2,0,2,2,0,0,1,1,1,0
11384,,,sugatingz,0,1,1,0,1,1,0,0,1,1,1,0
11385,,,booxercla,0,1,1,0,1,1,0,0,1,1,1,0
11386,,,yutakupon128,0,1,1,0,1,1,0,0,1,1,1,0
11387,,,kamishikana,0,1,1,0,1,1,0,0,1,1,1,0
11388,,,moonchpromisejm,0,1,1,0,1,1,0,0,1,1,1,0
11389,,,MichelleGuzzy,0,1,1,0,1,1,0,0,1,1,1,0
11390,,,khrxz_,0,1,1,0,1,1,0,0,1,1,1,0
11391,,,colleenpierrerd,0,1,1,0,1,1,0,0,1,1,1,0
11392,,,PPedrotty,0,1,1,0,1,1,0,0,1,1,1,0
11393,,,muich7ro,3,1,4,3,1,4,0.333333,0.020061,0,0,0,0
11394,,,Hibiki_andante,0,1,1,0,1,1,0,0,1,1,1,0
11395,,,Lindsayvt12Van,5,1,6,5,1,6,0.2,0.033436,0,0,0,0
11396,,,yuutafies,0,1,1,0,1,1,0,0,1,1,1,0
11397,,,realbtsjjin,0,1,1,0,1,1,0,0,1,1,1,0
11398,,,wujujiangshan,0,1,1,0,1,1,0,0,1,1,1,0
11399,,,seniorstllalive,0,3,3,0,3,3,0,0,1,1,1,0
11400,,,PriceAtkinson,6,1,7,6,1,7,0.166667,0.040123,0,0,0,0
11401,,,Ethereal_anja,0,1,1,0,1,1,0,0,1,1,1,0
11402,,,ughkiiwwii,0,1,1,0,1,1,0,0,1,1,1,0
11403,,,kingkoheii,0,1,1,0,1,1,0,0,1,1,1,0
11404,,,arclightwizone,0,1,1,0,1,1,0,0,1,1,1,0
11405,,,FMorningtea,0,1,1,0,1,1,0,0,1,1,1,0
11406,,,goodnews,1,1,2,1,1,2,0,0.006687,0,0,0,0
11407,,,HPAsianVoices,1,1,2,1,1,2,0,0.006687,0,0,0,0
11408,,,HuffPostEnt,22,1,23,22,1,23,0.045455,0.147117,0,0,0,0
11409,,,misskitty305,0,1,1,0,1,1,0,0,1,1,1,0
11410,,,tetsuyannie,0,1,1,0,1,1,0,0,1,1,1,0
11411,,,Elsie_Mandel,0,1,1,0,1,1,0,0,1,1,1,0
11412,,,jewelisima,0,1,1,0,1,1,0,0,1,1,1,0
11413,,,lovecean,0,1,1,0,1,1,0,0,1,1,1,0
11414,,,outroick,0,1,1,0,1,1,0,0,1,1,1,0
11415,,,yukinya_0,0,1,1,0,1,1,0,0,1,1,1,0
11416,,,LAtodayy,0,1,1,0,1,1,0,0,1,1,1,0
11417,,,wouldienyway,0,1,1,0,1,1,0,0,1,1,1,0
11418,,,JINNlEMOON,0,1,1,0,1,1,0,0,1,1,1,0
11419,,,mayutlp,0,1,1,0,1,1,0,0,1,1,1,0
11420,,,tiffanyjavines,0,1,1,0,1,1,0,0,1,1,1,0
11421,,,babiegushi,0,1,1,0,1,1,0,0,1,1,1,0
11422,,,hokiurina,0,1,1,0,1,1,0,0,1,1,1,0
11423,,,xMeliodas,0,1,1,0,1,1,0,0,1,1,1,0
11424,,,SurfSideSams,0,1,1,0,1,1,0,0,1,1,1,0
11425,,,X7Aak,0,1,1,0,1,1,0,0,1,1,1,0
11426,,,deathtocrazy,0,1,1,0,1,1,0,0,1,1,1,0
11427,,,yo_ice_b,0,1,1,0,1,1,0,0,1,1,1,0
11428,,,adabagcompany,2,1,3,2,1,3,0.5,0.013374,0,0,0,0
11429,,,OhJustTalk,0,1,1,0,1,1,0,0,1,1,1,0
11430,,,HsvTribune,1,1,2,1,1,2,0,0.006687,0,0,0,0
11431,,,hounddogxx101,11,1,12,12,1,13,0.090909,0.073559,0,0,0,0
11432,,,relaxming,0,1,1,0,1,1,0,0,1,1,1,0
11433,,,joonieemoonie,0,1,1,0,1,1,0,0,1,1,1,0
11434,,,InyxStyx,0,1,1,0,1,1,0,0,1,1,1,0
11435,,,utokkisluv,0,1,1,0,2,2,0,0,1,1,1,0
11436,,,furrycbg,0,1,1,0,1,1,0,0,1,1,1,0
11437,,,showmstgon,0,1,1,0,1,1,0,0,1,1,1,0
11438,,,masakidaniel,0,1,1,0,1,1,0,0,1,1,1,0
11439,,,hamster_gangsta,0,1,1,0,1,1,0,0,1,1,1,0
11440,,,andyz,0,3,3,0,3,3,0,0,1,1,1,0
11441,,,DavidPepper,0,1,1,0,1,1,0,0,1,1,1,0
11442,,,eliehonig,1,1,2,1,1,2,0,0.006687,0,0,0,0
11443,,,sehunnieday,0,1,1,0,1,1,0,0,1,1,1,0
11444,,,shubblehead,0,1,1,0,1,1,0,0,1,1,1,0
11445,,,meli16339,0,1,1,0,1,1,0,0,1,1,1,0
11446,,,mochimin_98,0,1,1,0,1,1,0,0,1,1,1,0
11447,,,4MEDLEN,0,2,2,0,2,2,0,0,1,1,1,0
11448,,,dorami_36,0,1,1,0,1,1,0,0,1,1,1,0
11449,,,namyukika,0,1,1,0,1,1,0,0,1,1,1,0
11450,,,lostinjnk13,0,1,1,0,1,1,0,0,1,1,1,0
11451,,,Balnagown,1,1,2,1,1,2,0,0.006687,0,0,0,0
11452,,,mikajones,8,1,9,8,1,9,0.125,0.053497,0,0,0,0
11453,,,mangoilango,0,1,1,0,1,1,0,0,1,1,1,0
11454,,,mayriella,0,1,1,0,1,1,0,0,1,1,1,0
11455,,,RamosLilee,0,1,1,0,1,1,0,0,1,1,1,0
11456,,,sakiiiiiiiiiii,0,1,1,0,1,1,0,0,1,1,1,0
11457,,,wangxianIovebot,11,2,13,11,2,13,0.083333,0.073559,1,1,1,10
11458,,,Blubaycrab,0,1,1,0,1,1,0,0,2,0.666667,0.75,0
11459,,,stewartswuxian,0,1,1,0,1,1,0,0,2,0.666667,0.75,0
11460,,,ZNantin,0,1,1,0,1,1,0,0,2,0.666667,0.75,0
11461,,,ABCHAMP11,0,1,1,0,1,1,0,0,2,0.666667,0.75,0
11462,,,soaptsukare,0,1,1,0,1,1,0,0,2,0.666667,0.75,0
11463,,,myg_vante,0,1,1,0,1,1,0,0,2,0.666667,0.75,0
11464,,,hobiseeds,5,1,6,5,1,6,0.2,0.03693,0,0,0,0
11465,,,crazyclownshire,0,1,1,0,1,1,0,0,1,1,1,0
11466,,,luvkmw,0,1,1,0,1,1,0,0,1,1,1,0
11467,,,R5Tnfau9H0EsQp7,0,1,1,0,1,1,0,0,1,1,1,0
11468,,,hasunomizu,1,1,2,1,1,2,0,0.006687,0,0,0,0
11469,,,dkahn369,2,1,3,2,1,3,0.5,0.013374,0,0,0,0
11470,,,sawadaraken,0,1,1,0,1,1,0,0,1,1,1,0
11471,,,klcrying,3,1,4,3,1,4,0.333333,0.020061,0,0,0,0
11472,,,baegsaegsoeum,0,1,1,0,1,1,0,0,1,1,1,0
11473,,,BlackfootTuxedo,1,1,2,1,1,2,0,0.006687,0,0,0,0
11474,,,kaebits,3,1,4,3,1,4,0.333333,0.020061,0,0,0,0
11475,,,jenrobertson2o2,13,1,14,13,1,14,0.076923,0.093921,0,0,0,0
11476,,,astroseok,0,1,1,0,1,1,0,0,1,1,1,0
11477,,,walbeRRRRR,0,1,1,0,1,1,0,0,1,1,1,0
11478,,,judy_snook,0,1,1,0,1,1,0,0,1,1,1,0
11479,,,RickyG_TV,0,1,1,0,1,1,0,0,1,1,1,0
11480,,,baekbyunpuppy,0,1,1,0,1,1,0,0,1,1,1,0
11481,,,Snowsv,0,2,2,0,2,2,0,0,2,0.666667,0.75,0
11482,,,SoobiesBingsoo,0,2,2,0,2,2,0,0,1,1,1,0
11483,,,_no_difference_,0,1,1,0,1,1,0,0,1,1,1,0
11484,,,caixin,1,1,2,1,1,2,0,0.006687,0,0,0,0
11485,,,masudakaoridayo,0,1,1,0,1,1,0,0,1,1,1,0
11486,,,rossxlie,0,1,1,0,1,1,0,0,1,1,1,0
11487,,,twosetowo,0,1,1,0,1,1,0,0,1,1,1,0
11488,,,SlDORKOVA,0,1,1,0,1,1,0,0,1,1,1,0
11489,,,LintheCow,0,1,1,0,1,1,0,0,1,1,1,0
11490,,,0431renjun,1,1,2,1,1,2,0,0.006687,0,0,0,0
11491,,,KarlinhadeGusu,0,1,1,0,1,1,0,0,2,0.666667,0.75,0
11492,,,Kondrk_lamar,0,1,1,0,1,1,0,0,2,0.666667,0.75,0
11493,,,mendelphobia,0,1,1,0,1,1,0,0,2,0.666667,0.75,0
11494,,,Lynnjmd,0,1,1,0,1,1,0,0,5,0.43662,0.474194,0
11495,,,Huriye,0,1,1,0,1,1,0,0,5,0.43662,0.474194,0
11496,,,RO12_MINI_01,0,1,1,0,1,1,0,0,5,0.43662,0.474194,0
11497,,,d9U7nsDuFn3tmGF,0,1,1,0,1,1,0,0,5,0.43662,0.474194,0
11498,,,tassvic,0,1,1,0,1,1,0,0,5,0.43662,0.474194,0
11499,,,GreenMerdragon,0,1,1,0,1,1,0,0,5,0.43662,0.474194,0
11500,,,KungLin5,0,1,1,0,1,1,0,0,5,0.43662,0.474194,0
11501,,,BanglaViral,9,1,10,9,1,10,0.111111,0.060184,0,0,0,0
11502,,,LLuche,0,1,1,0,1,1,0,0,1,1,1,0
11503,,,kaiyazold,0,1,1,0,1,1,0,0,1,1,1,0
11504,,,fchaumac_chau,0,1,1,0,1,1,0,0,1,1,1,0
11505,,,passionario,0,1,1,0,1,1,0,0,1,1,1,0
11506,,,ellenipvenbrr,0,1,1,0,1,1,0,0,1,1,1,0
11507,,,jicho2724ech,0,1,1,0,1,1,0,0,1,1,1,0
11508,,,ryouuuuuy,0,1,1,0,1,1,0,0,1,1,1,0
11509,,,small1ldy1,0,1,1,0,1,1,0,0,1,1,1,0
11510,,,__OCD,0,1,1,0,1,1,0,0,1,1,1,0
11511,,,royaItannie,0,1,1,0,1,1,0,0,1,1,1,0
11512,,,aka_nathanshine,0,1,1,0,1,1,0,0,1,1,1,0
11513,,,Sakura_d1sk,0,1,1,0,1,1,0,0,1,1,1,0
11514,,,cielongin,0,1,1,0,1,1,0,0,1,1,1,0
11515,,,prvdeoly,0,2,2,0,2,2,0,0,1,1,1,0
11516,,,ashlynndfields,0,1,1,0,1,1,0,0,1,1,1,0
11517,,,nessamegh,0,1,1,0,2,2,0,0,1,1,1,0
11518,,,mygghost,4,1,5,4,1,5,0.25,0.026749,0,0,0,0
11519,,,ojaio_oni_chan,0,1,1,0,1,1,0,0,1,1,1,0
11520,,,tsukiyominoasa,11,1,12,11,1,12,0.090909,0.084041,0,0,0,0
11521,,,blin27k,0,1,1,0,1,1,0,0,1,1,1,0
11522,,,ksanada,0,1,1,0,1,1,0,0,1,1,1,0
11523,,,nedenburdaysam,0,1,1,0,1,1,0,0,1,1,1,0
11524,,,CarmenPilar26,0,1,1,0,1,1,0,0,1,1,1,0
11525,,,Eternally7luv,0,1,1,0,1,1,0,0,1,1,1,0
11526,,,jaybkev,0,1,1,0,1,1,0,0,1,1,1,0
11527,,,fildfai,0,1,1,0,1,1,0,0,1,1,1,0
11528,,,redfoxbluebear,0,1,1,0,1,1,0,0,1,1,1,0
11529,,,gregory_greg_,0,1,1,0,1,1,0,0,1,1,1,0
11530,,,etxrnallyjoons,0,1,1,0,1,1,0,0,1,1,1,0
11531,,,VintageEdges,1,1,2,1,1,2,0,0.006687,0,0,0,0
11532,,,Prof_Chadwick,1,1,2,1,1,2,0,0.006687,0,0,0,0
11533,,,flwrvmins,0,1,1,0,1,1,0,0,2,0.666667,0.75,0
11534,,,9HSuxAl1h2Laro5,8,1,9,8,1,9,0.125,0.053497,0,0,0,0
11535,,,vintshiho,0,1,1,0,1,1,0,0,1,1,1,0
11536,,,moonjinnie__,0,1,1,0,1,1,0,0,1,1,1,0
11537,,,YellowishKanra,0,1,1,0,1,1,0,0,1,1,1,0
11538,,,DAYAN0517,0,1,1,0,1,1,0,0,1,1,1,0
11539,,,bts__ot7love,0,1,1,0,1,1,0,0,1,1,1,0
11540,,,joaomcrodrigues,5,1,6,6,2,8,0.2,0.033436,0,0,0,0
11541,,,Di_Artiki,0,1,1,0,1,1,0,0,1,1,1,0
11542,,,fedguga1,0,1,1,0,1,1,0,0,1,1,1,0
11543,,,starfishhost1,3,1,4,3,1,4,0.333333,0.030544,0,0,0,0
11544,,,BBYFL3UR,3,3,6,3,3,6,0.2,0.020061,1,1,1,4
11545,,,bl_kdrama,0,1,1,0,1,1,0,0,1,1,1,0
11546,,,madmadds_07,0,1,1,0,1,1,0,0,1,1,1,0
11547,,,EricPer94077700,7,1,8,8,2,10,0.142857,0.057293,0,0,0,0
11548,,,peteraclarkson,0,1,1,0,1,1,0,0,1,1,1,0
11549,,,peace1,0,1,1,0,1,1,0,0,1,1,1,0
11550,,,Walantea11,0,1,1,0,1,1,0,0,2,0.6,0.666667,0
11551,,,btsatrix,0,1,1,0,1,1,0,0,2,0.6,0.666667,0
11552,,,c1010lie,0,1,1,0,1,1,0,0,1,1,1,0
11553,,,jongincholo,0,1,1,0,1,1,0,0,1,1,1,0
11554,,,halohalohobi,0,2,2,0,2,2,0,0,1,1,1,0
11555,,,sgkoyuasg1024,0,1,1,0,1,1,0,0,1,1,1,0
11556,,,terronII,0,1,1,0,1,1,0,0,1,1,1,0
11557,,,TaYPLBzgl299wEp,0,1,1,0,1,1,0,0,1,1,1,0
11558,,,shawtybaetaee,0,1,1,0,1,1,0,0,1,1,1,0
11559,,,jiggukfairyy,0,1,1,0,1,1,0,0,1,1,1,0
11560,,,Telphoussa,0,1,1,0,1,1,0,0,1,1,1,0
11561,,,ChristineWesl18,1,1,2,1,1,2,0,0.006687,0,0,0,0
11562,,,carat_wooahae,0,1,1,0,1,1,0,0,2,0.666667,0.75,0
11563,,,inneryoonie,0,1,1,0,1,1,0,0,2,0.666667,0.75,0
11564,,,Lisa_Angel20,0,1,1,0,1,1,0,0,2,0.666667,0.75,0
11565,,,panshi7,0,1,1,0,1,1,0,0,2,0.666667,0.75,0
11566,,,PrincessBravato,0,1,1,0,1,1,0,0,2,0.666667,0.75,0
11567,,,Listofthings1,0,1,1,0,1,1,0,0,2,0.666667,0.75,0
11568,,,Zuzuzuz47728801,0,1,1,0,1,1,0,0,2,0.666667,0.75,0
11569,,,wsls,6,1,7,7,2,9,0.166667,0.040123,0,0,0,0
11570,,,susiem_01,0,1,1,0,1,1,0,0,1,1,1,0
11571,,,kathlovesyeol,0,1,1,0,1,1,0,0,1,1,1,0
11572,,,yzmpoo1,0,1,1,0,1,1,0,0,1,1,1,0
11573,,,Gunny_Loki,0,1,1,0,1,1,0,0,1,1,1,0
11574,,,rinrainy_,0,1,1,0,1,1,0,0,1,1,1,0
11575,,,lonegamer78,0,1,1,0,1,1,0,0,1,1,1,0
11576,,,YA3MiK0,0,1,1,0,1,1,0,0,1,1,1,0
11577,,,___bbing,0,3,3,0,3,3,0,0,1,1,1,0
11578,,,TracyTcleve,0,1,1,0,1,1,0,0,1,1,1,0
11579,,,ApraezGiovanni,0,1,1,0,1,1,0,0,1,1,1,0
11580,,,shirou99_kun,0,1,1,0,1,1,0,0,1,1,1,0
11581,,,ranran_skate,0,1,1,0,1,1,0,0,1,1,1,0
11582,,,yuzurinta1207,0,1,1,0,1,1,0,0,1,1,1,0
11583,,,DavidBa97762856,0,1,1,0,1,1,0,0,1,1,1,0
11584,,,w1_nct04,0,1,1,0,1,1,0,0,1,1,1,0
11585,,,gambarum,0,1,1,0,1,1,0,0,1,1,1,0
11586,,,inc_brands,9,1,10,9,1,10,0.111111,0.060184,0,0,0,0
11587,,,lim_singa,0,1,1,0,1,1,0,0,1,1,1,0
11588,,,momoqoolove,0,1,1,0,1,1,0,0,1,1,1,0
11589,,,glowy_wangji,0,1,1,0,1,1,0,0,1,1,1,0
11590,,,VORESANZ,0,1,1,0,1,1,0,0,1,1,1,0
11591,,,maiaxeliz,0,1,1,0,1,1,0,0,1,1,1,0
11592,,,jinlexious,0,1,1,0,1,1,0,0,1,1,1,0
11593,,,anangelwillfly,0,2,2,0,2,2,0,0,1,1,1,0
11594,,,yuzu__12072119,0,1,1,0,1,1,0,0,1,1,1,0
11595,,,KaraAiello,0,1,1,0,1,1,0,0,1,1,1,0
11596,,,CedricNettles,6,1,7,6,1,7,0.166667,0.040123,0,0,0,0
11597,,,maisadhoers,0,1,1,0,1,1,0,0,1,1,1,0
11598,,,temporair_e,0,1,1,0,1,1,0,0,1,1,1,0
11599,,,chimddung,0,1,1,0,1,1,0,0,1,1,1,0
11600,,,Jerode158869742,0,1,1,0,1,1,0,0,1,1,1,0
11601,,,2d56,7,1,8,7,1,8,0.142857,0.04681,0,0,0,0
11602,,,davresty,0,2,2,0,2,2,0,0,1,1,1,0
11603,,,pinkbIades,0,1,1,0,1,1,0,0,1,1,1,0
11604,,,mizuresan,0,1,1,0,1,1,0,0,1,1,1,0
11605,,,wanwan_pakkun,0,1,1,0,1,1,0,0,1,1,1,0
11606,,,tweetShanghai,0,1,1,0,1,1,0,0,1,1,1,0
11607,,,Aaron56439897,2,1,3,2,1,3,0.5,0.013374,0,0,0,0
11608,,,rakaxiusbfg,0,1,1,0,1,1,0,0,1,1,1,0
11609,,,T3N_ultMK,0,1,1,0,1,1,0,0,1,1,1,0
11610,,,JELLY_0402,0,1,1,0,1,1,0,0,1,1,1,0
11611,,,caroo_,0,1,1,0,1,1,0,0,1,1,1,0
11612,,,heysepii,0,1,1,0,1,1,0,0,1,1,1,0
11613,,,Blacksk1710,0,1,1,0,1,1,0,0,1,1,1,0
11614,,,_cocoira_,0,1,1,0,1,1,0,0,1,1,1,0
11615,,,ni_na_yz,0,1,1,0,1,1,0,0,1,1,1,0
11616,,,mymaiyi,0,1,1,0,1,1,0,0,1,1,1,0
11617,,,Moreapes,5,1,6,5,1,6,0.2,0.033436,0,0,0,0
11618,,,satosugurism,0,2,2,0,2,2,0,0,1,1,1,0
11619,,,rsmale,0,1,1,0,1,1,0,0,1,1,1,0
11620,,,hanakohanako151,0,1,1,0,1,1,0,0,1,1,1,0
11621,,,ciao_chie,0,1,1,0,1,1,0,0,1,1,1,0
11622,,,PawinHand1,0,1,1,0,1,1,0,0,1,1,1,0
11623,,,di_sov,0,1,1,0,1,1,0,0,1,1,1,0
11624,,,jzoppiphd,0,1,1,0,1,1,0,0,1,1,1,0
11625,,,sansamoura,0,1,1,0,1,1,0,0,1,1,1,0
11626,,,caonimabi120,0,3,3,0,3,3,0,0,1,1,1,0
11627,,,emma_trevelyan,12,1,13,13,1,14,0.083333,0.399025,0,0,0,0
11628,,,kensherman902,0,1,1,0,1,1,0,0,1,1,1,0
11629,,,dokukaiko,0,1,1,0,1,1,0,0,1,1,1,0
11630,,,Fastest_Losers,0,1,1,0,2,2,0,0,1,1,1,0
11631,,,barrosomelania,0,1,1,0,1,1,0,0,1,1,1,0
11632,,,yu610127,0,1,1,0,1,1,0,0,1,1,1,0
11633,,,SE0NGWH4T,0,2,2,0,2,2,0,0,1,1,1,0
11634,,,JOONSL0VER,0,1,1,0,1,1,0,0,1,1,1,0
11635,,,anulek_,0,1,1,0,1,1,0,0,1,1,1,0
11636,,,SusanUSC,1,1,2,1,1,2,0,0.006687,0,0,0,0
11637,,,staningmyloves,2,1,3,2,1,3,0.5,0.013374,0,0,0,0
11638,,,nadyingg,0,1,1,0,1,1,0,0,1,1,1,0
11639,,,ChubbyChub216,13,1,14,13,1,14,0.076923,0.090427,0,0,0,0
11640,,,ppkieee,0,1,1,0,1,1,0,0,1,1,1,0
11641,,,pjmfilter7,0,1,1,0,1,1,0,0,1,1,1,0
11642,,,grape_eating,0,1,1,0,1,1,0,0,1,1,1,0
11643,,,alwaysloveloona,0,1,1,0,1,1,0,0,1,1,1,0
11644,,,yhpjew,0,1,1,0,1,1,0,0,1,1,1,0
11645,,,porgavenger,0,1,1,0,1,1,0,0,1,1,1,0
11646,,,withinthedream,0,1,1,0,1,1,0,0,1,1,1,0
11647,,,josukessy,0,1,1,0,1,1,0,0,1,1,1,0
11648,,,mokkafc,0,1,1,0,1,1,0,0,1,1,1,0
11649,,,mrs_kimV_1,0,1,1,0,1,1,0,0,1,1,1,0
11650,,,oooootitleottsc,0,1,1,0,1,1,0,0,1,1,1,0
11651,,,slumberalien,0,1,1,0,1,1,0,0,1,1,1,0
11652,,,MIMlBangtan,0,1,1,0,1,1,0,0,1,1,1,0
11653,,,Jessjing1207,0,1,1,0,1,1,0,0,1,1,1,0
11654,,,cheolsaur,0,1,1,0,1,1,0,0,1,1,1,0
11655,,,cassmusngi,0,1,1,0,1,1,0,0,1,1,1,0
11656,,,TangerineJu1,0,1,1,0,1,1,0,0,1,1,1,0
11657,,,Aicila_25,0,2,2,0,2,2,0,0,3,0.484848,0.53125,0
11658,,,fox43,0,1,1,0,1,1,0,0,1,1,1,0
11659,,,Lumos84829207,0,1,1,0,1,1,0,0,1,1,1,0
11660,,,y_shibuko,0,1,1,0,1,1,0,0,1,1,1,0
11661,,,cccmizuno,0,1,1,0,1,1,0,0,1,1,1,0
11662,,,Joellenhale4,0,1,1,0,1,1,0,0,1,1,1,0
11663,,,RoverMack,0,1,1,0,1,1,0,0,1,1,1,0
11664,,,hunter55771,0,1,1,0,1,1,0,0,1,1,1,0
11665,,,tori_zero09,0,1,1,0,1,1,0,0,1,1,1,0
11666,,,tktk_5296_love,0,1,1,0,1,1,0,0,1,1,1,0
11667,,,iroonhome,6,1,7,6,1,7,0.166667,0.040123,0,0,0,0
11668,,,kozukakazuko,0,1,1,0,1,1,0,0,1,1,1,0
11669,,,gcb973,0,1,1,0,1,1,0,0,1,1,1,0
11670,,,nemoevk,0,1,1,0,1,1,0,0,1,1,1,0
11671,,,solarierudite,1,1,2,1,1,2,0,0.006687,0,0,0,0
11672,,,ayachan1617,4,1,5,4,1,5,0.25,0.026749,0,0,0,0
11673,,,EvGardner,0,1,1,0,1,1,0,0,1,1,1,0
11674,,,padaanpotpot,0,1,1,0,1,1,0,0,1,1,1,0
11675,,,maemyghai,0,2,2,0,2,2,0,0,1,1,1,0
11676,,,123_sunshinee,0,1,1,0,1,1,0,0,1,1,1,0
11677,,,MoonJinnie7,0,1,1,0,1,1,0,0,1,1,1,0
11678,,,CEOofTrustIssue,0,1,1,0,1,1,0,0,1,1,1,0
11679,,,booitsgarfield,0,1,1,0,1,1,0,0,1,1,1,0
11680,,,JaeyaTansin,7,1,8,7,1,8,0.142857,0.04681,0,0,0,0
11681,,,kinoko3670,0,1,1,0,1,1,0,0,1,1,1,0
11682,,,viavytsychill,0,1,1,0,1,1,0,0,1,1,1,0
11683,,,Pikabloo,0,1,1,0,1,1,0,0,1,1,1,0
11684,,,purplewalwal,0,1,1,0,1,1,0,0,1,1,1,0
11685,,,qnohoonji,0,1,1,0,1,1,0,0,1,1,1,0
11686,,,PTW_18,0,1,1,0,1,1,0,0,1,1,1,0
11687,,,horsebackwaffle,0,1,1,0,1,1,0,0,1,1,1,0
11688,,,laurooru,0,1,1,0,1,1,0,0,1,1,1,0
11689,,,mmmday6stan,0,1,1,0,1,1,0,0,1,1,1,0
11690,,,jsyche,4,1,5,4,1,5,0.25,0.026749,0,0,0,0
11691,,,mschill86,0,1,1,0,1,1,0,0,1,1,1,0
11692,,,_241018,0,1,1,0,1,1,0,0,1,1,1,0
11693,,,motsjoon,0,1,1,0,1,1,0,0,1,1,1,0
11694,,,wjxt4,4,1,5,4,1,5,0.25,0.026749,0,0,0,0
11695,,,mortalreading,0,2,2,0,2,2,0,0,1,1,1,0
11696,,,idlesbitch,0,2,2,0,2,2,0,0,3,0.571429,0.708333,0
11697,,,VCPHoops,2,1,3,2,1,3,0.5,0.013374,0,0,0,0
11698,,,lesbianpoesie,0,1,1,0,1,1,0,0,1,1,1,0
11699,,,NewsTube16,2,1,3,2,1,3,0.5,0.024249,0,0,0,0
11700,,,rzhongnotes,8,2,10,8,2,10,0.111111,0.060486,2,0.666667,0.75,16
11701,,,babielili_,0,1,1,0,1,1,0,0,3,0.5,0.611111,0
11702,,,impmj21,0,1,1,0,1,1,0,0,3,0.5,0.611111,0
11703,,,commiegender,0,1,1,0,1,1,0,0,3,0.5,0.611111,0
11704,,,10blockstorun,0,3,3,0,3,3,0,0,3,0.625,0.766667,0
11705,,,picassoc,10,1,11,11,2,13,0.1,0.135461,0,0,0,0
11706,,,pissboymurphy,0,2,2,0,2,2,0,0,2,0.75,0.833333,0
11707,,,kettleinspace,0,1,1,0,1,1,0,0,1,1,1,0
11708,,,hnyzr_,0,1,1,0,1,1,0,0,1,1,1,0
11709,,,seijohsmanager,0,1,1,0,1,1,0,0,1,1,1,0
11710,,,WHO13news,3,1,4,3,1,4,0.333333,0.020061,0,0,0,0
11711,,,yuuuuuzuruuu1,0,1,1,0,1,1,0,0,1,1,1,0
11712,,,gojoskikufukuu,0,1,1,0,1,1,0,0,1,1,1,0
11713,,,goldenchenmo,0,1,1,0,1,1,0,0,2,0.666667,0.75,0
11714,,,HOEFORCHANHYUK,0,1,1,0,1,1,0,0,1,1,1,0
11715,,,primogemsmylove,0,1,1,0,1,1,0,0,1,1,1,0
11716,,,KhaimookNatt,0,1,1,0,1,1,0,0,1,1,1,0
11717,,,Jx06S0,0,1,1,0,1,1,0,0,1,1,1,0
11718,,,irissdya,0,2,2,0,2,2,0,0,1,1,1,0
11719,,,iTAMAKILUVR,0,1,1,0,1,1,0,0,1,1,1,0
11720,,,Arranvvv,0,1,1,0,1,1,0,0,1,1,1,0
11721,,,mercurybard,2,1,3,2,1,3,0.5,0.013374,0,0,0,0
11722,,,hiu_jet,0,2,2,0,2,2,0,0,1,1,1,0
11723,,,rainyforest__,0,1,1,0,1,1,0,0,1,1,1,0
11724,,,Iouvara,12,1,13,12,1,13,0.083333,0.080246,0,0,0,0
11725,,,ididwy,0,1,1,0,1,1,0,0,1,1,1,0
11726,,,Paradise_SYL,0,1,1,0,1,1,0,0,1,1,1,0
11727,,,GOLDNARMYxMOA,0,1,1,0,1,1,0,0,1,1,1,0
11728,,,TinaMorphis,0,1,1,0,1,1,0,0,1,1,1,0
11729,,,kittyoongles_06,0,1,1,0,1,1,0,0,1,1,1,0
11730,,,losing_her,0,1,1,0,1,1,0,0,1,1,1,0
11731,,,ashraihyo,0,1,1,0,1,1,0,0,1,1,1,0
11732,,,kevin50738182,0,2,2,0,2,2,0,0,1,1,1,0
11733,,,intaevee,3,1,4,3,1,4,0.333333,0.020061,0,0,0,0
11734,,,yuge_sato,0,3,3,0,3,3,0,0,1,1,1,0
11735,,,NewsRadio710,7,1,8,7,1,8,0.142857,0.04681,0,0,0,0
11736,,,baby_tiger5010,0,1,1,0,1,1,0,0,1,1,1,0
11737,,,ke2_cat,0,1,1,0,1,1,0,0,1,1,1,0
11738,,,bobarach,0,2,2,0,2,2,0,0,1,1,1,0
11739,,,yangyangbestie_,0,1,1,0,1,1,0,0,1,1,1,0
11740,,,tobio_gyu,0,1,1,0,1,1,0,0,1,1,1,0
11741,,,softaeni,0,1,1,0,1,1,0,0,1,1,1,0
11742,,,drakul0na,0,1,1,0,1,1,0,0,1,1,1,0
11743,,,hadesharp,0,1,1,0,1,1,0,0,1,1,1,0
11744,,,kyojinbeak,0,1,1,0,1,1,0,0,1,1,1,0
11745,,,jeanmyeonn,2,1,3,2,1,3,0.5,0.02217,0,0,0,0
11746,,,jdf0109,2,1,3,2,1,3,0.5,0.013374,0,0,0,0
11747,,,n8wWgymU80u8dWU,7,1,8,7,1,8,0.142857,0.04681,0,0,0,0
11748,,,FLYTOMYFLY,0,1,1,0,1,1,0,0,1,1,1,0
11749,,,detectiscribe,0,1,1,0,1,1,0,0,1,1,1,0
11750,,,mostimasinine,0,1,1,0,1,1,0,0,1,1,1,0
11751,,,Galluizu1,0,1,1,0,1,1,0,0,1,1,1,0
11752,,,kepiscart,5,1,6,5,1,6,0.2,0.040424,0,0,0,0
11753,,,hany5435,0,1,1,0,1,1,0,0,1,1,1,0
11754,,,LJardine93,2,2,4,2,2,4,0.333333,0.013374,1,1,1,1
11755,,,606renjun,0,1,1,0,1,1,0,0,1,1,1,0
11756,,,jisuunie,0,1,1,0,1,1,0,0,1,1,1,0
11757,,,L4NW4NGJ1,0,1,1,0,1,1,0,0,1,1,1,0
11758,,,namminjoongi,2,3,5,2,3,5,0.25,0.013374,1,1,1,2
11759,,,wyc_hh,0,1,1,0,1,1,0,0,1,1,1,0
11760,,,gwchnksj,0,2,2,0,2,2,0,0,1,1,1,0
11761,,,milksimpx,0,4,4,0,5,5,0,0,1,1,1,0
11762,,,kkulyeoja,0,2,2,0,2,2,0,0,1,1,1,0
11763,,,G40NX,1,1,2,1,1,2,0,0.006687,0,0,0,0
11764,,,lilysmurder,2,1,3,2,1,3,0.5,0.013374,0,0,0,0
11765,,,Ioonatheprint,0,1,1,0,1,1,0,0,1,1,1,0
11766,,,RodPeterson13,0,1,1,0,1,1,0,0,1,1,1,0
11767,,,ClaraTSch,0,1,1,0,1,1,0,0,1,1,1,0
11768,,,miyabear_,0,1,1,0,1,1,0,0,1,1,1,0
11769,,,FOX43Sports,12,1,13,12,1,13,0.083333,0.080246,0,0,0,0
11770,,,ChocLover23,0,1,1,0,1,1,0,0,1,1,1,0
11771,,,yunakimqueen,0,1,1,0,1,1,0,0,1,1,1,0
11772,,,Kou1111881002,0,1,1,0,1,1,0,0,1,1,1,0
11773,,,teddyboizz,0,1,1,0,1,1,0,0,1,1,1,0
11774,,,sonoe6,0,1,1,0,1,1,0,0,1,1,1,0
11775,,,donteatmibread,0,1,1,0,1,1,0,0,1,1,1,0
11776,,,madeIineno,0,1,1,0,1,1,0,0,1,1,1,0
11777,,,nottodaymofo2,0,1,1,0,1,1,0,0,1,1,1,0
11778,,,staerrygguk,0,1,1,0,1,1,0,0,1,1,1,0
11779,,,TrickiNikkiM,8,1,9,8,1,9,0.125,0.056224,0,0,0,0
11780,,,reikittys,0,1,1,0,1,1,0,0,1,1,1,0
11781,,,heybouncer,0,1,1,0,1,1,0,0,1,1,1,0
11782,,,yuzusocool,1,3,4,1,3,4,0,0.00396,1,1,1,3
11783,,,marlen_dksh,0,1,1,0,1,1,0,0,1,1,1,0
11784,,,oliveten,0,1,1,0,1,1,0,0,1,1,1,0
11785,,,yuzukun941207,0,1,1,0,1,1,0,0,1,1,1,0
11786,,,VeryAsianEric,0,1,1,0,1,1,0,0,1,1,1,0
11787,,,ayayayayax_x,0,1,1,0,1,1,0,0,1,1,1,0
11788,,,soleileternel_,0,1,1,0,1,1,0,0,1,1,1,0
11789,,,Callalily57,0,1,1,0,1,1,0,0,1,1,1,0
11790,,,masa_ccyo,0,1,1,0,1,1,0,0,1,1,1,0
11791,,,Urch_mann,3,1,4,3,1,4,0.333333,0.020061,0,0,0,0
11792,,,christine2fab,0,1,1,0,1,1,0,0,1,1,1,0
11793,,,iwannasleprn,0,1,1,0,1,1,0,0,1,1,1,0
11794,,,DearsDq,0,1,1,0,1,1,0,0,1,1,1,0
11795,,,finnishtrends,3,1,4,3,1,4,0.333333,0.020061,0,0,0,0
11796,,,katycutecat,0,1,1,0,1,1,0,0,1,1,1,0
11797,,,dibatiqa,0,1,1,0,1,1,0,0,1,1,1,0
11798,,,rileylism,1,1,2,1,1,2,0,0.006687,0,0,0,0
11799,,,ben_teoh,8,1,9,8,1,9,0.125,0.074462,0,0,0,0
11800,,,teeea_withmilk,0,1,1,0,1,1,0,0,1,1,1,0
11801,,,ByrdMan0914,0,1,1,0,1,1,0,0,1,1,1,0
11802,,,neyliiii,0,1,1,0,1,1,0,0,1,1,1,0
11803,,,cuddlymyg,0,1,1,0,1,1,0,0,1,1,1,0
11804,,,klimtjvangogh,0,1,1,0,1,1,0,0,1,1,1,0
11805,,,folkloregoeson,0,1,1,0,1,1,0,0,1,1,1,0
11806,,,CarolYMorrisse1,0,1,1,0,1,1,0,0,3,0.46875,0.5,0
11807,,,LipkaXenia,0,1,1,0,1,1,0,0,3,0.46875,0.5,0
11808,,,_letsrockit_,0,1,1,0,1,1,0,0,3,0.46875,0.5,0
11809,,,Madpinkie,0,1,1,0,1,1,0,0,3,0.46875,0.5,0
11810,,,r1nk_mo0r,0,1,1,0,1,1,0,0,3,0.46875,0.5,0
11811,,,LisaWan67946248,0,1,1,0,1,1,0,0,3,0.46875,0.5,0
11812,,,maviis_x,0,1,1,0,1,1,0,0,3,0.46875,0.5,0
11813,,,ElsaOfErendel,0,1,1,0,1,1,0,0,1,1,1,0
11814,,,redrain_seoul,0,1,1,0,1,1,0,0,1,1,1,0
11815,,,kieutouforever,0,2,2,0,2,2,0,0,1,1,1,0
11816,,,AmericanMom20,4,1,5,4,1,5,0.25,0.026749,0,0,0,0
11817,,,__kimdy,0,1,1,0,1,1,0,0,1,1,1,0
11818,,,xbasellie,0,1,1,0,1,1,0,0,1,1,1,0
11819,,,yunmingguk,0,1,1,0,1,1,0,0,1,1,1,0
11820,,,lymsone,1,1,2,1,1,2,0,0.006687,0,0,0,0
11821,,,WDAYnews,6,1,7,6,1,7,0.166667,0.040123,0,0,0,0
11822,,,eclipsetaehyung,0,1,1,0,1,1,0,0,1,1,1,0
11823,,,phosephemeral,0,1,1,0,1,1,0,0,1,1,1,0
11824,,,prcctymoans,0,1,1,0,1,1,0,0,1,1,1,0
11825,,,ooblekoceanspls,0,1,1,0,1,1,0,0,1,1,1,0
11826,,,joyfulnamjin,0,1,1,0,1,1,0,0,1,1,1,0
11827,,,KOORITSU,2,1,3,2,1,3,0.5,0.013374,0,0,0,0
11828,,,red2vioIet,0,1,1,0,1,1,0,0,1,1,1,0
11829,,,haoIax,0,1,1,0,1,1,0,0,1,1,1,0
11830,,,IN2JINNIE,0,2,2,0,2,2,0,0,1,1,1,0
11831,,,linxiann,0,1,1,0,1,1,0,0,1,1,1,0
11832,,,gayboymingi,0,1,1,0,1,1,0,0,1,1,1,0
11833,,,Sollencia,6,1,7,6,1,7,0.166667,0.040123,0,0,0,0
11834,,,SimplyMagnius,0,1,1,0,1,1,0,0,1,1,1,0
11835,,,ythera,0,1,1,0,1,1,0,0,1,1,1,0
11836,,,meidnav,0,1,1,0,1,1,0,0,1,1,1,0
11837,,,buttsex53,0,1,1,0,1,1,0,0,1,1,1,0
11838,,,seokshine7,4,1,5,4,1,5,0.25,0.026749,0,0,0,0
11839,,,Gina_uiWkooK,0,1,1,0,1,1,0,0,1,1,1,0
11840,,,Midwest_Voter,0,1,1,0,1,1,0,0,1,1,1,0
11841,,,YuzuDreams,0,1,1,0,1,1,0,0,1,1,1,0
11842,,,kazootaoo,4,1,5,4,1,5,0.25,0.026749,0,0,0,0
11843,,,NiallAltErLove,0,1,1,0,1,1,0,0,1,1,1,0
11844,,,LyndsNix,0,1,1,0,1,1,0,0,1,1,1,0
11845,,,jksgonewrong,4,1,5,4,1,5,0.25,0.026749,0,0,0,0
11846,,,enjoy_908097,0,1,1,0,1,1,0,0,1,1,1,0
11847,,,audreyncz,0,1,1,0,1,1,0,0,1,1,1,0
11848,,,btsot7_SC617,0,1,1,0,1,1,0,0,1,1,1,0
11849,,,wctrib,1,1,2,1,1,2,0,0.006687,0,0,0,0
11850,,,yaarohimolly,0,1,1,0,1,1,0,0,1,1,1,0
11851,,,snow_curse,0,1,1,0,1,1,0,0,1,1,1,0
11852,,,mstrite61,6,1,7,6,1,7,0.166667,0.040123,0,0,0,0
11853,,,mochi_manggae,0,1,1,0,1,1,0,0,1,1,1,0
11854,,,WakawithRi,0,1,1,0,1,1,0,0,1,1,1,0
11855,,,Gikaramy,0,1,1,0,1,1,0,0,1,1,1,0
11856,,,maqplam,0,1,1,0,1,1,0,0,1,1,1,0
11857,,,heeseungbunny,0,1,1,0,1,1,0,0,1,1,1,0
11858,,,DigitalIndiawe,5,1,6,5,1,6,0.2,0.033436,0,0,0,0
11859,,,G789954931,0,1,1,0,1,1,0,0,1,1,1,0
11860,,,koikoijkslove,0,1,1,0,1,1,0,0,1,1,1,0
11861,,,mwkjess,26,1,27,26,1,27,0.038462,0.173866,0,0,0,0
11862,,,nikizuha,0,1,1,0,1,1,0,0,1,1,1,0
11863,,,elbie2712,0,1,1,0,1,1,0,0,1,1,1,0
11864,,,claubates,0,1,1,0,1,1,0,0,1,1,1,0
11865,,,veronicachiin,0,1,1,0,1,1,0,0,1,1,1,0
11866,,,Suki_2024,0,1,1,0,1,1,0,0,1,1,1,0
11867,,,BenzaitenJi,0,1,1,0,1,1,0,0,1,1,1,0
11868,,,aetoms,0,1,1,0,1,1,0,0,1,1,1,0
11869,,,jikooklvr9597,0,1,1,0,1,1,0,0,1,1,1,0
11870,,,dddictedturtle_,0,1,1,0,1,1,0,0,1,1,1,0
11871,,,mikiyabu,0,1,1,0,1,1,0,0,1,1,1,0
11872,,,saiimeow,0,1,1,0,1,1,0,0,1,1,1,0
11873,,,mhm1738,0,1,1,0,1,1,0,0,1,1,1,0
11874,,,rla_gksl,0,1,1,0,1,1,0,0,1,1,1,0
11875,,,dineoo_,0,1,1,0,1,1,0,0,1,1,1,0
11876,,,KAlSAT0U,0,1,1,0,1,1,0,0,1,1,1,0
11877,,,mCZ7CJ55gZBi9v9,0,1,1,0,1,1,0,0,1,1,1,0
11878,,,RNoonsapa,0,1,1,0,1,1,0,0,1,1,1,0
11879,,,fkideeh,0,1,1,0,1,1,0,0,1,1,1,0
11880,,,PatSRy_Ch,0,1,1,0,1,1,0,0,1,1,1,0
11881,,,stuart_masha,0,1,1,0,1,1,0,0,1,1,1,0
11882,,,itsurreal,0,1,1,0,1,1,0,0,1,1,1,0
11883,,,kinemislover,0,1,1,0,1,1,0,0,1,1,1,0
11884,,,tetebabyx,0,1,1,0,1,1,0,0,1,1,1,0
11885,,,beefcakebill4,8,1,9,8,1,9,0.125,0.060486,0,0,0,0
11886,,,ophelia_jk,0,1,1,0,1,1,0,0,1,1,1,0
11887,,,QTAHCULT,0,1,1,0,1,1,0,0,1,1,1,0
11888,,,sawamuraway,0,1,1,0,1,1,0,0,1,1,1,0
11889,,,heyparkjm,0,1,1,0,1,1,0,0,1,1,1,0
11890,,,hkanji,0,1,1,0,1,1,0,0,1,1,1,0
11891,,,julie_jag,9,1,10,9,1,10,0.111111,0.060184,0,0,0,0
11892,,,pinklapin0512,0,1,1,0,1,1,0,0,1,1,1,0
11893,,,wychodze1,0,1,1,0,1,1,0,0,1,1,1,0
11894,,,DabisLiLwhore,0,1,1,0,1,1,0,0,1,1,1,0
11895,,,critikal_trix,0,1,1,0,1,1,0,0,1,1,1,0
11896,,,if_biannca,0,1,1,0,1,1,0,0,1,1,1,0
11897,,,oyaoyaoyahaikyu,0,1,1,0,1,1,0,0,1,1,1,0
11898,,,sleepymilk_,0,1,1,0,1,1,0,0,1,1,1,0
11899,,,xeniih,0,2,2,0,2,2,0,0,1,1,1,0
11900,,,ksev4,0,1,1,0,1,1,0,0,1,1,1,0
11901,,,hrms_hillsec,0,1,1,0,1,1,0,0,1,1,1,0
11902,,,romaloredanaa,0,1,1,0,1,1,0,0,1,1,1,0
11903,,,TheReal_KDubb,3,1,4,3,1,4,0.333333,0.020061,0,0,0,0
11904,,,klustout,0,1,1,0,1,1,0,0,1,1,1,0
11905,,,naega_nugu13,0,1,1,0,1,1,0,0,1,1,1,0
11906,,,a5b923959a9f44a,0,1,1,0,1,1,0,0,1,1,1,0
11907,,,cheyennexli,1,1,2,1,1,2,0,0.006687,0,0,0,0
11908,,,_Oldmemory,0,1,1,0,1,1,0,0,2,0.666667,0.75,0
11909,,,NamjonThicTidys,0,1,1,0,1,1,0,0,2,0.666667,0.75,0
11910,,,djsammyt0917,0,9,9,0,11,11,0,0,2,0.846154,0.909091,0
11911,,,ErinEsdrelon,0,1,1,0,1,1,0,0,1,1,1,0
11912,,,nowhere4u,0,1,1,0,1,1,0,0,1,1,1,0
11913,,,uaminagreement,0,1,1,0,1,1,0,0,1,1,1,0
11914,,,405131library,0,1,1,0,1,1,0,0,1,1,1,0
11915,,,TZLING2,0,1,1,0,1,1,0,0,1,1,1,0
11916,,,VarVar___ka,0,1,1,0,1,1,0,0,1,1,1,0
11917,,,uncoverrrrr,0,1,1,0,1,1,0,0,1,1,1,0
11918,,,ARMY_IrishBomb,0,1,1,0,1,1,0,0,1,1,1,0
11919,,,lKISSMOBIUS,9,1,10,9,1,10,0.111111,0.060184,0,0,0,0
11920,,,tact_H,0,1,1,0,1,1,0,0,1,1,1,0
11921,,,gyuIyy,0,1,1,0,1,1,0,0,1,1,1,0
11922,,,iheartmonkeys19,0,1,1,0,1,1,0,0,1,1,1,0
11923,,,baconli,0,1,1,0,1,1,0,0,1,1,1,0
11924,,,CaineMcGinley,0,1,1,0,1,1,0,0,1,1,1,0
11925,,,PEACHY0SH,0,1,1,0,1,1,0,0,1,1,1,0
11926,,,liraru,0,1,1,0,1,1,0,0,1,1,1,0
11927,,,chitoseame3003,0,1,1,0,1,1,0,0,1,1,1,0
11928,,,gyujisu,3,1,4,3,1,4,0.333333,0.020061,0,0,0,0
11929,,,syaethv,0,1,1,0,1,1,0,0,1,1,1,0
11930,,,rjs0402,0,1,1,0,1,1,0,0,1,1,1,0
11931,,,JeremyH57940473,8,1,9,8,1,9,0.125,0.053497,0,0,0,0
11932,,,basicallyuta,0,1,1,0,1,1,0,0,1,1,1,0
11933,,,olgusolf,0,1,1,0,1,1,0,0,1,1,1,0
11934,,,joeypandaa,0,1,1,0,1,1,0,0,1,1,1,0
11935,,,akari_mizudori,0,1,1,0,1,1,0,0,1,1,1,0
11936,,,igotdeobi,0,1,1,0,1,1,0,0,1,1,1,0
11937,,,dainxoxosleif,0,1,1,0,1,1,0,0,1,1,1,0
11938,,,satoruakgae,8,1,9,8,1,9,0.125,0.053497,0,0,0,0
11939,,,YiboMiPololo,0,1,1,0,1,1,0,0,1,1,1,0
11940,,,_moonbabie,0,1,1,0,1,1,0,0,1,1,1,0
11941,,,aochabiyori,0,1,1,0,1,1,0,0,1,1,1,0
11942,,,arroganceGi,0,1,1,0,1,1,0,0,1,1,1,0
11943,,,chiru_hasu,0,1,1,0,1,1,0,0,1,1,1,0
11944,,,turtlegirl980,2,2,4,2,2,4,0.333333,0.013374,1,1,1,1
11945,,,jungmorai,0,1,1,0,1,1,0,0,2,0.666667,0.75,0
11946,,,EdoubleXE,1,1,2,1,1,2,0,0.006687,0,0,0,0
11947,,,qctimes,9,1,10,9,1,10,0.111111,0.060184,0,0,0,0
11948,,,chimamamamama,0,1,1,0,1,1,0,0,1,1,1,0
11949,,,tOes_snail,0,1,1,0,1,1,0,0,1,1,1,0
11950,,,donleoNERD,0,1,1,0,1,1,0,0,1,1,1,0
11951,,,Shelly7934222,0,2,2,0,2,2,0,0,1,1,1,0
11952,,,Ksalon7,0,1,1,0,1,1,0,0,1,1,1,0
11953,,,lovesmazemp3,0,1,1,0,1,1,0,0,1,1,1,0
11954,,,2ndleprechaun,0,1,1,0,1,1,0,0,1,1,1,0
11955,,,louisxharryf,0,1,1,0,1,1,0,0,1,1,1,0
11956,,,honeyhuimang,0,1,1,0,1,1,0,0,1,1,1,0
11957,,,mmmanena,0,1,1,0,1,1,0,0,1,1,1,0
11958,,,dechile207,0,1,1,0,1,1,0,0,1,1,1,0
11959,,,han_zre,0,1,1,0,1,1,0,0,1,1,1,0
11960,,,julia47374457,0,6,6,0,9,9,0,0,1,1,1,0
11961,,,flowieehibiscus,0,1,1,0,1,1,0,0,1,1,1,0
11962,,,AEgis7697,0,1,1,0,1,1,0,0,1,1,1,0
11963,,,Soniyaatomar,0,1,1,0,1,1,0,0,1,1,1,0
11964,,,IKissTohma,0,1,1,0,1,1,0,0,1,1,1,0
11965,,,univxers,0,1,1,0,1,1,0,0,1,1,1,0
11966,,,chiakireads,0,1,1,0,1,1,0,0,1,1,1,0
11967,,,yuri_figure,0,1,1,0,1,1,0,0,1,1,1,0
11968,,,GojoTwink,3,1,4,3,1,4,0.333333,0.020061,0,0,0,0
11969,,,MSNSports,11,1,12,12,1,13,0.090909,0.084041,0,0,0,0
11970,,,felixissues,0,1,1,0,1,1,0,0,1,1,1,0
11971,,,sardynka_0116,0,1,1,0,1,1,0,0,1,1,1,0
11972,,,zetahutch,0,1,1,0,1,1,0,0,1,1,1,0
11973,,,msmoonfart,0,1,1,0,1,1,0,0,1,1,1,0
11974,,,aliceroared,0,1,1,0,1,1,0,0,1,1,1,0
11975,,,100Riri100m,0,1,1,0,1,1,0,0,1,1,1,0
11976,,,mikeysmp,0,1,1,0,1,1,0,0,1,1,1,0
11977,,,hasshi57294307,0,1,1,0,1,1,0,0,1,1,1,0
11978,,,bIueknight,0,1,1,0,1,1,0,0,1,1,1,0
11979,,,jofelle,0,1,1,0,1,1,0,0,1,1,1,0
11980,,,guajilalala,0,1,1,0,1,1,0,0,1,1,1,0
11981,,,nyaakii,0,1,1,0,1,1,0,0,1,1,1,0
11982,,,triviavxrse,0,2,2,0,2,2,0,0,1,1,1,0
11983,,,h_ianna,0,1,1,0,1,1,0,0,1,1,1,0
11984,,,ilanaaa_aaa,0,1,1,0,1,1,0,0,1,1,1,0
11985,,,drpiyushkr,0,1,1,0,1,1,0,0,1,1,1,0
11986,,,chiangchet,0,1,1,0,1,1,0,0,1,1,1,0
11987,,,serious_21ab,0,1,1,0,1,1,0,0,1,1,1,0
11988,,,soran_ro,0,1,1,0,1,1,0,0,1,1,1,0
11989,,,kylexocampo,0,1,1,0,1,1,0,0,1,1,1,0
11990,,,NickyDVP,0,1,1,0,1,1,0,0,1,1,1,0
11991,,,PixelMendy,0,1,1,0,1,1,0,0,1,1,1,0
11992,,,RobertHon0911,3,1,4,4,2,6,0.333333,0.020061,0,0,0,0
11993,,,noraj_williams,4,1,5,4,1,5,0.25,0.026749,0,0,0,0
11994,,,shirozora,0,1,1,0,1,1,0,0,1,1,1,0
11995,,,jvseznayka,0,1,1,0,1,1,0,0,1,1,1,0
11996,,,GrumpyK48333693,21,1,22,22,2,24,0.047619,0.143924,0,0,0,0
11997,,,bacondravvs,0,1,1,0,1,1,0,0,4,0.384615,0.483333,0
11998,,,koko_shoma_,0,1,1,0,1,1,0,0,4,0.384615,0.483333,0
11999,,,0X1L0VES,0,1,1,0,1,1,0,0,1,1,1,0
12000,,,linzeigh,0,1,1,0,1,1,0,0,1,1,1,0
12001,,,TH0TB0TT,0,1,1,0,1,1,0,0,1,1,1,0
12002,,,zjyuzu,0,1,1,0,1,1,0,0,1,1,1,0
12003,,,eighttriples,0,1,1,0,1,1,0,0,1,1,1,0
12004,,,luminaur,0,1,1,0,1,1,0,0,1,1,1,0
12005,,,993618374Cathy,0,1,1,0,1,1,0,0,1,1,1,0
12006,,,jefdefsoulb,0,1,1,0,1,1,0,0,1,1,1,0
12007,,,ssamurey,0,1,1,0,1,1,0,0,1,1,1,0
12008,,,MARIUS_DTOWN,5,1,6,5,1,6,0.2,0.033436,0,0,0,0
12009,,,Exoslave1,0,1,1,0,1,1,0,0,1,1,1,0
12010,,,PrachiPundeer,0,1,1,0,1,1,0,0,1,1,1,0
12011,,,lazuligyu,0,1,1,0,1,1,0,0,1,1,1,0
12012,,,enshitiwildin,0,1,1,0,1,1,0,0,1,1,1,0
12013,,,jihadwatchdog,1,1,2,1,1,2,0,0.006687,0,0,0,0
12014,,,ayoub_moqtad,1,1,2,1,1,2,0,0.006687,0,0,0,0
12015,,,GBKWong,3,1,4,3,1,4,0.333333,0.020061,0,0,0,0
12016,,,Wuttttt2,0,1,1,0,1,1,0,0,1,1,1,0
12017,,,dochankai,3,1,4,3,1,4,0.333333,0.020061,0,0,0,0
12018,,,amane_araisan,0,1,1,0,1,1,0,0,1,1,1,0
12019,,,fried_rice_10,0,2,2,0,2,2,0,0,2,0.75,0.833333,0
12020,,,wqCgPphSBRquKEi,0,1,1,0,1,1,0,0,1,1,1,0
12021,,,lavenderdoggie,0,1,1,0,1,1,0,0,1,1,1,0
12022,,,grande_avvocato,0,1,1,0,1,1,0,0,1,1,1,0
12023,,,lifeisgood010,0,1,1,0,1,1,0,0,1,1,1,0
12024,,,vsmiIes,0,1,1,0,1,1,0,0,1,1,1,0
12025,,,knetai,0,1,1,0,1,1,0,0,1,1,1,0
12026,,,Latxorizo,0,1,1,0,1,1,0,0,1,1,1,0
12027,,,EUSPHlA,0,1,1,0,1,1,0,0,1,1,1,0
12028,,,niumenmer,0,1,1,0,1,1,0,0,1,1,1,0
12029,,,dbyjrzhelo,0,1,1,0,1,1,0,0,1,1,1,0
12030,,,baekelforyeoda,0,1,1,0,1,1,0,0,1,1,1,0
12031,,,S1CKJJK,0,1,1,0,1,1,0,0,1,1,1,0
12032,,,scarletvmin,0,1,1,0,1,1,0,0,1,1,1,0
12033,,,JeanninePayne15,0,1,1,0,1,1,0,0,1,1,1,0
12034,,,yunas3lz3t,0,1,1,0,1,1,0,0,1,1,1,0
12035,,,MysticToki,0,1,1,0,1,1,0,0,1,1,1,0
12036,,,Universestoy,0,1,1,0,1,1,0,0,1,1,1,0
12037,,,kdgmeu58,0,1,1,0,1,1,0,0,1,1,1,0
12038,,,nelly_ish,0,1,1,0,1,1,0,0,1,1,1,0
12039,,,peterpobjecky,0,1,1,0,1,1,0,0,1,1,1,0
12040,,,KURAScottie_,0,1,1,0,1,1,0,0,1,1,1,0
12041,,,JaiToFu,0,1,1,0,1,1,0,0,1,1,1,0
12042,,,gjnjg4,0,1,1,0,1,1,0,0,1,1,1,0
12043,,,nyu___kyu,0,1,1,0,1,1,0,0,1,1,1,0
12044,,,moonskwj,0,1,1,0,1,1,0,0,1,1,1,0
12045,,,waiyumanching,0,1,1,0,1,1,0,0,1,1,1,0
12046,,,pcypeaches,0,1,1,0,1,1,0,0,1,1,1,0
12047,,,huayizhen,0,1,1,0,1,1,0,0,1,1,1,0
12048,,,joebarton1238,0,1,1,0,1,1,0,0,1,1,1,0
12049,,,maoly4e,0,1,1,0,1,1,0,0,1,1,1,0
12050,,,lesna_nimfa,0,1,1,0,1,1,0,0,1,1,1,0
12051,,,megyn95,0,1,1,0,1,1,0,0,1,1,1,0
12052,,,WFXRsports,5,1,6,6,2,8,0.2,0.033436,0,0,0,0
12053,,,05YZU,0,1,1,0,1,1,0,0,1,1,1,0
12054,,,jy_o0o2,0,1,1,0,1,1,0,0,1,1,1,0
12055,,,akiteru000,0,1,1,0,1,1,0,0,1,1,1,0
12056,,,android_jinji,2,1,3,2,1,3,0.5,0.013374,0,0,0,0
12057,,,R0CKSTRJE0N,0,2,2,0,2,2,0,0,1,1,1,0
12058,,,pjmglss,4,1,5,5,2,7,0.25,0.026749,0,0,0,0
12059,,,potahanyu,0,1,1,0,1,1,0,0,1,1,1,0
12060,,,grigioantracite,0,1,1,0,1,1,0,0,1,1,1,0
12061,,,outrunGFW,10,1,11,11,1,12,0.1,0.066871,0,0,0,0
12062,,,candypopheart,0,2,2,0,2,2,0,0,1,1,1,0
12063,,,Sad_Maurice,0,2,2,0,2,2,0,0,1,1,1,0
12064,,,ri_omochabako,0,1,1,0,1,1,0,0,1,1,1,0
12065,,,kiwi75krypto,0,1,1,0,1,1,0,0,1,1,1,0
12066,,,ririroxdaworld,0,3,3,0,3,3,0,0,1,1,1,0
12067,,,monocrescent,0,1,1,0,1,1,0,0,1,1,1,0
12068,,,BlackBrandRep,0,1,1,0,1,1,0,0,1,1,1,0
12069,,,PetrelliPierre,0,1,1,0,2,2,0,0,1,1,1,0
12070,,,PekiKon7,4,1,5,4,1,5,0.25,0.026749,0,0,0,0
12071,,,NSTWOTHOUSAND,0,1,1,0,1,1,0,0,1,1,1,0
12072,,,ryoinunu,0,1,1,0,1,1,0,0,1,1,1,0
12073,,,lovesremi,0,1,1,0,1,1,0,0,1,1,1,0
12074,,,ESPN690Jax,1,1,2,1,1,2,0,0.006687,0,0,0,0
12075,,,_pffffa,0,1,1,0,1,1,0,0,1,1,1,0
12076,,,kkyuum,0,1,1,0,1,1,0,0,1,1,1,0
12077,,,iloveboobun,0,1,1,0,1,1,0,0,1,1,1,0
12078,,,braverudolf,0,1,1,0,1,1,0,0,1,1,1,0
12079,,,Mkstar4,0,6,6,0,6,6,0,0,1,1,1,0
12080,,,GoOnSweetie,0,2,2,0,2,2,0,0,1,1,1,0
12081,,,unlovedcrybaby,0,2,2,0,2,2,0,0,1,1,1,0
12082,,,EskersDice,9,1,10,9,1,10,0.111111,0.060184,0,0,0,0
12083,,,Heyitsbreeeeee,0,1,1,0,1,1,0,0,1,1,1,0
12084,,,mocasaayas,0,3,3,0,3,3,0,0,1,1,1,0
12085,,,InnerChildNammu,0,2,2,0,2,2,0,0,1,1,1,0
12086,,,hobiibot,0,1,1,0,1,1,0,0,1,1,1,0
12087,,,moonchldmaria,0,1,1,0,1,1,0,0,1,1,1,0
12088,,,syhnjtj7613,0,1,1,0,1,1,0,0,1,1,1,0
12089,,,OhanaAnna_,4,1,5,4,1,5,0.25,0.026749,0,0,0,0
12090,,,hlthiskrieger,0,1,1,0,1,1,0,0,1,1,1,0
12091,,,Shporki3,0,1,1,0,1,1,0,0,1,1,1,0
12092,,,PB_News,10,1,11,10,1,11,0.1,0.066871,0,0,0,0
12093,,,jellyjwi,0,1,1,0,1,1,0,0,1,1,1,0
12094,,,heeniaz,0,1,1,0,1,1,0,0,1,1,1,0
12095,,,Eliya94401409,0,1,1,0,1,1,0,0,1,1,1,0
12096,,,clearnightsong,0,1,1,0,1,1,0,0,1,1,1,0
12097,,,seijohgist,0,1,1,0,1,1,0,0,1,1,1,0
12098,,,thomas39212,0,1,1,0,1,1,0,0,1,1,1,0
12099,,,1717_ern,0,1,1,0,1,1,0,0,1,1,1,0
12100,,,sze9wei,15,1,16,15,1,16,0.066667,0.128261,0,0,0,0
12101,,,byLucilu,0,1,1,0,1,1,0,0,1,1,1,0
12102,,,y2kIee,0,1,1,0,1,1,0,0,1,1,1,0
12103,,,namjuningonline,0,1,1,0,1,1,0,0,1,1,1,0
12104,,,andrew_rudick,0,1,1,0,1,1,0,0,1,1,1,0
12105,,,ventisalcohol,0,1,1,0,1,1,0,0,1,1,1,0
12106,,,JodieKeith14,0,1,1,0,1,1,0,0,1,1,1,0
12107,,,jiminanana1,0,1,1,0,1,1,0,0,1,1,1,0
12108,,,loveszd08051005,0,1,1,0,1,1,0,0,1,1,1,0
12109,,,travelingnerd23,0,1,1,0,1,1,0,0,1,1,1,0
12110,,,ReutersSports,26,1,27,28,2,30,0.038462,0.194867,0,0,0,0
12111,,,drawseph,0,1,1,0,1,1,0,0,1,1,1,0
12112,,,BrettDakinBooks,0,1,1,0,1,1,0,0,1,1,1,0
12113,,,thesavagemuffin,0,1,1,0,1,1,0,0,1,1,1,0
12114,,,itscacing,0,1,1,0,1,1,0,0,1,1,1,0
12115,,,taestelepathy,0,1,1,0,1,1,0,0,1,1,1,0
12116,,,mame_mamesuke,0,1,1,0,1,1,0,0,1,1,1,0
12117,,,cheltonjm,0,1,1,0,1,1,0,0,1,1,1,0
12118,,,AvrilJade7,3,1,4,4,2,6,0.333333,0.020061,0,0,0,0
12119,,,mbrookerhk,0,1,1,0,1,1,0,0,1,1,1,0
12120,,,21septluv,0,1,1,0,1,1,0,0,1,1,1,0
12121,,,hsumaos,0,1,1,0,1,1,0,0,1,1,1,0
12122,,,rayawithluv,0,1,1,0,1,1,0,0,1,1,1,0
12123,,,skbozphd,6,1,7,8,3,11,0.166667,0.040123,0,0,0,0
12124,,,WhoIsNuz,0,1,1,0,1,1,0,0,1,1,1,0
12125,,,barbhiye,0,2,2,0,2,2,0,0,1,1,1,0
12126,,,libr0ry,1,1,2,1,1,2,0,0.006687,0,0,0,0
12127,,,brioin,0,1,1,0,1,1,0,0,1,1,1,0
12128,,,jiswwl,0,1,1,0,1,1,0,0,1,1,1,0
12129,,,DRechts,0,1,1,0,1,1,0,0,1,1,1,0
12130,,,Taemniiiii,4,1,5,4,1,5,0.25,0.026749,0,0,0,0
12131,,,kawakoyamada,0,1,1,0,1,1,0,0,1,1,1,0
12132,,,TirthaaT,0,1,1,0,1,1,0,0,1,1,1,0
12133,,,DeadCats111,0,1,1,0,1,1,0,0,1,1,1,0
12134,,,prttyhae,1,1,2,1,1,2,0,0.006687,0,0,0,0
12135,,,himederecosplay,12,1,13,12,1,13,0.083333,0.096029,0,0,0,0
12136,,,sugawainscoting,0,1,1,0,1,1,0,0,1,1,1,0
12137,,,dabuislove,0,1,1,0,1,1,0,0,1,1,1,0
12138,,,jonhhello,0,1,1,0,1,1,0,0,1,1,1,0
12139,,,Holdmewhilestay,0,1,1,0,1,1,0,0,1,1,1,0
12140,,,jarritxs,0,2,2,0,2,2,0,0,2,0.75,0.833333,0
12141,,,velvetkiisscs,0,1,1,0,1,1,0,0,1,1,1,0
12142,,,thebloodsaltar,2,1,3,2,1,3,0.5,0.013374,0,0,0,0
12143,,,addormentare,0,1,1,0,1,1,0,0,1,1,1,0
12144,,,marvinbries,0,1,1,0,1,1,0,0,1,1,1,0
12145,,,autumnleavestwt,0,1,1,0,1,1,0,0,1,1,1,0
12146,,,GCFfilter_mp3,0,1,1,0,1,1,0,0,1,1,1,0
12147,,,kittyongjoongie,0,1,1,0,1,1,0,0,1,1,1,0
12148,,,usapostnews1,0,1,1,0,1,1,0,0,1,1,1,0
12149,,,Godzilla_Money,2,1,3,2,1,3,0.5,0.020363,0,0,0,0
12150,,,srfrio17460,3,1,4,5,3,8,0.333333,0.020061,0,0,0,0
12151,,,OKfication,1,1,2,1,1,2,0,0.006687,0,0,0,0
12152,,,rinatthedisco,2,1,3,2,1,3,0.5,0.013374,0,0,0,0
12153,,,bto3o,0,1,1,0,1,1,0,0,1,1,1,0
12154,,,flwrren_,0,1,1,0,1,1,0,0,1,1,1,0
12155,,,marivanna10,0,1,1,0,1,1,0,0,1,1,1,0
12156,,,Hir0shiman,0,1,1,0,1,1,0,0,1,1,1,0
12157,,,MammonKinnie,0,1,1,0,1,1,0,0,1,1,1,0
12158,,,vicciho,0,1,1,0,1,1,0,0,1,1,1,0
12159,,,luneheka,0,1,1,0,1,1,0,0,1,1,1,0
12160,,,tylerscheib,0,1,1,0,1,1,0,0,1,1,1,0
12161,,,fleezymar,3,1,4,4,2,6,0.333333,0.020061,0,0,0,0
12162,,,victoriafhicks,3,1,4,3,1,4,0.333333,0.020061,0,0,0,0
12163,,,xxpstggdd,0,1,1,0,1,1,0,0,1,1,1,0
12164,,,fashionwalkwalk,4,1,5,4,1,5,0.25,0.065185,0,0,0,0
12165,,,uwu_riii,0,1,1,0,1,1,0,0,1,1,1,0
12166,,,X1224S,0,1,1,0,1,1,0,0,1,1,1,0
12167,,,PineTonygpine,9,1,10,10,2,12,0.111111,0.159045,0,0,0,0
12168,,,annie04522986,0,1,1,0,1,1,0,0,1,1,1,0
12169,,,lilacviolet_,0,1,1,0,1,1,0,0,1,1,1,0
12170,,,TheyStation,0,1,1,0,1,1,0,0,2,0.666667,0.75,0
12171,,,antifatwa,0,1,1,0,1,1,0,0,2,0.666667,0.75,0
12172,,,measdo,0,1,1,0,1,1,0,0,2,0.666667,0.75,0
12173,,,cruzhechka,0,1,1,0,1,1,0,0,2,0.666667,0.75,0
12174,,,s_m_stofka,0,1,1,0,1,1,0,0,2,0.666667,0.75,0
12175,,,hoon1fied,2,1,3,2,1,3,0.5,0.013374,0,0,0,0
12176,,,ryokoni,0,1,1,0,1,1,0,0,1,1,1,0
12177,,,jimin_my_bae,0,1,1,0,1,1,0,0,1,1,1,0
12178,,,xxxxdyyyyyyyyy,0,1,1,0,1,1,0,0,1,1,1,0
12179,,,colour_fetish,0,1,1,0,1,1,0,0,1,1,1,0
12180,,,sxchadream,0,1,1,0,1,1,0,0,1,1,1,0
12181,,,raisedtoseven,0,1,1,0,1,1,0,0,1,1,1,0
12182,,,Filipe_The_Man,0,1,1,0,1,1,0,0,1,1,1,0
12183,,,ZullyAmaro,0,1,1,0,1,1,0,0,1,1,1,0
12184,,,rogue_corq,1,1,2,1,1,2,0,0.006687,0,0,0,0
12185,,,StarryyCloset,0,1,1,0,1,1,0,0,1,1,1,0
12186,,,comfysope,0,1,1,0,1,1,0,0,1,1,1,0
12187,,,penspunk,0,1,1,0,1,1,0,0,1,1,1,0
12188,,,JaimePulfer,0,1,1,0,1,1,0,0,1,1,1,0
12189,,,beechhangergals,0,1,1,0,1,1,0,0,1,1,1,0
12190,,,BAU37QN5xpgbho1,0,1,1,0,1,1,0,0,1,1,1,0
12191,,,S120494H,0,1,1,0,1,1,0,0,1,1,1,0
12192,,,s1nnerfox,13,1,14,14,2,16,0.076923,0.086933,0,0,0,0
12193,,,chaesobas,6,1,7,6,1,7,0.166667,0.040123,0,0,0,0
12194,,,SaddysWolke,0,1,1,0,1,1,0,0,1,1,1,0
12195,,,shenlulushen,0,1,1,0,1,1,0,0,1,1,1,0
12196,,,MarthaLarive,0,1,1,0,1,1,0,0,1,1,1,0
12197,,,azaleas__,0,1,1,0,1,1,0,0,1,1,1,0
12198,,,thvanemone,0,2,2,0,2,2,0,0,2,0.75,0.833333,0
12199,,,kyadenai,0,1,1,0,1,1,0,0,3,0.5,0.518519,0
12200,,,sugarboo124,0,1,1,0,1,1,0,0,3,0.5,0.518519,0
12201,,,taekooknina,0,1,1,0,1,1,0,0,3,0.5,0.518519,0
12202,,,molliekatie,0,2,2,0,2,2,0,0,3,0.513514,0.54386,0
12203,,,wismessie,0,1,1,0,1,1,0,0,3,0.5,0.518519,0
12204,,,bibicosplays,0,1,1,0,1,1,0,0,3,0.5,0.518519,0
12205,,,onlybressons,0,1,1,0,1,1,0,0,3,0.5,0.518519,0
12206,,,haruzuy94,0,1,1,0,1,1,0,0,1,1,1,0
12207,,,JPaskin,0,1,1,0,1,1,0,0,1,1,1,0
12208,,,_LemonFlower_,0,1,1,0,1,1,0,0,1,1,1,0
12209,,,preciousihenec1,0,1,1,0,1,1,0,0,1,1,1,0
12210,,,KidElGat,0,1,1,0,1,1,0,0,1,1,1,0
12211,,,HsiaoliH,0,1,1,0,1,1,0,0,1,1,1,0
12212,,,hidelcondorpasa,0,1,1,0,1,1,0,0,1,1,1,0
12213,,,dfjdjgdjgdjgd,0,1,1,0,1,1,0,0,1,1,1,0
12214,,,youraraka,0,1,1,0,1,1,0,0,1,1,1,0
12215,,,SFdirewolf,0,1,1,0,1,1,0,0,1,1,1,0
12216,,,GainBEG,0,1,1,0,1,1,0,0,1,1,1,0
12217,,,Shivsaravan,0,1,1,0,1,1,0,0,1,1,1,0
12218,,,belphegie,0,1,1,0,1,1,0,0,1,1,1,0
12219,,,TeshawnEdmonds,0,1,1,0,1,1,0,0,2,0.666667,0.75,0
12220,,,lonelyaaaaaa,0,1,1,0,1,1,0,0,2,0.666667,0.75,0
12221,,,cryingsquirtle,0,1,1,0,1,1,0,0,2,0.666667,0.75,0
12222,,,madisonjenks22,0,1,1,0,1,1,0,0,2,0.666667,0.75,0
12223,,,kmaPY4gzBt8nOtW,0,1,1,0,1,1,0,0,2,0.666667,0.75,0
12224,,,hobismiIf,8,1,9,8,1,9,0.125,0.053497,0,0,0,0
12225,,,_20181198_2914_,0,1,1,0,1,1,0,0,1,1,1,0
12226,,,_svetkagrishina,0,1,1,0,1,1,0,0,1,1,1,0
12227,,,meiloveskazuha,0,1,1,0,1,1,0,0,1,1,1,0
12228,,,DTheExplorer80,0,1,1,0,1,1,0,0,1,1,1,0
12229,,,mkmthefuture,0,1,1,0,1,1,0,0,1,1,1,0
12230,,,denden010300,0,1,1,0,1,1,0,0,2,0.666667,0.75,0
12231,,,anna_feng1,0,1,1,0,1,1,0,0,1,1,1,0
12232,,,ozaed,0,1,1,0,1,1,0,0,1,1,1,0
12233,,,sabosannnn,0,1,1,0,1,1,0,0,1,1,1,0
12234,,,pauIinaj,6,1,7,6,1,7,0,0.02376,1,1,1,6
12235,,,suiisy1,0,1,1,0,1,1,0,0,1,1,1,0
12236,,,TiniDo,0,1,1,0,1,1,0,0,1,1,1,0
12237,,,keika_00,0,1,1,0,1,1,0,0,1,1,1,0
12238,,,holydarkling,0,1,1,0,1,1,0,0,1,1,1,0
12239,,,strictlyhentai,0,1,1,0,1,1,0,0,1,1,1,0
12240,,,yoonminskookies,0,1,1,0,1,1,0,0,1,1,1,0
12241,,,bucinanrandom,0,1,1,0,1,1,0,0,1,1,1,0
12242,,,TellyVee_,0,1,1,0,1,1,0,0,1,1,1,0
12243,,,AIZAWAN0,0,1,1,0,1,1,0,0,1,1,1,0
12244,,,squiddlex,0,1,1,0,1,1,0,0,1,1,1,0
12245,,,lokapliz,0,1,1,0,1,1,0,0,1,1,1,0
12246,,,love_demiglace,0,1,1,0,1,1,0,0,1,1,1,0
12247,,,hmrkzpdwrk,0,1,1,0,1,1,0,0,1,1,1,0
12248,,,ShaunCarter45,0,2,2,0,3,3,0,0,1,1,1,0
12249,,,strduster,0,1,1,0,1,1,0,0,1,1,1,0
12250,,,nanazerocolors,0,1,1,0,1,1,0,0,1,1,1,0
12251,,,stegersaurus,3,1,4,3,1,4,0.333333,0.075969,0,0,0,0
12252,,,drinkmilkpeople,0,1,1,0,1,1,0,0,1,1,1,0
12253,,,SlTHBAEK,0,1,1,0,1,1,0,0,2,0.666667,0.75,0
12254,,,triviaynwa,0,1,1,0,1,1,0,0,2,0.666667,0.75,0
12255,,,NatIsDone,0,1,1,0,1,1,0,0,2,0.666667,0.75,0
12256,,,cheery927,0,1,1,0,1,1,0,0,2,0.666667,0.75,0
12257,,,sh1myun,4,1,5,5,2,7,0.25,0.026749,0,0,0,0
12258,,,liluistherais,0,1,1,0,1,1,0,0,1,1,1,0
12259,,,basedmaria,0,1,1,0,1,1,0,0,1,1,1,0
12260,,,anxiousdisco,7,1,8,7,1,8,0.142857,0.102718,0,0,0,0
12261,,,Fmayubkhan,0,1,1,0,1,1,0,0,1,1,1,0
12262,,,sooo_nop,0,1,1,0,1,1,0,0,1,1,1,0
12263,,,atbeingyou,0,1,1,0,1,1,0,0,1,1,1,0
12264,,,JUSTLIKEFIIRE,0,1,1,0,1,1,0,0,1,1,1,0
12265,,,HNGNcom,3,1,4,3,1,4,0.333333,0.020061,0,0,0,0
12266,,,2Kiraku,0,1,1,0,1,1,0,0,1,1,1,0
12267,,,jimin_yes_jam,0,1,1,0,1,1,0,0,1,1,1,0
12268,,,0RBMASTER,0,2,2,0,2,2,0,0,2,0.666667,0.75,0
12269,,,LapkiHwana,0,1,1,0,1,1,0,0,1,1,1,0
12270,,,hanachirusato7,10,1,11,10,1,11,0.1,0.066871,0,0,0,0
12271,,,prince_bedi,0,1,1,0,1,1,0,0,1,1,1,0
12272,,,HikaruHirai1,0,1,1,0,1,1,0,0,1,1,1,0
12273,,,MyMissRight_twt,0,1,1,0,1,1,0,0,1,1,1,0
12274,,,elisabet_sosa97,0,1,1,0,1,1,0,0,1,1,1,0
12275,,,usembassydhaka,0,1,1,0,1,1,0,0,1,1,1,0
12276,,,saftyblanket,0,1,1,0,1,1,0,0,1,1,1,0
12277,,,seeunstc,0,1,1,0,1,1,0,0,1,1,1,0
12278,,,ezechielixe,0,1,1,0,1,1,0,0,1,1,1,0
12279,,,antinnous,0,1,1,0,1,1,0,0,1,1,1,0
12280,,,Hobarigado,0,1,1,0,1,1,0,0,1,1,1,0
12281,,,Anna__Johnson,0,1,1,0,1,1,0,0,1,1,1,0
12282,,,eli_phan,0,1,1,0,1,1,0,0,1,1,1,0
12283,,,marescaX,0,1,1,0,1,1,0,0,1,1,1,0
12284,,,ynsjlnn,0,1,1,0,1,1,0,0,1,1,1,0
12285,,,MiracleIC91,0,1,1,0,1,1,0,0,1,1,1,0
12286,,,swh200022,0,1,1,0,1,1,0,0,1,1,1,0
12287,,,mistersofttees,4,1,5,5,2,7,0.25,0.026749,0,0,0,0
12288,,,lonelypaperstar,0,1,1,0,1,1,0,0,1,1,1,0
12289,,,YuzuShiYu1,0,1,1,0,1,1,0,0,1,1,1,0
12290,,,lovesboba,0,1,1,0,1,1,0,0,1,1,1,0
12291,,,boscobosco2021,0,3,3,0,3,3,0,0,1,1,1,0
12292,,,dolIvmin,0,1,1,0,1,1,0,0,1,1,1,0
12293,,,cesca_aaa,0,1,1,0,1,1,0,0,1,1,1,0
12294,,,snfllllwr,0,1,1,0,1,1,0,0,1,1,1,0
12295,,,lilcherryhead_,0,1,1,0,1,1,0,0,1,1,1,0
12296,,,markleesshi,0,1,1,0,1,1,0,0,1,1,1,0
12297,,,lurzett,0,1,1,0,1,1,0,0,1,1,1,0
12298,,,MayoSusanto,0,1,1,0,1,1,0,0,1,1,1,0
12299,,,migneko,0,1,1,0,1,1,0,0,1,1,1,0
12300,,,lovetwirl0316,0,1,1,0,1,1,0,0,1,1,1,0
12301,,,StateStatus_OR,3,1,4,3,1,4,0.333333,0.020061,0,0,0,0
12302,,,arielcyiark,0,1,1,0,1,1,0,0,1,1,1,0
12303,,,vocalrachaa,0,1,1,0,1,1,0,0,1,1,1,0
12304,,,Cluleem,7,1,8,7,1,8,0.142857,0.04681,0,0,0,0
12305,,,BambooMade,0,1,1,0,1,1,0,0,1,1,1,0
12306,,,takamasakujou,0,1,1,0,1,1,0,0,1,1,1,0
12307,,,F4IRYJENSOO,0,1,1,0,1,1,0,0,1,1,1,0
12308,,,ElineBerings,0,1,1,0,1,1,0,0,1,1,1,0
12309,,,_iluvchuuya,0,1,1,0,1,1,0,0,1,1,1,0
12310,,,lisadont,1,1,2,1,1,2,0,0.006687,0,0,0,0
12311,,,wastedspoilers,0,1,1,0,1,1,0,0,1,1,1,0
12312,,,LorettaFilms,0,1,1,0,1,1,0,0,1,1,1,0
12313,,,murica__10,0,1,1,0,1,1,0,0,1,1,1,0
12314,,,SOQBlN,1,2,3,1,2,3,0.5,0.006687,1,1,1,0
12315,,,tupoihokage,0,1,1,0,1,1,0,0,1,1,1,0
12316,,,2003jpLove2m,0,1,1,0,1,1,0,0,1,1,1,0
12317,,,seleneaylward,0,1,1,0,1,1,0,0,1,1,1,0
12318,,,chimchimmievv,0,1,1,0,1,1,0,0,1,1,1,0
12319,,,wirelessfolks,0,1,1,0,1,1,0,0,1,1,1,0
12320,,,TodoTiempo,41,1,42,42,1,43,0.02439,0.281161,0,0,0,0
12321,,,q4yyiyy,0,1,1,0,2,2,0,0,1,1,1,0
12322,,,adri_jpg,0,1,1,0,1,1,0,0,1,1,1,0
12323,,,yoon_a00u,0,1,1,0,1,1,0,0,1,1,1,0
12324,,,marguii_14,0,1,1,0,1,1,0,0,1,1,1,0
12325,,,CBJimandB,0,1,1,0,1,1,0,0,1,1,1,0
12326,,,WrongQuotes5,0,1,1,0,1,1,0,0,1,1,1,0
12327,,,odalysio,0,1,1,0,1,1,0,0,1,1,1,0
12328,,,bigdickfreak83,0,1,1,0,1,1,0,0,1,1,1,0
12329,,,onebirdbread,0,1,1,0,1,1,0,0,1,1,1,0
12330,,,hoyaprod,0,1,1,0,1,1,0,0,1,1,1,0
12331,,,MeierLink_Z,0,1,1,0,1,1,0,0,1,1,1,0
12332,,,YaraviUzcategui,0,1,1,0,1,1,0,0,1,1,1,0
12333,,,lua_da_carolina,0,1,1,0,1,1,0,0,1,1,1,0
12334,,,hiro_0v0,0,1,1,0,1,1,0,0,1,1,1,0
12335,,,kanata5201314,0,1,1,0,1,1,0,0,1,1,1,0
12336,,,chiararosso,0,1,1,0,1,1,0,0,1,1,1,0
12337,,,nyx_bamzZ,0,1,1,0,1,1,0,0,1,1,1,0
12338,,,yingIaozu,0,1,1,0,1,1,0,0,1,1,1,0
12339,,,nieshirun,0,1,1,0,1,1,0,0,1,1,1,0
12340,,,subtaelity,0,1,1,0,1,1,0,0,1,1,1,0
12341,,,msbettedot,0,1,1,0,1,1,0,0,1,1,1,0
12342,,,deffshore_,0,1,1,0,1,1,0,0,1,1,1,0
12343,,,MusicSunlit,0,1,1,0,1,1,0,0,1,1,1,0
12344,,,ItsMeKailaG,0,1,1,0,1,1,0,0,1,1,1,0
12345,,,likejamie3,0,1,1,0,1,1,0,0,1,1,1,0
12346,,,cloudburst3375,0,1,1,0,1,1,0,0,1,1,1,0
12347,,,suniolympicgold,0,1,1,0,1,1,0,0,1,1,1,0
12348,,,22purplecat,0,1,1,0,1,1,0,0,1,1,1,0
12349,,,newoki,0,1,1,0,1,1,0,0,1,1,1,0
12350,,,JAEW0NDER,0,1,1,0,1,1,0,0,1,1,1,0
12351,,,AZZUHRUH,0,1,1,0,1,1,0,0,1,1,1,0
12352,,,tealspyre,0,1,1,0,1,1,0,0,1,1,1,0
12353,,,OnIcePH_,0,2,2,0,2,2,0,0,1,1,1,0
12354,,,GeoffVallis,12,1,13,12,1,13,0.083333,0.164889,0,0,0,0
12355,,,milmillecrepes,0,1,1,0,1,1,0,0,1,1,1,0
12356,,,YuzuruHanyuPH,0,1,1,0,1,1,0,0,1,1,1,0
12357,,,chxnye,0,1,1,0,1,1,0,0,1,1,1,0
12358,,,bethna_lavis,0,1,1,0,1,1,0,0,1,1,1,0
12359,,,Andreea_1_d,0,1,1,0,1,1,0,0,1,1,1,0
12360,,,jiejie_laoshi,0,1,1,0,1,1,0,0,1,1,1,0
12361,,,diiminies,0,1,1,0,1,1,0,0,1,1,1,0
12362,,,fangedphoenix,3,1,4,3,1,4,0.333333,0.020061,0,0,0,0
12363,,,tacos_suadero,0,3,3,0,3,3,0,0,1,1,1,0
12364,,,hunlune,2,1,3,2,1,3,0.5,0.013374,0,0,0,0
12365,,,gaolianxian1205,0,1,1,0,1,1,0,0,1,1,1,0
12366,,,doiecat,2,1,3,2,1,3,0.5,0.013374,0,0,0,0
12367,,,sofiaaaahh,11,1,12,12,1,13,0.090909,0.073559,0,0,0,0
12368,,,serenitybetson,0,1,1,0,2,2,0,0,1,1,1,0
12369,,,myginluv,0,1,1,0,1,1,0,0,1,1,1,0
12370,,,moonright1028,0,1,1,0,1,1,0,0,1,1,1,0
12371,,,kooihmu,0,1,1,0,1,1,0,0,1,1,1,0
12372,,,triple_axel0903,0,1,1,0,1,1,0,0,1,1,1,0
12373,,,chinaghao,0,1,1,0,1,1,0,0,1,1,1,0
12374,,,tbh1530na208y27,0,1,1,0,1,1,0,0,1,1,1,0
12375,,,protectherullet,0,1,1,0,1,1,0,0,1,1,1,0
12376,,,thverrie,0,1,1,0,1,1,0,0,1,1,1,0
12377,,,tigerfae_,0,1,1,0,1,1,0,0,1,1,1,0
12378,,,tatillon_angel,0,1,1,0,1,1,0,0,1,1,1,0
12379,,,margaritaxcz,0,1,1,0,1,1,0,0,1,1,1,0
12380,,,iseankyle,27,1,28,28,1,29,0.037037,0.180553,0,0,0,0
12381,,,L0VELIXIE,0,1,1,0,1,1,0,0,1,1,1,0
12382,,,diIfgloss,0,1,1,0,1,1,0,0,1,1,1,0
12383,,,CFgmb,0,1,1,0,1,1,0,0,1,1,1,0
12384,,,pikatikachu,0,1,1,0,1,1,0,0,1,1,1,0
12385,,,booksg2500,0,2,2,0,2,2,0,0,1,1,1,0
12386,,,alpacaspink,0,1,1,0,1,1,0,0,1,1,1,0
12387,,,P_CTaonii,0,1,1,0,1,1,0,0,1,1,1,0
12388,,,lflorepolitics,0,1,1,0,1,1,0,0,1,1,1,0
12389,,,_njs91,0,1,1,0,1,1,0,0,1,1,1,0
12390,,,getonista,0,1,1,0,1,1,0,0,1,1,1,0
12391,,,SPEARMYTH,0,1,1,0,1,1,0,0,1,1,1,0
12392,,,jkbobahead,0,1,1,0,1,1,0,0,1,1,1,0
12393,,,MinaNoru,0,1,1,0,1,1,0,0,1,1,1,0
12394,,,PatuPatu11,0,1,1,0,1,1,0,0,1,1,1,0
12395,,,sonaeyo,0,1,1,0,1,1,0,0,1,1,1,0
12396,,,VIsmineforever,0,1,1,0,1,1,0,0,1,1,1,0
12397,,,whycoolwine,0,1,1,0,1,1,0,0,1,1,1,0
12398,,,tokko3lune,0,1,1,0,1,1,0,0,1,1,1,0
12399,,,timcampyy,0,1,1,0,1,1,0,0,1,1,1,0
12400,,,saltbittermelon,0,1,1,0,1,1,0,0,1,1,1,0
12401,,,kult_lucifer,0,1,1,0,1,1,0,0,1,1,1,0
12402,,,allen_with_a_b,18,1,19,18,1,19,0.055556,0.120369,0,0,0,0
12403,,,ibu_hoshina,0,1,1,0,1,1,0,0,1,1,1,0
12404,,,lineeyihhh,0,1,1,0,1,1,0,0,1,1,1,0
12405,,,_mrsshy,0,1,1,0,1,1,0,0,1,1,1,0
12406,,,miniemoonstar,0,1,1,0,1,1,0,0,1,1,1,0
12407,,,R3TROFUTUR1ST,0,1,1,0,1,1,0,0,1,1,1,0
12408,,,svnsunist,0,1,1,0,1,1,0,0,1,1,1,0
12409,,,patrickprat,0,1,1,0,1,1,0,0,1,1,1,0
12410,,,chana_2706,0,1,1,0,1,1,0,0,1,1,1,0
12411,,,djworldisrin,0,1,1,0,1,1,0,0,1,1,1,0
12412,,,whaliean52,0,1,1,0,1,1,0,0,1,1,1,0
12413,,,fumin061061,0,1,1,0,1,1,0,0,1,1,1,0
12414,,,kozumezkenma,0,3,3,0,3,3,0,0,1,1,1,0
12415,,,hoesasuke,0,1,1,0,1,1,0,0,1,1,1,0
12416,,,sh7n5ee,0,1,1,0,1,1,0,0,1,1,1,0
12417,,,milfluvrawr,0,1,1,0,1,1,0,0,1,1,1,0
12418,,,Muhamma70177866,1,1,2,1,1,2,0,0.006687,0,0,0,0
12419,,,rayh71408789,12,1,13,12,1,13,0.083333,0.087234,0,0,0,0
12420,,,Horeszko1,0,1,1,0,1,1,0,0,1,1,1,0
12421,,,hseokjk_flowers,0,1,1,0,1,1,0,0,1,1,1,0
12422,,,kellyjomae,0,1,1,0,1,1,0,0,1,1,1,0
12423,,,nnppqqpp,0,1,1,0,1,1,0,0,1,1,1,0
12424,,,beem_mee,0,1,1,0,1,1,0,0,1,1,1,0
12425,,,gladys_sabin,0,1,1,0,1,1,0,0,1,1,1,0
12426,,,cchubibi,0,1,1,0,1,1,0,0,1,1,1,0
12427,,,MWilson_89,0,1,1,0,1,1,0,0,1,1,1,0
12428,,,judywasyours,0,1,1,0,1,1,0,0,1,1,1,0
12429,,,moonluvity,0,1,1,0,1,1,0,0,1,1,1,0
12430,,,MATCHABLOSS0M,0,1,1,0,1,1,0,0,1,1,1,0
12431,,,UOTrackFangirl,0,2,2,0,2,2,0,0,1,1,1,0
12432,,,taetaestress,5,2,7,5,2,7,0.166667,0.033436,1,1,1,4
12433,,,readynugget,0,1,1,0,1,1,0,0,2,0.666667,0.75,0
12434,,,JhillyB,0,1,1,0,1,1,0,0,2,0.666667,0.75,0
12435,,,dollsyang,6,1,7,7,2,9,0.166667,0.040123,0,0,0,0
12436,,,mirkolorenz,0,1,1,0,1,1,0,0,1,1,1,0
12437,,,fishwithshrimps,0,1,1,0,1,1,0,0,1,1,1,0
12438,,,msbybj4eversup,0,1,1,0,1,1,0,0,1,1,1,0
12439,,,StarlightRoad,0,2,2,0,2,2,0,0,1,1,1,0
12440,,,e34079435,16,2,18,21,7,28,0.058824,0.106994,1,1,1,15
12441,,,CarolineSeydel,5,1,6,5,1,6,0.2,0.033436,0,0,0,0
12442,,,gerardlenting,0,1,1,0,1,1,0,0,1,1,1,0
12443,,,lilkikibum,0,1,1,0,1,1,0,0,1,1,1,0
12444,,,ragazza103,0,1,1,0,1,1,0,0,1,1,1,0
12445,,,NimrodTica,0,1,1,0,1,1,0,0,1,1,1,0
12446,,,JennyP220,2,2,4,2,2,4,0.333333,0.013374,1,1,1,1
12447,,,kuncuts,0,1,1,0,1,1,0,0,2,0.666667,0.75,0
12448,,,cheonsaminnie,0,1,1,0,1,1,0,0,1,1,1,0
12449,,,parkfaijies,0,1,1,0,1,1,0,0,1,1,1,0
12450,,,fairyluciel,0,1,1,0,1,1,0,0,1,1,1,0
12451,,,sarara4141,0,1,1,0,1,1,0,0,2,0.666667,0.75,0
12452,,,yonkpils,0,1,1,0,1,1,0,0,2,0.666667,0.75,0
12453,,,Elle_Cares,0,1,1,0,1,1,0,0,2,0.666667,0.75,0
12454,,,eyedropps,0,1,1,0,1,1,0,0,2,0.666667,0.75,0
12455,,,Qu33nnL,0,1,1,0,1,1,0,0,2,0.666667,0.75,0
12456,,,aekozume,0,3,3,0,3,3,0,0,2,0.8,0.875,0
12457,,,robinsnewswire,3,1,4,3,1,4,0.333333,0.020061,0,0,0,0
12458,,,decendium,0,1,1,0,1,1,0,0,1,1,1,0
12459,,,AndrewOrell,8,1,9,8,1,9,0.125,0.070968,0,0,0,0
12460,,,lunaaamaria,0,1,1,0,1,1,0,0,1,1,1,0
12461,,,yuzukasep,0,2,2,0,2,2,0,0,1,1,1,0
12462,,,hokuroprincess,0,1,1,0,1,1,0,0,1,1,1,0
12463,,,ShigeyoK,0,2,2,0,2,2,0,0,1,1,1,0
12464,,,jhopegenderenvy,6,1,7,6,1,7,0.166667,0.040123,0,0,0,0
12465,,,yuzuangeI,0,1,1,0,1,1,0,0,1,1,1,0
12466,,,broodingground,0,1,1,0,1,1,0,0,1,1,1,0
12467,,,AnchorNECC,0,1,1,0,1,1,0,0,1,1,1,0
12468,,,_eveningFERN,0,1,1,0,1,1,0,0,1,1,1,0
12469,,,giggity4204,1,1,2,1,1,2,0,0.006687,0,0,0,0
12470,,,netbuoy,2,1,3,2,1,3,0.5,0.013374,0,0,0,0
12471,,,lexusvaliance,7,1,8,7,1,8,0.142857,0.04681,0,0,0,0
12472,,,AgarwalPema,0,1,1,0,1,1,0,0,1,1,1,0
12473,,,sunnelore,0,1,1,0,1,1,0,0,1,1,1,0
12474,,,laureniceskater,0,1,1,0,1,1,0,0,1,1,1,0
12475,,,vaklantis,0,1,1,0,1,1,0,0,1,1,1,0
12476,,,rifan155,0,1,1,0,1,1,0,0,1,1,1,0
12477,,,mo_onhoney,0,2,2,0,2,2,0,0,1,1,1,0
12478,,,rachmova,16,1,17,16,1,17,0.0625,0.106994,0,0,0,0
12479,,,mortifaed,0,1,1,0,1,1,0,0,1,1,1,0
12480,,,v8nitcs,0,1,1,0,1,1,0,0,1,1,1,0
12481,,,dS0QFGPNqFoLrUw,0,1,1,0,1,1,0,0,1,1,1,0
12482,,,wheecentral,0,1,1,0,1,1,0,0,1,1,1,0
12483,,,jasminemsc,0,1,1,0,1,1,0,0,1,1,1,0
12484,,,btobinfinite77,0,1,1,0,1,1,0,0,1,1,1,0
12485,,,kisumisofty,0,1,1,0,1,1,0,0,1,1,1,0
12486,,,princesspoppyc,0,1,1,0,1,1,0,0,1,1,1,0
12487,,,maily2m,0,1,1,0,1,1,0,0,1,1,1,0
12488,,,valtavarosen,0,1,1,0,1,1,0,0,1,1,1,0
12489,,,elenilote,0,1,1,0,1,1,0,0,1,1,1,0
12490,,,ramenrulz8P,0,1,1,0,1,1,0,0,1,1,1,0
12491,,,miemour,0,1,1,0,1,1,0,0,1,1,1,0
12492,,,temptempholder,0,1,1,0,1,1,0,0,1,1,1,0
12493,,,s990405176,0,1,1,0,1,1,0,0,1,1,1,0
12494,,,xin_xin300,0,1,1,0,1,1,0,0,1,1,1,0
12495,,,connorluvr69,0,1,1,0,1,1,0,0,1,1,1,0
12496,,,BAEKYAN_506,0,1,1,0,1,1,0,0,1,1,1,0
12497,,,doodlemon_,0,1,1,0,1,1,0,0,1,1,1,0
12498,,,wmhuo168,0,1,1,0,1,1,0,0,1,1,1,0
12499,,,rnacchiatos,1,1,2,1,1,2,0,0.006687,0,0,0,0
12500,,,koki_otter,0,1,1,0,1,1,0,0,1,1,1,0
12501,,,RanaZoba,1,1,2,1,1,2,0,0.006687,0,0,0,0
12502,,,Rika_3A2T,0,1,1,0,1,1,0,0,1,1,1,0
12503,,,_Maryonet_,0,1,1,0,1,1,0,0,1,1,1,0
12504,,,cc3_3,0,1,1,0,1,1,0,0,1,1,1,0
12505,,,TrippinOnLegos,9,1,10,9,1,10,0.111111,0.060184,0,0,0,0
12506,,,suwaaikichi,0,2,2,0,2,2,0,0,1,1,1,0
12507,,,huachengfucker,0,1,1,0,1,1,0,0,1,1,1,0
12508,,,seikoh_fsp,0,2,2,0,2,2,0,0,1,1,1,0
12509,,,lcjshs_wz,0,1,1,0,1,1,0,0,1,1,1,0
12510,,,frangipani24451,0,1,1,0,1,1,0,0,1,1,1,0
12511,,,kaeyahearteyess,0,1,1,0,1,1,0,0,1,1,1,0
12512,,,wambuisophie,7,1,8,7,1,8,0.142857,0.04681,0,0,0,0
12513,,,madokapepe2,0,1,1,0,1,1,0,0,1,1,1,0
12514,,,BostonBubbalooo,0,1,1,0,1,1,0,0,1,1,1,0
12515,,,adagi0rca,0,2,2,0,2,2,0,0,1,1,1,0
12516,,,shiroruninglow,0,1,1,0,1,1,0,0,1,1,1,0
12517,,,petitehobis,0,1,1,0,1,1,0,0,1,1,1,0
12518,,,sprite0604,0,1,1,0,1,1,0,0,1,1,1,0
12519,,,strangecloud3,2,1,3,2,1,3,0.5,0.013374,0,0,0,0
12520,,,areum_moon,0,2,2,0,2,2,0,0,1,1,1,0
12521,,,__adomingo,0,1,1,0,1,1,0,0,1,1,1,0
12522,,,conqiglia,0,1,1,0,1,1,0,0,1,1,1,0
12523,,,deandero,0,1,1,0,1,1,0,0,1,1,1,0
12524,,,jiminbestboi,0,1,1,0,1,1,0,0,1,1,1,0
12525,,,JungshockedO,0,1,1,0,1,1,0,0,1,1,1,0
12526,,,gukkisluv,0,1,1,0,1,1,0,0,1,1,1,0
12527,,,hz2uHyoP7hTW9Pk,0,1,1,0,1,1,0,0,1,1,1,0
12528,,,v4_v4_,2,1,3,3,2,5,0.5,0.013374,0,0,0,0
12529,,,SacchanOT7,0,1,1,0,1,1,0,0,1,1,1,0
12530,,,aizuki_x,0,1,1,0,1,1,0,0,1,1,1,0
12531,,,japansacewrites,0,1,1,0,1,1,0,0,1,1,1,0
12532,,,japhettaula,0,1,1,0,1,1,0,0,1,1,1,0
12533,,,whouskat,0,1,1,0,1,1,0,0,1,1,1,0
12534,,,VANTESLCV,0,1,1,0,1,1,0,0,1,1,1,0
12535,,,____wangjanim,0,2,2,0,2,2,0,0,1,1,1,0
12536,,,robinsportsnews,4,1,5,4,1,5,0.25,0.026749,0,0,0,0
12537,,,enharu_,0,1,1,0,1,1,0,0,1,1,1,0
12538,,,BlankPonyboy,0,9,9,0,9,9,0,0,1,1,1,0
12539,,,alicepatches,0,1,1,0,1,1,0,0,1,1,1,0
12540,,,rumeenate,1,1,2,1,1,2,0,0.006687,0,0,0,0
12541,,,tina_araneta,6,1,7,6,1,7,0.166667,0.040123,0,0,0,0
12542,,,bob3bob3,0,1,1,0,1,1,0,0,1,1,1,0
12543,,,tan_agotchi,0,1,1,0,1,1,0,0,1,1,1,0
12544,,,icyhottrash,0,1,1,0,1,1,0,0,1,1,1,0
12545,,,lovebugknj,0,1,1,0,1,1,0,0,1,1,1,0
12546,,,minjiscorner,8,1,9,8,1,9,0.125,0.058952,0,0,0,0
12547,,,XAHAgali,0,1,1,0,1,1,0,0,1,1,1,0
12548,,,anarociodi,0,1,1,0,1,1,0,0,1,1,1,0
12549,,,celestialreina,0,1,1,0,1,1,0,0,1,1,1,0
12550,,,notfineasfine,0,1,1,0,1,1,0,0,1,1,1,0
12551,,,xoxo_nini01,0,1,1,0,1,1,0,0,1,1,1,0
12552,,,WDAZTV,1,1,2,1,1,2,0,0.006687,0,0,0,0
12553,,,DylanMc50991216,4,1,5,4,1,5,0.25,0.026749,0,0,0,0
12554,,,alexsisu,0,1,1,0,1,1,0,0,1,1,1,0
12555,,,whalienvmn,0,1,1,0,1,1,0,0,1,1,1,0
12556,,,Tushar__Kothari,4,1,5,4,1,5,0.25,0.026749,0,0,0,0
12557,,,yuzuruforevver,0,14,14,0,23,23,0,0,2,0.9375,0.966667,0
12558,,,lostinkewtness,0,1,1,0,1,1,0,0,1,1,1,0
12559,,,xiaobabie1,0,1,1,0,1,1,0,0,1,1,1,0
12560,,,neki0_0,0,1,1,0,1,1,0,0,1,1,1,0
12561,,,tsayu_,0,1,1,0,1,1,0,0,1,1,1,0
12562,,,Mikoto_Shin_07,0,1,1,0,1,1,0,0,1,1,1,0
12563,,,Caesar85857147,0,1,1,0,1,1,0,0,1,1,1,0
12564,,,yangskates,0,1,1,0,1,1,0,0,1,1,1,0
12565,,,satrian,0,1,1,0,1,1,0,0,1,1,1,0
12566,,,oldgoldengirl2,0,1,1,0,1,1,0,0,1,1,1,0
12567,,,TheWorldNewsENG,6,1,7,6,1,7,0.166667,0.040123,0,0,0,0
12568,,,dianora77,0,1,1,0,1,1,0,0,1,1,1,0
12569,,,mym_xing,0,1,1,0,1,1,0,0,1,1,1,0
12570,,,20ishh,0,1,1,0,1,1,0,0,1,1,1,0
12571,,,t3chnobwade,0,1,1,0,1,1,0,0,1,1,1,0
12572,,,hafizyusr,0,1,1,0,1,1,0,0,1,1,1,0
12573,,,Dali_Yang,6,1,7,6,1,7,0.166667,0.040123,0,0,0,0
12574,,,VINCEG0GH,0,2,2,0,2,2,0,0,3,0.518519,0.559524,0
12575,,,ErikvanSanden,0,1,1,0,1,1,0,0,1,1,1,0
12576,,,lkults,0,1,1,0,1,1,0,0,1,1,1,0
12577,,,goquuokka,0,1,1,0,1,1,0,0,1,1,1,0
12578,,,OnlineTheWiki,9,1,10,9,1,10,0.111111,0.060184,0,0,0,0
12579,,,ashley__freitas,0,1,1,0,1,1,0,0,1,1,1,0
12580,,,nnevermindt,0,1,1,0,1,1,0,0,1,1,1,0
12581,,,zjy_08,0,1,1,0,1,1,0,0,1,1,1,0
12582,,,renscreamjun,0,1,1,0,1,1,0,0,1,1,1,0
12583,,,ZAQSBusiness,1,1,2,1,1,2,0,0.006687,0,0,0,0
12584,,,Lynndia,8,1,9,8,1,9,0.125,0.053497,0,0,0,0
12585,,,dymorany_byun,0,1,1,0,1,1,0,0,1,1,1,0
12586,,,h6seon,0,1,1,0,1,1,0,0,1,1,1,0
12587,,,yoontids,0,1,1,0,1,1,0,0,1,1,1,0
12588,,,ctdbdmt,0,1,1,0,1,1,0,0,1,1,1,0
12589,,,mainvocaltaetae,0,1,1,0,1,1,0,0,1,1,1,0
12590,,,whenkoosmiles,0,1,1,0,1,1,0,0,1,1,1,0
12591,,,daelu_ee,0,1,1,0,1,1,0,0,1,1,1,0
12592,,,jjongloml,0,1,1,0,1,1,0,0,1,1,1,0
12593,,,9jalover1,9,1,10,9,1,10,0.111111,0.144828,0,0,0,0
12594,,,gothyoonie_,0,1,1,0,1,1,0,0,1,1,1,0
12595,,,PatAmador1,0,1,1,0,1,1,0,0,1,1,1,0
12596,,,straits_times,0,1,1,0,1,1,0,0,1,1,1,0
12597,,,chtmq_,0,1,1,0,1,1,0,0,1,1,1,0
12598,,,NgoziEkeledo,1,1,2,1,1,2,0,0.006687,0,0,0,0
12599,,,ST_LifeTweets,4,1,5,4,1,5,0.25,0.026749,0,0,0,0
12600,,,queenofbirbia,0,1,1,0,1,1,0,0,1,1,1,0
12601,,,spaceykyoru,0,1,1,0,1,1,0,0,1,1,1,0
12602,,,kainsydence,0,1,1,0,1,1,0,0,1,1,1,0
12603,,,uharlotte,0,1,1,0,1,1,0,0,1,1,1,0
12604,,,JournoWes,0,1,1,0,1,1,0,0,1,1,1,0
12605,,,PixelPets3,0,1,1,0,1,1,0,0,1,1,1,0
12606,,,ahyuntwt,0,1,1,0,1,1,0,0,1,1,1,0
12607,,,Kelly_and_Annie,0,1,1,0,1,1,0,0,1,1,1,0
12608,,,CAPapiya,0,1,1,0,1,1,0,0,1,1,1,0
12609,,,souffleighh,0,1,1,0,1,1,0,0,1,1,1,0
12610,,,InsideNewYorkTV,0,2,2,0,2,2,0,0,1,1,1,0
12611,,,erwins_boobs,0,1,1,0,1,1,0,0,1,1,1,0
12612,,,ForCommunities,9,1,10,9,1,10,0.111111,0.082292,0,0,0,0
12613,,,chae_seven,0,1,1,0,1,1,0,0,1,1,1,0
12614,,,hellabella33,0,1,1,0,1,1,0,0,1,1,1,0
12615,,,shotobimilk,0,1,1,0,1,1,0,0,1,1,1,0
12616,,,girlbossbaejin,0,1,1,0,1,1,0,0,1,1,1,0
12617,,,BlackWiidowz,0,1,1,0,1,1,0,0,1,1,1,0
12618,,,JimmyWinSV,10,1,11,10,1,11,0.1,0.138563,0,0,0,0
12619,,,euiseeun,0,1,1,0,1,1,0,0,1,1,1,0
12620,,,yuzu1207saito01,0,1,1,0,1,1,0,0,1,1,1,0
12621,,,mariechmaury,0,1,1,0,1,1,0,0,1,1,1,0
12622,,,NarroVictor,0,1,1,0,1,1,0,0,1,1,1,0
12623,,,xxBrookePayne,0,1,1,0,1,1,0,0,1,1,1,0
12624,,,taebabyyy3,0,1,1,0,1,1,0,0,1,1,1,0
12625,,,catboyIevi,0,3,3,0,3,3,0,0,1,1,1,0
12626,,,Emc2Bit,6,1,7,6,1,7,0.166667,0.040123,0,0,0,0
12627,,,futurecitrus,0,1,1,0,1,1,0,0,1,1,1,0
12628,,,Yeollie148561,0,1,1,0,1,1,0,0,1,1,1,0
12629,,,sora_02,0,1,1,0,1,1,0,0,1,1,1,0
12630,,,evasmlp,0,2,2,0,2,2,0,0,1,1,1,0
12631,,,jacky77345895,0,1,1,0,1,1,0,0,1,1,1,0
12632,,,thesweetestjoon,0,1,1,0,1,1,0,0,1,1,1,0
12633,,,wLjhsXoGU7YoaGp,0,1,1,0,1,1,0,0,1,1,1,0
12634,,,sritoper,0,1,1,0,1,1,0,0,1,1,1,0
12635,,,LibraAbsolut,0,1,1,0,1,1,0,0,1,1,1,0
12636,,,ranwvns,0,1,1,0,1,1,0,0,1,1,1,0
12637,,,ireneapoIogist,17,1,18,17,1,18,0.058824,0.124164,0,0,0,0
12638,,,uyukth,0,1,1,0,1,1,0,0,1,1,1,0
12639,,,wikipattia,0,1,1,0,1,1,0,0,1,1,1,0
12640,,,baIIcockshot,0,2,2,0,2,2,0,0,1,1,1,0
12641,,,EGIVpiuc_7,0,1,1,0,1,1,0,0,1,1,1,0
12642,,,rwestfbr,0,1,1,0,1,1,0,0,1,1,1,0
12643,,,The_clearest,0,1,1,0,1,1,0,0,1,1,1,0
12644,,,LauraPoRe,0,1,1,0,1,1,0,0,1,1,1,0
12645,,,_mikasakasa,0,1,1,0,1,1,0,0,1,1,1,0
12646,,,joyshivelvet,0,1,1,0,1,1,0,0,1,1,1,0
12647,,,Rue_Lenyoress,0,1,1,0,1,1,0,0,1,1,1,0
12648,,,alyssxn_,0,1,1,0,1,1,0,0,1,1,1,0
12649,,,1eojnx,9,1,10,9,1,10,0.111111,0.060184,0,0,0,0
12650,,,hybelabelsdog,0,1,1,0,1,1,0,0,1,1,1,0
12651,,,s3okjinn1es,0,1,1,0,1,1,0,0,1,1,1,0
12652,,,fall1ngfl0wer,0,2,2,0,2,2,0,0,1,1,1,0
12653,,,haneuyelle,0,1,1,0,1,1,0,0,1,1,1,0
12654,,,95KTAEHYUNGV,0,1,1,0,1,1,0,0,1,1,1,0
12655,,,samiell1,0,1,1,0,1,1,0,0,1,1,1,0
12656,,,bb_billkin,2,1,3,3,2,5,0.5,0.013374,0,0,0,0
12657,,,teddynoel,0,1,1,0,1,1,0,0,1,1,1,0
12658,,,nstnstns,0,1,1,0,1,1,0,0,1,1,1,0
12659,,,NttUy3,0,1,1,0,1,1,0,0,1,1,1,0
12660,,,_nataleaf,7,2,9,8,3,11,0.125,0.04681,1,1,1,6
12661,,,geishaarmy,2,1,3,2,1,3,0.5,0.013374,0,0,0,0
12662,,,kplrhie,0,1,1,0,1,1,0,0,1,1,1,0
12663,,,Nathan4U_Tmw4Me,3,1,4,3,1,4,0.333333,0.028857,0,0,0,0
12664,,,Forgiven0072,0,1,1,0,1,1,0,0,1,1,1,0
12665,,,slavicbimbo,11,1,12,11,1,12,0.090909,0.073559,0,0,0,0
12666,,,_iamishii,0,1,1,0,1,1,0,0,1,1,1,0
12667,,,ariromu,0,1,1,0,1,1,0,0,1,1,1,0
12668,,,Churro0704,0,1,1,0,1,1,0,0,1,1,1,0
12669,,,1510_butterfly,0,1,1,0,1,1,0,0,1,1,1,0
12670,,,tinyseokjjin,0,1,1,0,1,1,0,0,1,1,1,0
12671,,,iyagiri,0,2,2,0,2,2,0,0,1,1,1,0
12672,,,mew_teaspoon,0,1,1,0,1,1,0,0,1,1,1,0
12673,,,ivuszk,0,1,1,0,1,1,0,0,1,1,1,0
12674,,,ItsmePalm_S,0,1,1,0,1,1,0,0,2,0.666667,0.75,0
12675,,,ceokaii,0,1,1,0,1,1,0,0,2,0.666667,0.75,0
12676,,,letitgosam,9,1,10,9,1,10,0.111111,0.060184,0,0,0,0
12677,,,Hoverover2,0,1,1,0,1,1,0,0,1,1,1,0
12678,,,AndrewPDuncan2,0,1,1,0,1,1,0,0,1,1,1,0
12679,,,nogginpl,0,1,1,0,1,1,0,0,1,1,1,0
12680,,,KeilMoon,0,1,1,0,1,1,0,0,1,1,1,0
12681,,,rockbison__ot7,0,1,1,0,1,1,0,0,1,1,1,0
12682,,,m0nsa1,0,1,1,0,1,1,0,0,1,1,1,0
12683,,,pdaleyalexander,0,1,1,0,1,1,0,0,1,1,1,0
12684,,,onyourmarkles,0,1,1,0,1,1,0,0,1,1,1,0
12685,,,user128937,5,1,6,5,1,6,0.2,0.033436,0,0,0,0
12686,,,RpakaJ,0,1,1,0,1,1,0,0,1,1,1,0
12687,,,mingostaen,0,1,1,0,1,1,0,0,1,1,1,0
12688,,,mintyvmk,0,1,1,0,1,1,0,0,1,1,1,0
12689,,,philsmusicass,0,1,1,0,1,1,0,0,1,1,1,0
12690,,,aurasparrowmist,1,1,2,1,1,2,0,0.006687,0,0,0,0
12691,,,MUSTAFAMAMUJEE1,7,1,8,7,1,8,0.142857,0.04681,0,0,0,0
12692,,,jooniekolagi,0,1,1,0,1,1,0,0,1,1,1,0
12693,,,yumburrito,0,1,1,0,1,1,0,0,1,1,1,0
12694,,,KarenMokKY,0,1,1,0,1,1,0,0,1,1,1,0
12695,,,ifckinhatefs,0,1,1,0,1,1,0,0,1,1,1,0
12696,,,jksvnte,0,1,1,0,1,1,0,0,1,1,1,0
12697,,,rente2oo3,0,1,1,0,1,1,0,0,1,1,1,0
12698,,,_Amandrew_,3,1,4,3,1,4,0.333333,0.020061,0,0,0,0
12699,,,WilliamSingourd,0,1,1,0,1,1,0,0,1,1,1,0
12700,,,D_TownNico,0,1,1,0,1,1,0,0,1,1,1,0
12701,,,Park_Chaemin_7,0,1,1,0,1,1,0,0,1,1,1,0
12702,,,etsuko666,9,1,10,10,1,11,0.111111,0.060184,0,0,0,0
12703,,,bambyshely,0,1,1,0,1,1,0,0,1,1,1,0
12704,,,KimPhck,0,1,1,0,1,1,0,0,1,1,1,0
12705,,,suryakriz,0,1,1,0,1,1,0,0,1,1,1,0
12706,,,agustrracha,0,1,1,0,1,1,0,0,1,1,1,0
12707,,,innermeowngi,0,1,1,0,1,1,0,0,1,1,1,0
12708,,,Chelle_Coops,0,1,1,0,1,1,0,0,1,1,1,0
12709,,,usahana612,0,1,1,0,1,1,0,0,1,1,1,0
12710,,,boiledbao,0,1,1,0,1,1,0,0,1,1,1,0
12711,,,QuintupleFlop,0,1,1,0,1,1,0,0,1,1,1,0
12712,,,DrChenMD,0,1,1,0,1,1,0,0,1,1,1,0
12713,,,mkyxxf,0,1,1,0,1,1,0,0,1,1,1,0
12714,,,ReSinanian,0,1,1,0,1,1,0,0,1,1,1,0
12715,,,ChakristRazuli,0,1,1,0,1,1,0,0,1,1,1,0
12716,,,sanapottah_,0,1,1,0,1,1,0,0,1,1,1,0
12717,,,sadist_bbypink,0,1,1,0,1,1,0,0,1,1,1,0
12718,,,a_gam3s,0,1,1,0,1,1,0,0,1,1,1,0
12719,,,k43amduvk,34,1,35,37,1,38,0.029412,0.227363,0,0,0,0
12720,,,taechna,0,1,1,0,1,1,0,0,1,1,1,0
12721,,,Marmarescobar,0,2,2,0,2,2,0,0,1,1,1,0
12722,,,Nadej_no,0,1,1,0,2,2,0,0,1,1,1,0
12723,,,hana_onthego,0,1,1,0,1,1,0,0,1,1,1,0
12724,,,taesbaeday,0,1,1,0,1,1,0,0,1,1,1,0
12725,,,joycedcanada,0,1,1,0,1,1,0,0,1,1,1,0
12726,,,AsseleTs13,0,1,1,0,1,1,0,0,1,1,1,0
12727,,,sei134340,0,1,1,0,1,1,0,0,1,1,1,0
12728,,,DaeguMinBasket,0,1,1,0,1,1,0,0,1,1,1,0
12729,,,EmilyTenjo,0,1,1,0,1,1,0,0,1,1,1,0
12730,,,babiekento,0,1,1,0,1,1,0,0,1,1,1,0
12731,,,LauraHuffman18,0,1,1,0,1,1,0,0,1,1,1,0
12732,,,mimixsoob,0,1,1,0,1,1,0,0,1,1,1,0
12733,,,rospham,0,1,1,0,1,1,0,0,1,1,1,0
12734,,,Avant_G,0,1,1,0,1,1,0,0,1,1,1,0
12735,,,wintertxts,0,1,1,0,1,1,0,0,1,1,1,0
12736,,,amiewose,0,1,1,0,1,1,0,0,1,1,1,0
12737,,,desiderario,0,2,2,0,2,2,0,0,1,1,1,0
12738,,,CHASINGJIMIN,0,1,1,0,1,1,0,0,1,1,1,0
12739,,,queeringaround,0,1,1,0,1,1,0,0,1,1,1,0
12740,,,lazarettoo,0,1,1,0,1,1,0,0,1,1,1,0
12741,,,jennyjanka16,0,1,1,0,1,1,0,0,1,1,1,0
12742,,,pivex_twt,0,1,1,0,1,1,0,0,1,1,1,0
12743,,,amaterumiko,0,1,1,0,1,1,0,0,1,1,1,0
12744,,,sehunsbestie,0,1,1,0,1,1,0,0,1,1,1,0
12745,,,minsgv,0,1,1,0,1,1,0,0,1,1,1,0
12746,,,_Erzsebet,0,1,1,0,1,1,0,0,1,1,1,0
12747,,,flowerdae4,6,1,7,6,1,7,0.166667,0.040123,0,0,0,0
12748,,,sjmn777,0,1,1,0,1,1,0,0,1,1,1,0
12749,,,Hanlingfr,0,1,1,0,1,1,0,0,1,1,1,0
12750,,,nighatbutt1987,3,1,4,3,1,4,0.333333,0.020061,0,0,0,0
12751,,,EMILIAALTUNA99,0,1,1,0,1,1,0,0,1,1,1,0
12752,,,Varna,0,1,1,0,1,1,0,0,1,1,1,0
12753,,,pattiann800,14,1,15,14,1,15,0.071429,0.09362,0,0,0,0
12754,,,kassotaa,0,1,1,0,1,1,0,0,1,1,1,0
12755,,,chanyeolnooo,0,1,1,0,1,1,0,0,1,1,1,0
12756,,,Komihad,0,1,1,0,1,1,0,0,1,1,1,0
12757,,,alaskinny,0,1,1,0,1,1,0,0,1,1,1,0
12758,,,AshtenSymone,0,1,1,0,1,1,0,0,1,1,1,0
12759,,,monsuima,0,1,1,0,1,1,0,0,1,1,1,0
12760,,,Pickle46978731,0,6,6,0,8,8,0,0,1,1,1,0
12761,,,epheebaoey,0,1,1,0,1,1,0,0,1,1,1,0
12762,,,leosmayashi,0,1,1,0,1,1,0,0,1,1,1,0
12763,,,cateyxdubs,0,1,1,0,1,1,0,0,1,1,1,0
12764,,,melinaagld,0,2,2,0,2,2,0,0,1,1,1,0
12765,,,KrisWinters,3,1,4,3,1,4,0.333333,0.020061,0,0,0,0
12766,,,yushihuangg,0,1,1,0,1,1,0,0,1,1,1,0
12767,,,sportscultureco,0,1,1,0,1,1,0,0,1,1,1,0
12768,,,beautifulflora7,0,1,1,0,1,1,0,0,2,0.666667,0.75,0
12769,,,slnnsnw,0,1,1,0,1,1,0,0,2,0.666667,0.75,0
12770,,,OldGunix,0,1,1,0,1,1,0,0,2,0.666667,0.75,0
12771,,,Aru5994,4,1,5,4,1,5,0.25,0.026749,0,0,0,0
12772,,,mydesu,0,1,1,0,1,1,0,0,1,1,1,0
12773,,,yumyumyumtom,0,1,1,0,1,1,0,0,1,1,1,0
12774,,,kurapikafarted,0,1,1,0,1,1,0,0,1,1,1,0
12775,,,Btsarmyinfires1,3,1,4,3,1,4,0.333333,0.020061,0,0,0,0
12776,,,goodnighthtm1,0,1,1,0,1,1,0,0,1,1,1,0
12777,,,AtzYeoHwa,0,1,1,0,1,1,0,0,1,1,1,0
12778,,,brd_dispatch,5,1,6,5,1,6,0.2,0.033436,0,0,0,0
12779,,,anthocerotae,0,1,1,0,1,1,0,0,1,1,1,0
12780,,,DrDeathlyMoon,0,1,1,0,1,1,0,0,1,1,1,0
12781,,,hatchdent,0,1,1,0,1,1,0,0,1,1,1,0
12782,,,ilovepie84,0,1,1,0,1,1,0,0,1,1,1,0
12783,,,dannyehuanmx,0,1,1,0,1,1,0,0,1,1,1,0
12784,,,3a3t0721,0,1,1,0,1,1,0,0,1,1,1,0
12785,,,MagsChiff,6,1,7,6,1,7,0.166667,0.040123,0,0,0,0
12786,,,lcvedohyon,0,1,1,0,1,1,0,0,1,1,1,0
12787,,,ariadne_king,0,1,1,0,1,1,0,0,1,1,1,0
12788,,,drmlnchh,0,1,1,0,1,1,0,0,1,1,1,0
12789,,,dipdidaridu,0,1,1,0,1,1,0,0,1,1,1,0
12790,,,Ob_Oon,0,1,1,0,1,1,0,0,1,1,1,0
12791,,,jnoverse,3,1,4,3,1,4,0.333333,0.020061,0,0,0,0
12792,,,JMKaix,0,1,1,0,1,1,0,0,1,1,1,0
12793,,,envity1stgen4,0,1,1,0,1,1,0,0,1,1,1,0
12794,,,venommxj,1,1,2,1,1,2,0,0.006687,0,0,0,0
12795,,,burntbabyfoetus,0,1,1,0,1,1,0,0,1,1,1,0
12796,,,rebecaleal36,0,1,1,0,1,1,0,0,1,1,1,0
12797,,,KGNSnews,5,1,6,5,1,6,0.2,0.033436,0,0,0,0
12798,,,riorsope,0,1,1,0,1,1,0,0,1,1,1,0
12799,,,Croozhive,0,1,1,0,1,1,0,0,1,1,1,0
12800,,,wherezmyhair,0,1,1,0,1,1,0,0,1,1,1,0
12801,,,MaggieAnn1222,0,1,1,0,1,1,0,0,1,1,1,0
12802,,,kurapikachuuuu,0,1,1,0,1,1,0,0,1,1,1,0
12803,,,Shinoliaa,7,1,8,7,1,8,0,0.071355,1,1,1,22
12804,,,getosboobies,0,1,1,0,1,1,0,0,1,1,1,0
12805,,,geckogirl23,0,1,1,0,1,1,0,0,1,1,1,0
12806,,,worninninin,0,1,1,0,1,1,0,0,1,1,1,0
12807,,,shadow_curator,0,1,1,0,1,1,0,0,1,1,1,0
12808,,,Mitty74907422,9,1,10,10,1,11,0.111111,0.060184,0,0,0,0
12809,,,tiziano14882,0,1,1,0,2,2,0,0,1,1,1,0
12810,,,chaoticcgood,0,1,1,0,1,1,0,0,1,1,1,0
12811,,,ice_yoi,0,1,1,0,1,1,0,0,1,1,1,0
12812,,,CspankD,0,1,1,0,1,1,0,0,1,1,1,0
12813,,,beetwhoreven,0,1,1,0,1,1,0,0,1,1,1,0
12814,,,bbykyuju,0,1,1,0,1,1,0,0,1,1,1,0
12815,,,kyncity,5,1,6,5,1,6,0.2,0.033436,0,0,0,0
12816,,,lil_darlingx,0,1,1,0,1,1,0,0,1,1,1,0
12817,,,anne_mone8025,0,1,1,0,1,1,0,0,1,1,1,0
12818,,,bwiminbakbak,0,2,2,0,2,2,0,0,1,1,1,0
12819,,,WLWT,7,1,8,7,1,8,0.142857,0.04681,0,0,0,0
12820,,,NczNzIfLs04Iwa0,0,1,1,0,1,1,0,0,1,1,1,0
12821,,,LenaAndYoongi,0,1,1,0,1,1,0,0,1,1,1,0
12822,,,Anne_Brussels,0,1,1,0,1,1,0,0,1,1,1,0
12823,,,annadelphia,7,1,8,8,1,9,0.142857,0.04681,0,0,0,0
12824,,,hira9th,0,1,1,0,1,1,0,0,1,1,1,0
12825,,,yaki_nori,0,1,1,0,1,1,0,0,1,1,1,0
12826,,,Khrisstine2,0,1,1,0,1,1,0,0,1,1,1,0
12827,,,minchaeco,0,1,1,0,1,1,0,0,1,1,1,0
12828,,,the_devilishdoc,0,1,1,0,1,1,0,0,1,1,1,0
12829,,,CaineLido,7,1,8,7,1,8,0.142857,0.054992,0,0,0,0
12830,,,ririblast_1t,0,1,1,0,1,1,0,0,1,1,1,0
12831,,,qifruit,0,1,1,0,1,1,0,0,1,1,1,0
12832,,,Alphabet__L,0,1,1,0,1,1,0,0,1,1,1,0
12833,,,bahmjeon,0,1,1,0,1,1,0,0,1,1,1,0
12834,,,HenesKade,0,1,1,0,1,1,0,0,1,1,1,0
12835,,,yoongiaugustD,0,1,1,0,1,1,0,0,1,1,1,0
12836,,,na1ka21,0,1,1,0,1,1,0,0,1,1,1,0
12837,,,carolfury,2,1,3,2,1,3,0.5,0.013374,0,0,0,0
12838,,,nazuwuna,1,1,2,1,1,2,0,0.006687,0,0,0,0
12839,,,saisikisiki,0,1,1,0,1,1,0,0,2,0.666667,0.75,0
12840,,,strawberrychims,0,1,1,0,1,1,0,0,2,0.666667,0.75,0
12841,,,kozukag,0,1,1,0,1,1,0,0,2,0.666667,0.75,0
12842,,,peachsunj,0,1,1,0,1,1,0,0,2,0.666667,0.75,0
12843,,,Watcher0033,0,1,1,0,1,1,0,0,2,0.666667,0.75,0
12844,,,KanonKonna,0,1,1,0,1,1,0,0,2,0.666667,0.75,0
12845,,,gnyp_,0,1,1,0,1,1,0,0,2,0.666667,0.75,0
12846,,,Younique_ala_M,25,1,26,26,1,27,0.04,0.169906,0,0,0,0
12847,,,DanielaFierro03,0,1,1,0,1,1,0,0,1,1,1,0
12848,,,__unravel__,0,1,1,0,1,1,0,0,1,1,1,0
12849,,,kijitora321,0,1,1,0,1,1,0,0,1,1,1,0
12850,,,Alejand56307851,0,1,1,0,2,2,0,0,1,1,1,0
12851,,,AviFlyGirl,0,1,1,0,1,1,0,0,1,1,1,0
12852,,,SpriteB,0,1,1,0,1,1,0,0,1,1,1,0
12853,,,astridherondale,1,1,2,1,1,2,0,0.00396,1,1,1,1
12854,,,BTS_Princess_3,0,1,1,0,1,1,0,0,1,1,1,0
12855,,,moodyblue_1977,0,1,1,0,1,1,0,0,1,1,1,0
12856,,,360CNN,0,1,1,0,1,1,0,0,1,1,1,0
12857,,,hippypeaches,0,1,1,0,1,1,0,0,1,1,1,0
12858,,,ttokarrok,0,1,1,0,1,1,0,0,1,1,1,0
12859,,,agusttd3_,0,1,1,0,1,1,0,0,1,1,1,0
12860,,,amidala2112,0,1,1,0,1,1,0,0,1,1,1,0
12861,,,clashpandaRay1,0,1,1,0,1,1,0,0,1,1,1,0
12862,,,_lildeath,0,1,1,0,1,1,0,0,1,1,1,0
12863,,,VVIPallRed,0,1,1,0,1,1,0,0,1,1,1,0
12864,,,thenewpaper,0,1,1,0,1,1,0,0,1,1,1,0
12865,,,_mashu_hiso,0,1,1,0,1,1,0,0,1,1,1,0
12866,,,MiliSans,0,1,1,0,1,1,0,0,1,1,1,0
12867,,,shayshaygold,6,1,7,6,1,7,0.166667,0.040123,0,0,0,0
12868,,,idkyzh05,0,1,1,0,1,1,0,0,1,1,1,0
12869,,,raknongtenlee,0,1,1,0,1,1,0,0,1,1,1,0
12870,,,PeaKathLa,0,1,1,0,1,1,0,0,1,1,1,0
12871,,,aquariusjm,0,1,1,0,1,1,0,0,1,1,1,0
12872,,,h0o0lly,4,1,5,4,1,5,0.25,0.026749,0,0,0,0
12873,,,SilvercorniX,0,1,1,0,1,1,0,0,1,1,1,0
12874,,,BoleynLoyalist,0,1,1,0,1,1,0,0,1,1,1,0
12875,,,Iuvssun,6,1,7,6,1,7,0.166667,0.040123,0,0,0,0
12876,,,nunezcrystalj,0,1,1,0,1,1,0,0,1,1,1,0
12877,,,ahgdstedawtd,0,1,1,0,1,1,0,0,1,1,1,0
12878,,,Probotype,0,1,1,0,1,1,0,0,1,1,1,0
12879,,,thecutestnemo,0,1,1,0,1,1,0,0,1,1,1,0
12880,,,y8nkook,0,2,2,0,2,2,0,0,1,1,1,0
12881,,,drwill_SuttonPl,7,1,8,7,1,8,0.142857,0.04681,0,0,0,0
12882,,,firenzve,0,1,1,0,1,1,0,0,1,1,1,0
12883,,,dwyAKAdawny,0,1,1,0,1,1,0,0,1,1,1,0
12884,,,iXIA0CORE,0,1,1,0,1,1,0,0,1,1,1,0
12885,,,vanesboo_,0,1,1,0,1,1,0,0,1,1,1,0
12886,,,ezmbri,0,1,1,0,1,1,0,0,1,1,1,0
12887,,,mmu_mimi,0,1,1,0,1,1,0,0,2,0.666667,0.75,0
12888,,,atticusexe,8,1,9,9,1,10,0.125,0.053497,0,0,0,0
12889,,,TokkiKOOKIE97,0,1,1,0,1,1,0,0,1,1,1,0
12890,,,min_agustd9393,0,1,1,0,1,1,0,0,1,1,1,0
12891,,,koolkat2826,0,1,1,0,2,2,0,0,1,1,1,0
12892,,,Driftingafloat,0,1,1,0,1,1,0,0,1,1,1,0
12893,,,zgdx_chelle,0,1,1,0,1,1,0,0,1,1,1,0
12894,,,KIKImegumari,0,1,1,0,1,1,0,0,1,1,1,0
12895,,,AdorSetou,0,1,1,0,1,1,0,0,1,1,1,0
12896,,,seira586k1,0,1,1,0,1,1,0,0,1,1,1,0
12897,,,JimsAltAccount1,0,1,1,0,1,1,0,0,1,1,1,0
12898,,,kiiirrrbyy,0,1,1,0,2,2,0,0,1,1,1,0
12899,,,99yawnzn,5,2,7,6,2,8,0.166667,0.033436,1,1,1,4
12900,,,MarcoOnTheRadio,2,1,3,2,1,3,0.5,0.013374,0,0,0,0
12901,,,HQisbest,0,2,2,0,3,3,0,0,2,0.75,0.833333,0
12902,,,sahanjjai,0,1,1,0,1,1,0,0,2,0.666667,0.75,0
12903,,,SKZisPoggers,0,1,1,0,1,1,0,0,2,0.666667,0.75,0
12904,,,DreamInColorDIC,2,1,3,2,1,3,0.5,0.013374,0,0,0,0
12905,,,jcuniverse16,16,1,17,16,1,17,0.0625,0.106994,0,0,0,0
12906,,,voremobeijun,0,1,1,0,1,1,0,0,1,1,1,0
12907,,,yuzurus__,0,1,1,0,1,1,0,0,1,1,1,0
12908,,,strwbrrynathan,0,1,1,0,1,1,0,0,1,1,1,0
12909,,,IGLV_05,0,1,1,0,1,1,0,0,1,1,1,0
12910,,,catffeineaddict,0,1,1,0,1,1,0,0,1,1,1,0
12911,,,_SingleBabyMama,0,2,2,0,2,2,0,0,1,1,1,0
12912,,,zaddy_zuzuu,0,1,1,0,1,1,0,0,1,1,1,0
12913,,,amiliyananana,0,1,1,0,1,1,0,0,1,1,1,0
12914,,,huit_bonheur,0,1,1,0,1,1,0,0,1,1,1,0
12915,,,acwcyac,0,1,1,0,1,1,0,0,1,1,1,0
12916,,,carin_colin_5,0,1,1,0,1,1,0,0,1,1,1,0
12917,,,msygolf,6,1,7,6,1,7,0.166667,0.040123,0,0,0,0
12918,,,daily_euphoria_,0,1,1,0,1,1,0,0,1,1,1,0
12919,,,obiwangji,0,1,1,0,1,1,0,0,1,1,1,0
12920,,,Yourwaifunurse,0,1,1,0,1,1,0,0,1,1,1,0
12921,,,skinniebinnie,0,1,1,0,1,1,0,0,1,1,1,0
12922,,,springsope07,0,1,1,0,1,1,0,0,1,1,1,0
12923,,,Y2KD0IE,2,1,3,2,1,3,0.5,0.013374,0,0,0,0
12924,,,karasunopan,0,1,1,0,1,1,0,0,1,1,1,0
12925,,,gadisbonding,4,1,5,4,1,5,0.25,0.033737,0,0,0,0
12926,,,blueazaleas,0,1,1,0,1,1,0,0,1,1,1,0
12927,,,renew0719,0,2,2,0,2,2,0,0,1,1,1,0
12928,,,Ukhthicc_,18,1,19,21,1,22,0.055556,0.120369,0,0,0,0
12929,,,yuzumemiyu,0,1,1,0,1,1,0,0,1,1,1,0
12930,,,M_a_de_li_ne,0,1,1,0,2,2,0,0,1,1,1,0
12931,,,_lanlan_0517,0,1,1,0,1,1,0,0,1,1,1,0
12932,,,Rotting_Apples,0,1,1,0,1,1,0,0,1,1,1,0
12933,,,mayuko_icecream,0,1,1,0,1,1,0,0,1,1,1,0
12934,,,hanyuyuzu1207,0,1,1,0,1,1,0,0,1,1,1,0
12935,,,Ducky8abug,0,1,1,0,1,1,0,0,1,1,1,0
12936,,,ohpleeznotagain,0,1,1,0,1,1,0,0,1,1,1,0
12937,,,bibi_chaaaa,0,1,1,0,1,1,0,0,1,1,1,0
12938,,,ToniKX3,0,1,1,0,1,1,0,0,1,1,1,0
12939,,,goma_cotton41,0,1,1,0,1,1,0,0,1,1,1,0
12940,,,Hinduxpress1,0,1,1,0,1,1,0,0,1,1,1,0
12941,,,veggie64_leslie,0,1,1,0,1,1,0,0,1,1,1,0
12942,,,multidisaster,0,2,2,0,2,2,0,0,2,0.75,0.833333,0
12943,,,jjksluvaffair,0,1,1,0,1,1,0,0,1,1,1,0
12944,,,ac4ayhtotw,0,1,1,0,1,1,0,0,1,1,1,0
12945,,,glizzzle,0,1,1,0,1,1,0,0,1,1,1,0
12946,,,ariataetae,0,1,1,0,1,1,0,0,1,1,1,0
12947,,,Mikanojo,0,1,1,0,1,1,0,0,1,1,1,0
12948,,,catyoongimin,0,1,1,0,1,1,0,0,3,0.5,0.566667,0
12949,,,Zizzani,0,2,2,0,2,2,0,0,3,0.545455,0.638889,0
12950,,,fhurtado,4,1,5,5,1,6,0.25,0.026749,0,0,0,0
12951,,,Axo_Dom,0,1,1,0,1,1,0,0,1,1,1,0
12952,,,chrollololol,0,1,1,0,1,1,0,0,1,1,1,0
12953,,,mygfightingme,0,1,1,0,1,1,0,0,1,1,1,0
12954,,,load_dependent,0,1,1,0,1,1,0,0,1,1,1,0
12955,,,snwuenthusiast,0,1,1,0,1,1,0,0,1,1,1,0
12956,,,pervsmutgirrl,0,1,1,0,1,1,0,0,1,1,1,0
12957,,,kawaiiwagakolov,0,1,1,0,1,1,0,0,1,1,1,0
12958,,,sourirecheoreom,0,2,2,0,2,2,0,0,1,1,1,0
12959,,,henriette001129,0,1,1,0,1,1,0,0,1,1,1,0
12960,,,sunshinenonie,10,1,11,12,1,13,0.1,0.066871,0,0,0,0
12961,,,lleiakae,0,1,1,0,1,1,0,0,1,1,1,0
12962,,,sugarplumkittY,0,1,1,0,1,1,0,0,1,1,1,0
12963,,,lvsdrak3n,0,2,2,0,2,2,0,0,1,1,1,0
12964,,,hugonamba,0,2,2,0,2,2,0,0,1,1,1,0
12965,,,yoonguistic,0,1,1,0,1,1,0,0,1,1,1,0
12966,,,silaaaaaaaaa123,0,1,1,0,1,1,0,0,1,1,1,0
12967,,,lemonafrisia,0,1,1,0,1,1,0,0,1,1,1,0
12968,,,fullmetalklit,12,1,13,13,1,14,0.083333,0.080246,0,0,0,0
12969,,,neocitytime,0,1,1,0,1,1,0,0,1,1,1,0
12970,,,minqtxt,0,1,1,0,1,1,0,0,1,1,1,0
12971,,,alcleynnn,0,1,1,0,1,1,0,0,1,1,1,0
12972,,,jpostman,0,1,1,0,1,1,0,0,1,1,1,0
12973,,,lrntdevere,0,1,1,0,1,1,0,0,1,1,1,0
12974,,,carolinefan,0,1,1,0,1,1,0,0,1,1,1,0
12975,,,6luesparks,0,1,1,0,1,1,0,0,1,1,1,0
12976,,,Sayulett,0,1,1,0,1,1,0,0,1,1,1,0
12977,,,killersignals,3,1,4,3,1,4,0.333333,0.020061,0,0,0,0
12978,,,dprstear,1,1,2,1,1,2,0,0.006687,0,0,0,0
12979,,,yeozuru,1,1,2,1,1,2,0,0.006687,0,0,0,0
12980,,,MallamSawyerr,0,1,1,0,1,1,0,0,1,1,1,0
12981,,,some_vs,2,1,3,2,1,3,0.5,0.013374,0,0,0,0
12982,,,gldenkoobi,0,1,1,0,1,1,0,0,1,1,1,0
12983,,,bbabiebbh,0,1,1,0,1,1,0,0,1,1,1,0
12984,,,yokkiemeeped,0,1,1,0,1,1,0,0,1,1,1,0
12985,,,ProHercKacchan,0,1,1,0,1,1,0,0,2,0.6,0.666667,0
12986,,,arachick_05,0,2,2,0,2,2,0,0,2,0.75,0.833333,0
12987,,,softoby,15,1,16,19,1,20,0.066667,0.117778,0,0,0,0
12988,,,rhcm123,0,1,1,0,4,4,0,0,1,1,1,0
12989,,,kennerff,0,1,1,0,1,1,0,0,1,1,1,0
12990,,,hachetw,0,1,1,0,1,1,0,0,1,1,1,0
12991,,,jooniesbonsai94,0,2,2,0,2,2,0,0,1,1,1,0
12992,,,Nancikhogan,0,1,1,0,1,1,0,0,1,1,1,0
12993,,,Justin_Klos,0,1,1,0,1,1,0,0,1,1,1,0
12994,,,texturedghost,0,1,1,0,1,1,0,0,1,1,1,0
12995,,,HPandaA,0,1,1,0,1,1,0,0,1,1,1,0
12996,,,FierceFrankie1,18,1,19,20,1,21,0.055556,0.120369,0,0,0,0
12997,,,ggesmer,0,1,1,0,1,1,0,0,1,1,1,0
12998,,,stan_yordanov,0,1,1,0,1,1,0,0,1,1,1,0
12999,,,Daannyuki,0,1,1,0,1,1,0,0,1,1,1,0
13000,,,jessmarine_,0,1,1,0,1,1,0,0,1,1,1,0
13001,,,francakeszz,0,1,1,0,1,1,0,0,1,1,1,0
13002,,,nichiyoubisan,0,1,1,0,1,1,0,0,1,1,1,0
13003,,,jkpogi01,0,1,1,0,1,1,0,0,1,1,1,0
13004,,,Lotus_drop06,0,1,1,0,1,1,0,0,1,1,1,0
13005,,,TheScottMillen,0,1,1,0,1,1,0,0,1,1,1,0
13006,,,pretoreyn,0,1,1,0,1,1,0,0,1,1,1,0
13007,,,l_saffron,0,1,1,0,1,1,0,0,1,1,1,0
13008,,,16Supichaya,0,1,1,0,1,1,0,0,1,1,1,0
13009,,,Xbackwardsx,2,1,3,2,1,3,0.5,0.013374,0,0,0,0
13010,,,lexokan1,0,1,1,0,1,1,0,0,1,1,1,0
13011,,,bunkookssi,0,1,1,0,1,1,0,0,1,1,1,0
13012,,,RainbowBitxh22,0,1,1,0,1,1,0,0,1,1,1,0
13013,,,HakuIlona,0,1,1,0,1,1,0,0,1,1,1,0
13014,,,Dancerchic122,0,1,1,0,1,1,0,0,1,1,1,0
13015,,,iHoldKaidou,0,1,1,0,1,1,0,0,1,1,1,0
13016,,,bangtansit0,0,1,1,0,1,1,0,0,1,1,1,0
13017,,,miengtian,0,1,1,0,1,1,0,0,1,1,1,0
13018,,,squitwordd,0,1,1,0,1,1,0,0,1,1,1,0
13019,,,PreppyDude,1,1,2,1,1,2,0,0.006687,0,0,0,0
13020,,,Tony86757967,4,1,5,4,1,5,0.25,0.026749,0,0,0,0
13021,,,__nxture,0,1,1,0,1,1,0,0,1,1,1,0
13022,,,AskDearNexus,0,1,1,0,1,1,0,0,1,1,1,0
13023,,,AWayofLife0,0,1,1,0,1,1,0,0,1,1,1,0
13024,,,upontaintedones,16,1,17,17,2,19,0.0625,0.106994,0,0,0,0
13025,,,kavnxshi,0,1,1,0,1,1,0,0,1,1,1,0
13026,,,_sxxyoung_,0,1,1,0,1,1,0,0,1,1,1,0
13027,,,Y_Coraima_,0,1,1,0,1,1,0,0,1,1,1,0
13028,,,l_eliza57,3,1,4,3,1,4,0.333333,0.020061,0,0,0,0
13029,,,jazz8080,0,1,1,0,1,1,0,0,1,1,1,0
13030,,,wheen_in,0,1,1,0,1,1,0,0,1,1,1,0
13031,,,Iuvkkura,5,1,6,5,1,6,0.2,0.033436,0,0,0,0
13032,,,reiing17,0,1,1,0,1,1,0,0,1,1,1,0
13033,,,kobxvxshi,0,1,1,0,1,1,0,0,1,1,1,0
13034,,,SydneySiler,0,1,1,0,1,1,0,0,1,1,1,0
13035,,,28flwr,0,2,2,0,2,2,0,0,1,1,1,0
13036,,,silk_nightmare,1,1,2,1,1,2,0,0.006687,0,0,0,0
13037,,,Chloe09161806,1,1,2,1,1,2,0,0.006687,0,0,0,0
13038,,,tpham26863223,2,1,3,2,1,3,0.5,0.013374,0,0,0,0
13039,,,_Gobbledigook_,0,1,1,0,1,1,0,0,1,1,1,0
13040,,,infirmly,0,2,2,0,2,2,0,0,1,1,1,0
13041,,,wwwdotyeedotcom,0,1,1,0,1,1,0,0,1,1,1,0
13042,,,Aikimochiiy,0,1,1,0,1,1,0,0,1,1,1,0
13043,,,VoorheesZaine,0,1,1,0,1,1,0,0,1,1,1,0
13044,,,cutsew2016,0,1,1,0,1,1,0,0,1,1,1,0
13045,,,jvaejvictis,0,1,1,0,1,1,0,0,1,1,1,0
13046,,,KarenKarenson5,2,1,3,2,1,3,0.5,0.013374,0,0,0,0
13047,,,nikkuhanasoba,0,1,1,0,1,1,0,0,1,1,1,0
13048,,,beaner803,11,1,12,11,1,12,0.090909,0.073559,0,0,0,0
13049,,,Sugafreesugar,0,1,1,0,1,1,0,0,1,1,1,0
13050,,,joonsrxse,0,1,1,0,1,1,0,0,1,1,1,0
13051,,,little_mochi12,0,1,1,0,1,1,0,0,1,1,1,0
13052,,,mtsdlr,0,1,1,0,1,1,0,0,1,1,1,0
13053,,,litzcarti,0,1,1,0,1,1,0,0,1,1,1,0
13054,,,Findjulie,0,1,1,0,1,1,0,0,1,1,1,0
13055,,,GN134340,0,1,1,0,1,1,0,0,1,1,1,0
13056,,,ii_luvmusic,0,1,1,0,1,1,0,0,1,1,1,0
13057,,,ghostccity,9,1,10,9,1,10,0.111111,0.149944,0,0,0,0
13058,,,vivianjiang00,0,1,1,0,1,1,0,0,1,1,1,0
13059,,,YUZULEAFzcy,0,1,1,0,1,1,0,0,1,1,1,0
13060,,,DarrahHarold,0,1,1,0,1,1,0,0,1,1,1,0
13061,,,valxei,0,1,1,0,1,1,0,0,1,1,1,0
13062,,,BlueOc1981,6,1,7,7,1,8,0.166667,0.040123,0,0,0,0
13063,,,Ssimms777,0,3,3,0,4,4,0,0,1,1,1,0
13064,,,duhior,2,1,3,2,1,3,0.5,0.013374,0,0,0,0
13065,,,pIutotae,0,1,1,0,1,1,0,0,1,1,1,0
13066,,,bach753,0,1,1,0,1,1,0,0,1,1,1,0
13067,,,ayumiskdjv,0,1,1,0,1,1,0,0,2,0.666667,0.75,0
13068,,,unaisthebest3,0,1,1,0,1,1,0,0,1,1,1,0
13069,,,J00NSPARK,0,1,1,0,1,1,0,0,1,1,1,0
13070,,,megan_claire28,0,1,1,0,1,1,0,0,1,1,1,0
13071,,,DanaLau1988,7,1,8,7,1,8,0.142857,0.057293,0,0,0,0
13072,,,majeed_hania,0,1,1,0,1,1,0,0,1,1,1,0
13073,,,SafiraVera,0,1,1,0,1,1,0,0,1,1,1,0
13074,,,yarieso_j,0,1,1,0,1,1,0,0,1,1,1,0
13075,,,saphyers,0,1,1,0,1,1,0,0,1,1,1,0
13076,,,astorgabeaa,2,1,3,2,1,3,0.5,0.013374,0,0,0,0
13077,,,ilvslangaa,0,1,1,0,1,1,0,0,1,1,1,0
13078,,,ItsAllyVega,5,1,6,5,1,6,0.2,0.033436,0,0,0,0
13079,,,knightdriver74,0,1,1,0,1,1,0,0,1,1,1,0
13080,,,dfrozeee,0,1,1,0,1,1,0,0,1,1,1,0
13081,,,szeanng,0,2,2,0,2,2,0,0,3,0.5,0.595238,0
13082,,,mugen_sp,0,1,1,0,1,1,0,0,1,1,1,0
13083,,,L1LACH3ART,0,1,1,0,1,1,0,0,1,1,1,0
13084,,,shio_kaze7,0,1,1,0,1,1,0,0,1,1,1,0
13085,,,earlgreywolff,0,1,1,0,1,1,0,0,1,1,1,0
13086,,,ppingpg,0,1,1,0,1,1,0,0,1,1,1,0
13087,,,xiaotuzi_bo,0,1,1,0,1,1,0,0,1,1,1,0
13088,,,tsktskpfft_,0,1,1,0,1,1,0,0,1,1,1,0
13089,,,malacree,0,1,1,0,1,1,0,0,1,1,1,0
13090,,,natsukashii6,0,1,1,0,1,1,0,0,1,1,1,0
13091,,,joyfullyran,0,1,1,0,1,1,0,0,1,1,1,0
13092,,,army7forever,0,1,1,0,1,1,0,0,1,1,1,0
13093,,,LadyCat311,0,1,1,0,1,1,0,0,1,1,1,0
13094,,,Hani_paradise7,0,1,1,0,1,1,0,0,2,0.538462,0.571429,0
13095,,,ramenwithgyoza,0,1,1,0,1,1,0,0,2,0.538462,0.571429,0
13096,,,DrMelissaSimon,0,1,1,0,1,1,0,0,2,0.538462,0.571429,0
13097,,,pkwl95_,0,1,1,0,1,1,0,0,2,0.538462,0.571429,0
13098,,,kkklf____,0,1,1,0,1,1,0,0,2,0.538462,0.571429,0
13099,,,pileofrat,3,1,4,3,1,4,0.333333,0.020061,0,0,0,0
13100,,,bfsyoonminn,0,1,1,0,1,1,0,0,1,1,1,0
13101,,,The_SpookyEri,0,1,1,0,1,1,0,0,1,1,1,0
13102,,,wifelytaemin,0,1,1,0,1,1,0,0,1,1,1,0
13103,,,maripazberlin,1,1,2,1,1,2,0,0.006687,0,0,0,0
13104,,,chan_nng,1,1,2,1,1,2,0,0.006687,0,0,0,0
13105,,,cinema_cat5,2,1,3,2,1,3,0.5,0.013374,0,0,0,0
13106,,,popomi0,0,1,1,0,1,1,0,0,1,1,1,0
13107,,,robotsimmons,1,1,2,1,1,2,0,0.006687,0,0,0,0
13108,,,PAstynome,8,1,9,8,1,9,0.125,0.053497,0,0,0,0
13109,,,rmjkreal,0,1,1,0,1,1,0,0,1,1,1,0
13110,,,fontane_lo,0,1,1,0,1,1,0,0,1,1,1,0
13111,,,taxianjjs_,0,1,1,0,1,1,0,0,1,1,1,0
13112,,,machanpopo721a1,0,1,1,0,1,1,0,0,1,1,1,0
13113,,,connnie_wan,0,1,1,0,1,1,0,0,1,1,1,0
13114,,,gaabbbiiii_,0,1,1,0,1,1,0,0,1,1,1,0
13115,,,PkrlhP,0,1,1,0,1,1,0,0,1,1,1,0
13116,,,SijunChen1,11,1,12,12,2,14,0.090909,0.073559,0,0,0,0
13117,,,arlene_schier,0,1,1,0,1,1,0,0,1,1,1,0
13118,,,aimeesoph,4,1,5,4,1,5,0.25,0.026749,0,0,0,0
13119,,,DDaCrema1,0,1,1,0,1,1,0,0,1,1,1,0
13120,,,TaeHanyu,0,3,3,0,3,3,0,0,1,1,1,0
13121,,,daziekittie,0,1,1,0,1,1,0,0,1,1,1,0
13122,,,MrsAutumn__,8,1,9,8,1,9,0.125,0.056991,0,0,0,0
13123,,,cholobaji,0,1,1,0,1,1,0,0,1,1,1,0
13124,,,andreasnohsia,0,1,1,0,1,1,0,0,1,1,1,0
13125,,,CHRISTINELEM007,0,1,1,0,1,1,0,0,1,1,1,0
13126,,,boonotboss,0,2,2,0,4,4,0,0,1,1,1,0
13127,,,busyxfangirling,0,1,1,0,1,1,0,0,1,1,1,0
13128,,,jungsuthnkr,0,1,1,0,1,1,0,0,1,1,1,0
13129,,,rochreads17,0,1,1,0,1,1,0,0,1,1,1,0
13130,,,A_s_h_l_i_n,0,1,1,0,1,1,0,0,1,1,1,0
13131,,,tanmen_c,0,1,1,0,1,1,0,0,1,1,1,0
13132,,,kimtehyoung,0,1,1,0,1,1,0,0,1,1,1,0
13133,,,johnklin,1,2,3,1,2,3,0.5,0.006687,1,1,1,0
13134,,,ddnsg,15,1,16,17,1,18,0.066667,0.121272,0,0,0,0
13135,,,0Ritsumafu,0,1,1,0,1,1,0,0,1,1,1,0
13136,,,Lalala_frio,0,3,3,0,3,3,0,0,1,1,1,0
13137,,,Irisbde125,0,1,1,0,1,1,0,0,1,1,1,0
13138,,,__bubblebabe,0,1,1,0,1,1,0,0,1,1,1,0
13139,,,ojyujyuo,0,1,1,0,1,1,0,0,1,1,1,0
13140,,,omistsumu,0,1,1,0,1,1,0,0,1,1,1,0
13141,,,Chummy23133389,0,1,1,0,1,1,0,0,1,1,1,0
13142,,,megskz,0,1,1,0,1,1,0,0,1,1,1,0
13143,,,oOMinnow,0,1,1,0,1,1,0,0,1,1,1,0
13144,,,kk718_1214ss,0,2,2,0,2,2,0,0,1,1,1,0
13145,,,dazedlaurie,14,1,15,14,1,15,0.071429,0.09362,0,0,0,0
13146,,,marichromatic,0,1,1,0,1,1,0,0,1,1,1,0
13147,,,NataliaPurple07,0,1,1,0,1,1,0,0,1,1,1,0
13148,,,egoistyeri,0,1,1,0,1,1,0,0,1,1,1,0
13149,,,JoeyParry_,0,1,1,0,1,1,0,0,1,1,1,0
13150,,,neptuningfork,0,1,1,0,1,1,0,0,1,1,1,0
13151,,,yoonsith,0,1,1,0,1,1,0,0,1,1,1,0
13152,,,baekfltr,0,1,1,0,1,1,0,0,1,1,1,0
13153,,,Rash_k9592,0,1,1,0,1,1,0,0,1,1,1,0
13154,,,stanyeol_,0,1,1,0,1,1,0,0,1,1,1,0
13155,,,FVCKbetty,0,2,2,0,2,2,0,0,1,1,1,0
13156,,,hiimjustyoung,5,1,6,5,1,6,0.2,0.033436,0,0,0,0
13157,,,fata_morganaxx,0,1,1,0,1,1,0,0,1,1,1,0
13158,,,_alleycatjimin,0,1,1,0,1,1,0,0,1,1,1,0
13159,,,verycarrie,0,1,1,0,1,1,0,0,1,1,1,0
13160,,,polygirl32,0,2,2,0,2,2,0,0,1,1,1,0
13161,,,dailyrepublic,2,1,3,2,1,3,0.5,0.013374,0,0,0,0
13162,,,chaergay,0,1,1,0,1,1,0,0,1,1,1,0
13163,,,NewDarkLegend1,0,1,1,0,1,1,0,0,1,1,1,0
13164,,,bradleyxie,0,1,1,0,1,1,0,0,1,1,1,0
13165,,,enews,4,1,5,4,1,5,0.25,0.026749,0,0,0,0
13166,,,starfellprince,0,1,1,0,1,1,0,0,1,1,1,0
13167,,,jaiipsssssqt,0,2,2,0,2,2,0,0,1,1,1,0
13168,,,rkivehyejin,0,1,1,0,1,1,0,0,1,1,1,0
13169,,,Peachy10975727,0,1,1,0,1,1,0,0,1,1,1,0
13170,,,JustAhFanBoy,0,1,1,0,1,1,0,0,1,1,1,0
13171,,,strawberijoonie,0,1,1,0,1,1,0,0,1,1,1,0
13172,,,CanesWorld,0,1,1,0,1,1,0,0,1,1,1,0
13173,,,itsnawmepewe,0,1,1,0,1,1,0,0,1,1,1,0
13174,,,kllinglies,0,1,1,0,1,1,0,0,1,1,1,0
13175,,,JChengWSJ,6,1,7,6,1,7,0.166667,0.040123,0,0,0,0
13176,,,jjisva,0,1,1,0,1,1,0,0,1,1,1,0
13177,,,eihsk,0,1,1,0,1,1,0,0,1,1,1,0
13178,,,ustalpomogite,0,1,1,0,1,1,0,0,1,1,1,0
13179,,,tiddieguk,0,1,1,0,1,1,0,0,1,1,1,0
13180,,,tatibanayua,0,1,1,0,1,1,0,0,1,1,1,0
13181,,,DimiBlaidydd,0,1,1,0,1,1,0,0,1,1,1,0
13182,,,zuno_roco777,0,1,1,0,1,1,0,0,1,1,1,0
13183,,,MsPixiefly,0,1,1,0,1,1,0,0,1,1,1,0
13184,,,LordSoo,0,1,1,0,1,1,0,0,1,1,1,0
13185,,,m_e_i_1_3,0,1,1,0,1,1,0,0,1,1,1,0
13186,,,vkjha62,11,1,12,12,1,13,0.090909,0.087195,0,0,0,0
13187,,,JKazerounian,0,2,2,0,3,3,0,0,1,1,1,0
13188,,,QueenScarlett,0,2,2,0,2,2,0,0,1,1,1,0
13189,,,ChirlyGalvan,5,2,7,5,2,7,0,0.0198,1,1,1,10
13190,,,iridescentsung,0,1,1,0,1,1,0,0,1,1,1,0
13191,,,mimimoriarty,0,1,1,0,1,1,0,0,1,1,1,0
13192,,,BtsYizhan,0,1,1,0,1,1,0,0,1,1,1,0
13193,,,wandahobi,0,1,1,0,1,1,0,0,1,1,1,0
13194,,,starIightyg,0,1,1,0,1,1,0,0,1,1,1,0
13195,,,Imadxsxstxr,0,1,1,0,1,1,0,0,1,1,1,0
13196,,,rara810,0,1,1,0,1,1,0,0,1,1,1,0
13197,,,uzuiversal,10,1,11,10,1,11,0.1,0.066871,0,0,0,0
13198,,,yukilogue,0,1,1,0,1,1,0,0,1,1,1,0
13199,,,IoveIovedeluxe,0,1,1,0,1,1,0,0,1,1,1,0
13200,,,ligayaiis,0,1,1,0,1,1,0,0,1,1,1,0
13201,,,taegoghV,0,1,1,0,1,1,0,0,1,1,1,0
13202,,,COCO_leox,0,1,1,0,1,1,0,0,1,1,1,0
13203,,,taiteez,0,1,1,0,1,1,0,0,1,1,1,0
13204,,,Puk_G7XOXO,0,1,1,0,1,1,0,0,1,1,1,0
13205,,,AgeofIrony,11,1,12,12,1,13,0.090909,0.073559,0,0,0,0
13206,,,sansuhnamgalaxy,0,1,1,0,1,1,0,0,1,1,1,0
13207,,,TbzBurger,0,1,1,0,1,1,0,0,1,1,1,0
13208,,,bunnymiyano,0,1,1,0,1,1,0,0,1,1,1,0
13209,,,ceridomateez,0,2,2,0,2,2,0,0,1,1,1,0
13210,,,wweihae,0,1,1,0,1,1,0,0,1,1,1,0
13211,,,MichaelWHughes3,0,1,1,0,1,1,0,0,1,1,1,0
13212,,,airwuddhuzakki,0,1,1,0,1,1,0,0,1,1,1,0
13213,,,kwimicament,0,2,2,0,3,3,0,0,1,1,1,0
13214,,,LiuYongfu6,3,1,4,3,1,4,0.333333,0.020061,0,0,0,0
13215,,,swiftstruffles,0,1,1,0,1,1,0,0,1,1,1,0
13216,,,judith_hand,4,1,5,4,1,5,0.25,0.026749,0,0,0,0
13217,,,cozy_chennie,0,1,1,0,1,1,0,0,1,1,1,0
13218,,,gaysunsun,0,1,1,0,1,1,0,0,1,1,1,0
13219,,,shephard_neil,0,1,1,0,1,1,0,0,1,1,1,0
13220,,,pepinoxiao,0,1,1,0,1,1,0,0,1,1,1,0
13221,,,shiraxyaw,0,1,1,0,1,1,0,0,1,1,1,0
13222,,,midwaloo,8,1,9,9,1,10,0.125,0.061679,0,0,0,0
13223,,,Iahkokbisa,0,1,1,0,1,1,0,0,1,1,1,0
13224,,,a_almond1msncom,0,2,2,0,2,2,0,0,1,1,1,0
13225,,,DoKscho,0,1,1,0,1,1,0,0,1,1,1,0
13226,,,business,2,1,3,2,1,3,0.5,0.013374,0,0,0,0
13227,,,bloodlinesoju,0,1,1,0,1,1,0,0,1,1,1,0
13228,,,KATUNews,6,1,7,7,1,8,0.166667,0.068077,0,0,0,0
13229,,,meljoden,8,2,10,8,2,10,0.111111,0.053497,1,1,1,7
13230,,,burre0901,0,1,1,0,1,1,0,0,1,1,1,0
13231,,,streussal,0,1,1,0,1,1,0,0,1,1,1,0
13232,,,TdashBABY_,4,1,5,4,1,5,0.25,0.026749,0,0,0,0
13233,,,itshannhel,0,1,1,0,1,1,0,0,1,1,1,0
13234,,,Melody_C11,0,1,1,0,1,1,0,0,1,1,1,0
13235,,,JessieSpeak,2,1,3,2,1,3,0.5,0.013374,0,0,0,0
13236,,,lorreiysimp,0,1,1,0,1,1,0,0,1,1,1,0
13237,,,schrutehaIpert,1,1,2,1,1,2,0,0.006687,0,0,0,0
13238,,,juliadnorwood,1,1,2,1,1,2,0,0.006687,0,0,0,0
13239,,,khit1075,11,1,12,11,1,12,0.090909,0.073559,0,0,0,0
13240,,,Gupton68,0,1,1,0,1,1,0,0,1,1,1,0
13241,,,non_beenary,0,1,1,0,1,1,0,0,1,1,1,0
13242,,,tachikoma24,0,1,1,0,1,1,0,0,1,1,1,0
13243,,,yinjiatong1,0,1,1,0,1,1,0,0,1,1,1,0
13244,,,CaroLambs,0,1,1,0,1,1,0,0,1,1,1,0
13245,,,urehoshiio,0,1,1,0,1,1,0,0,1,1,1,0
13246,,,justmgirl1,0,1,1,0,1,1,0,0,1,1,1,0
13247,,,kookspremium,0,1,1,0,1,1,0,0,1,1,1,0
13248,,,londeloo,0,1,1,0,1,1,0,0,1,1,1,0
13249,,,BlkBelleFlower,22,3,25,23,4,27,0.043478,0.182059,1,1,1,57
13250,,,Elizavca,0,1,1,0,1,1,0,0,1,1,1,0
13251,,,Ming_jin,0,2,2,0,2,2,0,0,1,1,1,0
13252,,,artysmama,0,2,2,0,2,2,0,0,1,1,1,0
13253,,,Valizatouche,0,1,1,0,1,1,0,0,1,1,1,0
13254,,,killer_asian,0,1,1,0,1,1,0,0,5,0.43662,0.474194,0
13255,,,rebels2008,5,2,7,5,2,7,0.166667,0.033436,5,0.43662,0.474194,124
13256,,,PTO_FYI,4,1,5,4,1,5,0.25,0.029476,0,0,0,0
13257,,,quesitohelado,1,1,2,1,1,2,0,0.00396,1,1,1,1
13258,,,janellxhy,0,1,1,0,1,1,0,0,1,1,1,0
13259,,,gigglyseokjinie,0,2,2,0,2,2,0,0,1,1,1,0
13260,,,tianyu61108709,0,1,1,0,1,1,0,0,1,1,1,0
13261,,,kimbers133,0,1,1,0,1,1,0,0,1,1,1,0
13262,,,shomalino,0,1,1,0,1,1,0,0,1,1,1,0
13263,,,vere_roselivre,0,1,1,0,1,1,0,0,1,1,1,0
13264,,,findtheeldorado,8,1,9,8,1,9,0.125,0.053497,0,0,0,0
13265,,,vocalbosu,0,1,1,0,1,1,0,0,1,1,1,0
13266,,,satanicswiffer,0,1,1,0,1,1,0,0,1,1,1,0
13267,,,MissHavisham,0,1,1,0,1,1,0,0,1,1,1,0
13268,,,lhs_toki,0,1,1,0,1,1,0,0,1,1,1,0
13269,,,DADAOWANGWU666,0,1,1,0,1,1,0,0,1,1,1,0
13270,,,whoismissjane,0,1,1,0,1,1,0,0,1,1,1,0
13271,,,mahitussy,4,2,6,4,2,6,0.2,0.026749,2,0.6,0.666667,9
13272,,,ly1ds0,0,1,1,0,1,1,0,0,3,0.444444,0.541667,0
13273,,,madamyiling,0,1,1,0,1,1,0,0,3,0.444444,0.541667,0
13274,,,strawberrygogy,0,1,1,0,1,1,0,0,6,0.31068,0.338021,0
13275,,,chimgooey,0,1,1,0,1,1,0,0,6,0.31068,0.338021,0
13276,,,bloodysweatytea,0,1,1,0,1,1,0,0,6,0.31068,0.338021,0
13277,,,AriDrennen,9,1,10,9,1,10,0.111111,0.167057,0,0,0,0
13278,,,lunar_jk,0,1,1,0,1,1,0,0,1,1,1,0
13279,,,axelpoohs,0,1,1,0,1,1,0,0,1,1,1,0
13280,,,usgyh,0,1,1,0,1,1,0,0,1,1,1,0
13281,,,JSWJFW,0,1,1,0,1,1,0,0,1,1,1,0
13282,,,__summerblues,0,1,1,0,1,1,0,0,1,1,1,0
13283,,,18Lynnbell,10,1,11,10,1,11,0.1,0.066871,0,0,0,0
13284,,,kiwi_music_,0,1,1,0,1,1,0,0,1,1,1,0
13285,,,k_ayanga_n,0,1,1,0,1,1,0,0,1,1,1,0
13286,,,solukelyabs,0,1,1,0,1,1,0,0,1,1,1,0
13287,,,xjeonsdimplesx,0,1,1,0,1,1,0,0,1,1,1,0
13288,,,ventiBBH,0,1,1,0,1,1,0,0,1,1,1,0
13289,,,Trinhnomics,2,1,3,2,1,3,0.5,0.013374,0,0,0,0
13290,,,namu_nomu,0,1,1,0,1,1,0,0,1,1,1,0
13291,,,yokonaka,7,1,8,8,2,10,0.142857,0.04681,0,0,0,0
13292,,,lockmeinurheart,0,1,1,0,1,1,0,0,1,1,1,0
13293,,,wannawelo,0,1,1,0,1,1,0,0,1,1,1,0
13294,,,hyukaslefteye,6,4,10,6,4,10,0.111111,0.040123,2,0.714286,0.8,25
13295,,,W1N3L0VER,0,1,1,0,1,1,0,0,3,0.461538,0.527778,0
13296,,,AnzBananzzzzz,0,1,1,0,1,1,0,0,3,0.461538,0.527778,0
13297,,,DQHKSOO,0,1,1,0,1,1,0,0,3,0.461538,0.527778,0
13298,,,XennDad,8,1,9,8,1,9,0.125,0.053497,0,0,0,0
13299,,,reticent_gigi,0,1,1,0,1,1,0,0,1,1,1,0
13300,,,hibiki_mc,0,1,1,0,1,1,0,0,1,1,1,0
13301,,,chiharurero,0,1,1,0,1,1,0,0,1,1,1,0
13302,,,KAGEYAMADLERS,0,1,1,0,1,1,0,0,1,1,1,0
13303,,,jwiz6,0,1,1,0,1,1,0,0,1,1,1,0
13304,,,yerifan2006,0,1,1,0,1,1,0,0,2,0.6,0.666667,0
13305,,,Kookmin74,0,1,1,0,1,1,0,0,2,0.6,0.666667,0
13306,,,duxzzxib,0,1,1,0,1,1,0,0,2,0.6,0.666667,0
13307,,,formulamila,0,1,1,0,1,1,0,0,2,0.6,0.666667,0
13308,,,lupeitis,0,1,1,0,1,1,0,0,2,0.6,0.666667,0
13309,,,1DOnlyTheBrave,0,1,1,0,1,1,0,0,2,0.6,0.666667,0
13310,,,Ultrama27914718,0,1,1,0,1,1,0,0,2,0.6,0.666667,0
13311,,,980128_,0,1,1,0,1,1,0,0,2,0.6,0.666667,0
13312,,,GusTsilent,0,1,1,0,1,1,0,0,2,0.6,0.666667,0
13313,,,guorouyi1,0,1,1,0,1,1,0,0,2,0.6,0.666667,0
13314,,,sevireynnad,3,1,4,3,1,4,0.333333,0.020061,0,0,0,0
13315,,,figureskatingac,0,1,1,0,1,1,0,0,1,1,1,0
13316,,,onitnyc07,0,1,1,0,1,1,0,0,1,1,1,0
13317,,,uhohbailey_,7,1,8,7,1,8,0.142857,0.04681,0,0,0,0
13318,,,le_pukeka,0,1,1,0,1,1,0,0,1,1,1,0
13319,,,bts4ever___,0,1,1,0,1,1,0,0,1,1,1,0
13320,,,kurami_,0,1,1,0,1,1,0,0,1,1,1,0
13321,,,ayayasoup,0,1,1,0,1,1,0,0,1,1,1,0
13322,,,TradeSafeCoin1,0,1,1,0,1,1,0,0,1,1,1,0
13323,,,t1nywooyo,2,1,3,2,1,3,0.5,0.013374,0,0,0,0
13324,,,SHKozy,0,1,1,0,1,1,0,0,1,1,1,0
13325,,,suzecel,0,1,1,0,1,1,0,0,1,1,1,0
13326,,,kji_peaches,4,2,6,4,2,6,0.2,0.026749,1,1,1,3
13327,,,rxndxz_,0,1,1,0,1,1,0,0,1,1,1,0
13328,,,mokomokokaasan,0,1,1,0,1,1,0,0,1,1,1,0
13329,,,ryo_crunch,0,1,1,0,1,1,0,0,1,1,1,0
13330,,,haepla,0,1,1,0,1,1,0,0,1,1,1,0
13331,,,transtsg,11,1,12,12,1,13,0.090909,0.108501,0,0,0,0
13332,,,rashomonxyz,0,1,1,0,1,1,0,0,1,1,1,0
13333,,,joyiesuh,7,2,9,7,3,10,0.125,0.04681,1,1,1,6
13334,,,digierabareshi,0,1,1,0,1,1,0,0,1,1,1,0
13335,,,8018Bf,0,1,1,0,1,1,0,0,1,1,1,0
13336,,,peach_rawr,0,1,1,0,1,1,0,0,2,0.666667,0.75,0
13337,,,MFJenks,0,1,1,0,1,1,0,0,2,0.666667,0.75,0
13338,,,fleurescein,0,1,1,0,1,1,0,0,2,0.666667,0.75,0
13339,,,xikido,0,1,1,0,1,1,0,0,2,0.666667,0.75,0
13340,,,queermothman,7,1,8,7,1,8,0.142857,0.04681,0,0,0,0
13341,,,gloria092188,0,1,1,0,1,1,0,0,1,1,1,0
13342,,,ttc_soft,0,1,1,0,1,1,0,0,1,1,1,0
13343,,,Sportsf81719469,0,1,1,0,1,1,0,0,1,1,1,0
13344,,,bjonesbrown,0,1,1,0,1,1,0,0,1,1,1,0
13345,,,KoyukiArt,0,1,1,0,1,1,0,0,1,1,1,0
13346,,,sandsoceanstree,0,1,1,0,1,1,0,0,1,1,1,0
13347,,,magjicqal,6,1,7,6,1,7,0.166667,0.040123,0,0,0,0
13348,,,flopxiaoshi,0,1,1,0,1,1,0,0,1,1,1,0
13349,,,jimincheeks1013,0,1,1,0,1,1,0,0,1,1,1,0
13350,,,SusyCruel,0,1,1,0,1,1,0,0,1,1,1,0
13351,,,milk_pods,0,1,1,0,1,1,0,0,1,1,1,0
13352,,,Talking_Pts,0,2,2,0,2,2,0,0,1,1,1,0
13353,,,YLzxRbjzsVlowuF,0,1,1,0,1,1,0,0,1,1,1,0
13354,,,edjlazar,0,1,1,0,1,1,0,0,1,1,1,0
13355,,,hakcobz,1,2,3,1,2,3,0.5,0.006687,1,1,1,0
13356,,,buttshoveI,7,1,8,8,2,10,0.142857,0.04681,0,0,0,0
13357,,,memetwice1,0,1,1,0,1,1,0,0,1,1,1,0
13358,,,hohobizarre,3,1,4,3,1,4,0.333333,0.020061,0,0,0,0
13359,,,calix_tra,0,1,1,0,1,1,0,0,1,1,1,0
13360,,,moarmy_12ot,0,1,1,0,1,1,0,0,1,1,1,0
13361,,,jvb774,13,1,14,13,1,14,0.076923,0.090427,0,0,0,0
13362,,,Egaleonis,0,1,1,0,1,1,0,0,1,1,1,0
13363,,,vioIetfIower,0,1,1,0,1,1,0,0,1,1,1,0
13364,,,Taekwonah1,0,1,1,0,1,1,0,0,1,1,1,0
13365,,,swordsoprano,0,1,1,0,1,1,0,0,1,1,1,0
13366,,,_92914,0,1,1,0,1,1,0,0,1,1,1,0
13367,,,Cassiegndako,0,1,1,0,1,1,0,0,1,1,1,0
13368,,,vante_LY,0,1,1,0,1,1,0,0,1,1,1,0
13369,,,Journeyman15,0,1,1,0,1,1,0,0,1,1,1,0
13370,,,pinkpurplebleu,0,1,1,0,1,1,0,0,1,1,1,0
13371,,,amewastaken,0,1,1,0,1,1,0,0,1,1,1,0
13372,,,jacki98847683,7,2,9,9,3,12,0.142857,0.04681,1,1,1,5
13373,,,n_sakurai16,0,3,3,0,5,5,0.166667,0,1,1,1,0
13374,,,_txetae_,0,1,1,0,1,1,0,0,2,0.666667,0.75,0
13375,,,yaang___,0,1,1,0,1,1,0,0,2,0.666667,0.75,0
13376,,,zhngzhehan,0,1,1,0,1,1,0,0,2,0.666667,0.75,0
13377,,,RobinQuinninLA,0,1,1,0,1,1,0,0,2,0.666667,0.75,0
13378,,,EvelynG77310272,3,1,4,3,1,4,0.333333,0.020061,0,0,0,0
13379,,,Anthropologal,0,1,1,0,1,1,0,0,1,1,1,0
13380,,,Fresh3s,0,1,1,0,1,1,0,0,1,1,1,0
13381,,,StandWithMarco_,6,1,7,6,1,7,0.2,0.064582,0,0,0,0
13382,,,ilikefinemusic,0,1,1,0,1,1,0,0,1,1,1,0
13383,,,ddaeng_qween,0,1,1,0,1,1,0,0,1,1,1,0
13384,,,TracyLil05,0,1,1,0,1,1,0,0,1,1,1,0
13385,,,GennadyPodolsky,5,1,6,6,1,7,0.2,0.070283,0,0,0,0
13386,,,LSZsButterflies,0,1,1,0,1,1,0,0,1,1,1,0
13387,,,gnfCroissant,0,1,1,0,1,1,0,0,1,1,1,0
13388,,,sunnyside_11104,0,1,1,0,1,1,0,0,1,1,1,0
13389,,,thestucklanding,0,1,1,0,1,1,0,0,1,1,1,0
13390,,,strataegi,0,1,1,0,1,1,0,0,1,1,1,0
13391,,,commietomatillo,0,1,1,0,1,1,0,0,1,1,1,0
13392,,,pinupturnip,0,1,1,0,1,1,0,0,1,1,1,0
13393,,,MariahFerraz,0,1,1,0,1,1,0,0,1,1,1,0
13394,,,J0VEJUSTlCE,0,1,1,0,1,1,0,0,1,1,1,0
13395,,,Tokki_yang,0,1,1,0,1,1,0,0,1,1,1,0
13396,,,icantresisthem,0,1,1,0,1,1,0,0,1,1,1,0
13397,,,MykeAtTheMic,3,1,4,3,1,4,0.333333,0.020061,0,0,0,0
13398,,,ughhingbaka,0,1,1,0,1,1,0,0,1,1,1,0
13399,,,TheMooseJesus,0,1,1,0,1,1,0,0,1,1,1,0
13400,,,HOSHIDIN0,0,1,1,0,1,1,0,0,1,1,1,0
13401,,,ieu73,0,2,2,0,2,2,0,0,1,1,1,0
13402,,,suetekh_xen,0,1,1,0,1,1,0,0,1,1,1,0
13403,,,ftimhn,0,1,1,0,1,1,0,0,1,1,1,0
13404,,,nncnna,0,1,1,0,1,1,0,0,1,1,1,0
13405,,,Anita23647680,3,1,4,3,1,4,0.333333,0.020061,0,0,0,0
13406,,,cha_chan_i_ya,0,1,1,0,1,1,0,0,1,1,1,0
13407,,,pillarmozo,0,1,1,0,1,1,0,0,1,1,1,0
13408,,,dionysusmood,0,1,1,0,1,1,0,0,1,1,1,0
13409,,,Pauline98476699,1,1,2,1,1,2,0,0.006687,0,0,0,0
13410,,,brandenice,12,1,13,12,1,13,0.083333,0.080246,0,0,0,0
13411,,,tedoko1696,0,1,1,0,1,1,0,0,1,1,1,0
13412,,,OKfnkzwUyZ2fkd,0,1,1,0,1,1,0,0,1,1,1,0
13413,,,babyvx13,0,1,1,0,1,1,0,0,1,1,1,0
13414,,,phakebish,0,1,1,0,1,1,0,0,1,1,1,0
13415,,,minijagii,0,1,1,0,1,1,0,0,1,1,1,0
13416,,,tita_riri,0,1,1,0,1,1,0,0,1,1,1,0
13417,,,squirrelly1357,0,1,1,0,1,1,0,0,1,1,1,0
13418,,,uo6fu3RbIK2eSSh,0,1,1,0,1,1,0,0,1,1,1,0
13419,,,hubishanniebee,0,1,1,0,1,1,0,0,1,1,1,0
13420,,,zanymystery,0,1,1,0,1,1,0,0,1,1,1,0
13421,,,ThornIrisRibbon,0,1,1,0,1,1,0,0,1,1,1,0
13422,,,rpfirm,1,1,2,1,1,2,0,0.006687,0,0,0,0
13423,,,PinchofPeppers,7,1,8,7,1,8,0.142857,0.04681,0,0,0,0
13424,,,e_mingxx,0,1,1,0,1,1,0,0,1,1,1,0
13425,,,marywells_xo,0,1,1,0,1,1,0,0,1,1,1,0
13426,,,NotMeAyee,0,1,1,0,1,1,0,0,1,1,1,0
13427,,,Ievispika,0,1,1,0,1,1,0,0,1,1,1,0
13428,,,BAEPlNKS,0,1,1,0,1,1,0,0,1,1,1,0
13429,,,geomansae,0,1,1,0,1,1,0,0,1,1,1,0
13430,,,AsenaDuman12,3,1,4,3,1,4,0.333333,0.020061,0,0,0,0
13431,,,JjiniVu,0,1,1,0,1,1,0,0,1,1,1,0
13432,,,hwasasbirkin,4,1,5,4,1,5,0.25,0.026749,0,0,0,0
13433,,,thephdz,0,1,1,0,1,1,0,0,1,1,1,0
13434,,,origamilover01,0,1,1,0,1,1,0,0,1,1,1,0
13435,,,MarkSpatny,0,1,1,0,1,1,0,0,1,1,1,0
13436,,,Steve3357,2,1,3,2,1,3,0.5,0.013374,0,0,0,0
13437,,,mijita212,0,1,1,0,1,1,0,0,1,1,1,0
13438,,,pearcer15,32,1,33,33,1,34,0.03125,0.274567,0,0,0,0
13439,,,SeamiiC,0,1,1,0,1,1,0,0,1,1,1,0
13440,,,vantems,0,1,1,0,1,1,0,0,1,1,1,0
13441,,,ShannAwesome,0,1,1,0,1,1,0,0,1,1,1,0
13442,,,imval7,0,1,1,0,1,1,0,0,1,1,1,0
13443,,,_ngelhgy,0,1,1,0,1,1,0,0,1,1,1,0
13444,,,grapesallergy,0,1,1,0,1,1,0,0,1,1,1,0
13445,,,yourm0minmybed,0,1,1,0,1,1,0,0,1,1,1,0
13446,,,MicheleJeanson1,0,1,1,0,1,1,0,0,1,1,1,0
13447,,,caoistheory,0,1,1,0,1,1,0,0,1,1,1,0
13448,,,rqbts,0,4,4,0,4,4,0,0,1,1,1,0
13449,,,TEAMSNOOGEYFACE,0,1,1,0,1,1,0,0,1,1,1,0
13450,,,Vcalledmebesty,0,1,1,0,1,1,0,0,1,1,1,0
13451,,,Kwangkundesu,0,1,1,0,1,1,0,0,1,1,1,0
13452,,,wcarterlewis,0,1,1,0,1,1,0,0,1,1,1,0
13453,,,any_windy_day,0,1,1,0,1,1,0,0,1,1,1,0
13454,,,lynpricillia,0,1,1,0,1,1,0,0,1,1,1,0
13455,,,PeachSsUnooo,0,1,1,0,1,1,0,0,1,1,1,0
13456,,,lvfrksn,0,1,1,0,1,1,0,0,1,1,1,0
13457,,,krisworld,0,1,1,0,1,1,0,0,1,1,1,0
13458,,,kiiroi_churippu,0,1,1,0,1,1,0,0,1,1,1,0
13459,,,genderedcass,0,1,1,0,1,1,0,0,1,1,1,0
13460,,,melovcakey,0,1,1,0,1,1,0,0,1,1,1,0
13461,,,Yukiko62219633,0,1,1,0,1,1,0,0,1,1,1,0
13462,,,blckswaaan,0,1,1,0,1,1,0,0,1,1,1,0
13463,,,yoonminiebub,0,1,1,0,1,1,0,0,1,1,1,0
13464,,,courtsfelix,1,1,2,1,1,2,0,0.006687,0,0,0,0
13465,,,chohanniee,0,2,2,0,3,3,0,0,1,1,1,0
13466,,,icelollyrainbow,0,1,1,0,1,1,0,0,1,1,1,0
13467,,,wipedout23,0,1,1,0,1,1,0,0,1,1,1,0
13468,,,sunzhiwei20,0,1,1,0,1,1,0,0,1,1,1,0
13469,,,spokenWOLf,0,1,1,0,1,1,0,0,1,1,1,0
13470,,,graceemoyer,0,1,1,0,1,1,0,0,1,1,1,0
13471,,,yeolmae_beth,0,1,1,0,1,1,0,0,1,1,1,0
13472,,,emluvrxx,4,1,5,4,1,5,0.25,0.026749,0,0,0,0
13473,,,_flirtykoo,0,1,1,0,1,1,0,0,1,1,1,0
13474,,,argusdog1206,0,1,1,0,1,1,0,0,1,1,1,0
13475,,,EOukashin,14,1,15,14,1,15,0.071429,0.09362,0,0,0,0
13476,,,nachucomethru,0,1,1,0,1,1,0,0,1,1,1,0
13477,,,mkkyyz01,0,1,1,0,1,1,0,0,1,1,1,0
13478,,,MomofTeen,0,4,4,0,5,5,0,0,2,0.833333,0.9,0
13479,,,glimmernights,0,1,1,0,1,1,0,0,1,1,1,0
13480,,,jiangsonly,0,1,1,0,1,1,0,0,1,1,1,0
13481,,,JihyoMyGoddess,0,1,1,0,1,1,0,0,1,1,1,0
13482,,,ting_yang_ya,0,1,1,0,1,1,0,0,1,1,1,0
13483,,,Tokyo_Tom,0,1,1,0,1,1,0,0,1,1,1,0
13484,,,rbbvelvet,0,1,1,0,1,1,0,0,1,1,1,0
13485,,,SurfCityWriter,4,1,5,4,1,5,0.25,0.026749,0,0,0,0
13486,,,CarmenRisi81,0,1,1,0,1,1,0,0,1,1,1,0
13487,,,PRETTYBOYOONG,0,1,1,0,1,1,0,0,1,1,1,0
13488,,,stonerkeiji,1,1,2,1,1,2,0,0.006687,0,0,0,0
13489,,,molly_jasi,2,1,3,3,2,5,0.5,0.013374,0,0,0,0
13490,,,CMicheleSmith,1,1,2,1,1,2,0,0.006687,0,0,0,0
13491,,,lugaw__,0,1,1,0,1,1,0,0,1,1,1,0
13492,,,kvcacti,0,1,1,0,1,1,0,0,1,1,1,0
13493,,,chdorinagashi,3,1,4,3,1,4,0.333333,0.020061,0,0,0,0
13494,,,BGwyn4Democracy,0,1,1,0,1,1,0,0,1,1,1,0
13495,,,curtis91044720,3,1,4,3,1,4,0.333333,0.020061,0,0,0,0
13496,,,vavegan93,0,1,1,0,1,1,0,0,1,1,1,0
13497,,,94khais,0,1,1,0,1,1,0,0,1,1,1,0
13498,,,nehcwnahtan,1,1,2,1,1,2,0,0.006687,0,0,0,0
13499,,,iKbt40aFJCUCz70,0,1,1,0,1,1,0,0,1,1,1,0
13500,,,KimHyoMi8,0,1,1,0,1,1,0,0,1,1,1,0
13501,,,THaight5,0,1,1,0,1,1,0,0,1,1,1,0
13502,,,bulubuluanin,0,1,1,0,1,1,0,0,1,1,1,0
13503,,,YutaLynx,0,1,1,0,1,1,0,0,1,1,1,0
13504,,,qiud0tkrz,0,1,1,0,1,1,0,0,1,1,1,0
13505,,,reservoirbunny,0,1,1,0,1,1,0,0,1,1,1,0
13506,,,Scrimsdiscord,0,1,1,0,1,1,0,0,1,1,1,0
13507,,,k00kswrld_,0,1,1,0,1,1,0,0,1,1,1,0
13508,,,Iuvlees,0,1,1,0,1,1,0,0,1,1,1,0
13509,,,7AAAASports,0,1,1,0,1,1,0,0,1,1,1,0
13510,,,ESXIII,0,1,1,0,1,1,0,0,1,1,1,0
13511,,,TerraFFXV,0,1,1,0,1,1,0,0,1,1,1,0
13512,,,starflowersunn,0,1,1,0,1,1,0,0,1,1,1,0
13513,,,kanavrs,0,1,1,0,1,1,0,0,1,1,1,0
13514,,,SueScoby,0,1,1,0,1,1,0,0,1,1,1,0
13515,,,sarutofu,0,1,1,0,1,1,0,0,1,1,1,0
13516,,,emforshee,4,1,5,4,1,5,0.25,0.026749,0,0,0,0
13517,,,KayEatsMonsters,0,1,1,0,1,1,0,0,1,1,1,0
13518,,,pierce_angelus,0,2,2,0,2,2,0,0,1,1,1,0
13519,,,pigdog67,8,1,9,8,1,9,0.125,0.060486,0,0,0,0
13520,,,Violetatovar1,0,1,1,0,1,1,0,0,1,1,1,0
13521,,,jeonggukjeoon,0,2,2,0,2,2,0,0,1,1,1,0
13522,,,chittaphonTEN00,0,1,1,0,1,1,0,0,1,1,1,0
13523,,,miu_miu_xy,0,1,1,0,1,1,0,0,1,1,1,0
13524,,,JoBearParker,0,1,1,0,1,1,0,0,1,1,1,0
13525,,,shampoofairyRM,0,1,1,0,1,1,0,0,1,1,1,0
13526,,,laurenbanksart,2,1,3,2,1,3,0.5,0.013374,0,0,0,0
13527,,,_oldtea,0,1,1,0,1,1,0,0,1,1,1,0
13528,,,KTVB,2,1,3,2,1,3,0.5,0.013374,0,0,0,0
13529,,,minhyuksuperio1,0,1,1,0,1,1,0,0,1,1,1,0
13530,,,kolinzkay,4,1,5,5,1,6,0.25,0.026749,0,0,0,0
13531,,,mei_hanxue,0,1,1,0,1,1,0,0,1,1,1,0
13532,,,ihsanbrk,0,1,1,0,1,1,0,0,2,0.6,0.666667,0
13533,,,Ggeez11,0,1,1,0,1,1,0,0,2,0.6,0.666667,0
13534,,,doitformengmeng,0,1,1,0,1,1,0,0,2,0.6,0.666667,0
13535,,,dreamingsnf,0,1,1,0,1,1,0,0,2,0.6,0.666667,0
13536,,,userkiveee,0,1,1,0,1,1,0,0,2,0.6,0.666667,0
13537,,,KaitlynLindaman,1,1,2,1,1,2,0,0.006687,0,0,0,0
13538,,,Joysnewfss,1,1,2,1,1,2,0,0.006687,0,0,0,0
13539,,,jjwanwol,4,1,5,4,1,5,0.25,0.026749,0,0,0,0
13540,,,AldricKody,0,1,1,0,1,1,0,0,1,1,1,0
13541,,,iTHBLU3,0,1,1,0,1,1,0,0,1,1,1,0
13542,,,DlORBlNS,0,1,1,0,1,1,0,0,1,1,1,0
13543,,,joshc,4,1,5,4,1,5,0.25,0.026749,0,0,0,0
13544,,,bossofdeeznuts,0,1,1,0,1,1,0,0,1,1,1,0
13545,,,maxuewei1,0,1,1,0,1,1,0,0,1,1,1,0
13546,,,cuhwanning,0,1,1,0,1,1,0,0,1,1,1,0
13547,,,_meganaguirre_,7,1,8,8,2,10,0.142857,0.060787,0,0,0,0
13548,,,CatieHarper,2,1,3,2,1,3,0.5,0.013374,0,0,0,0
13549,,,proxivir,0,1,1,0,1,1,0,0,1,1,1,0
13550,,,manusia_jawa_1,3,1,4,3,1,4,0.333333,0.041027,0,0,0,0
13551,,,hashtag_atwood,0,1,1,0,1,1,0,0,1,1,1,0
13552,,,Bedazzleasaurus,2,1,3,2,1,3,0.5,0.013374,0,0,0,0
13553,,,llolague,0,1,1,0,1,1,0,0,1,1,1,0
13554,,,RNG32BJ,12,1,13,12,1,13,0.083333,0.11604,0,0,0,0
13555,,,jklipss,0,1,1,0,1,1,0,0,1,1,1,0
13556,,,Fuxy69961665,0,1,1,0,1,1,0,0,1,1,1,0
13557,,,PsnuoqW,0,1,1,0,1,1,0,0,1,1,1,0
13558,,,xielhcns,0,1,1,0,1,1,0,0,1,1,1,0
13559,,,Lewis70567457,0,1,1,0,1,1,0,0,1,1,1,0
13560,,,multi_lunax,0,1,1,0,1,1,0,0,1,1,1,0
13561,,,shaytae_frvr,0,1,1,0,1,1,0,0,1,1,1,0
13562,,,deviirmasafitri,12,1,13,12,1,13,0,0.058428,1,1,1,14
13563,,,_yoonimcx,0,1,1,0,1,1,0,0,1,1,1,0
13564,,,rkiluvrs,0,1,1,0,1,1,0,0,1,1,1,0
13565,,,Thurman8er1,13,1,14,13,1,14,0.076923,0.086933,0,0,0,0
13566,,,aceantii,0,1,1,0,1,1,0,0,1,1,1,0
13567,,,flatapartment07,0,1,1,0,1,1,0,0,1,1,1,0
13568,,,Mark09118039,0,1,1,0,1,1,0,0,1,1,1,0
13569,,,ApichayaTecha,0,1,1,0,1,1,0,0,1,1,1,0
13570,,,BE_BLAR,0,1,1,0,1,1,0,0,1,1,1,0
13571,,,zfrstq,0,1,1,0,1,1,0,0,1,1,1,0
13572,,,thegoIdenway,0,1,1,0,1,1,0,0,1,1,1,0
13573,,,SS44085,0,1,1,0,1,1,0,0,1,1,1,0
13574,,,NCAAScared,0,1,1,0,1,1,0,0,1,1,1,0
13575,,,lynnburgess,0,1,1,0,1,1,0,0,1,1,1,0
13576,,,jmassaro,0,1,1,0,1,1,0,0,1,1,1,0
13577,,,TheMnstrsCloset,0,1,1,0,1,1,0,0,3,0.5,0.525641,0
13578,,,agoodmintality,20,1,21,20,1,21,0.05,0.154708,0,0,0,0
13579,,,AlbanyLugo2,0,2,2,0,2,2,0,0,1,1,1,0
13580,,,Nightearsnow,0,1,1,0,1,1,0,0,1,1,1,0
13581,,,huislovesong,0,1,1,0,1,1,0,0,1,1,1,0
13582,,,MVRKACE,0,1,1,0,1,1,0,0,1,1,1,0
13583,,,june_june66,0,1,1,0,1,1,0,0,1,1,1,0
13584,,,GibMeo,0,1,1,0,1,1,0,0,1,1,1,0
13585,,,ScarboughSly,0,1,1,0,1,1,0,0,1,1,1,0
13586,,,zhaoxiaoxiao00,0,1,1,0,1,1,0,0,1,1,1,0
13587,,,michinfree,0,4,4,0,4,4,0,0,2,0.833333,0.9,0
13588,,,Kyumbunny,0,1,1,0,1,1,0,0,1,1,1,0
13589,,,etherealyoonie,0,1,1,0,1,1,0,0,1,1,1,0
13590,,,s1343407,0,1,1,0,1,1,0,0,1,1,1,0
13591,,,MoshellRobert,0,1,1,0,1,1,0,0,1,1,1,0
13592,,,gintokou,0,1,1,0,1,1,0,0,1,1,1,0
13593,,,kai__pla,0,1,1,0,1,1,0,0,1,1,1,0
13594,,,flippinflutz,0,1,1,0,1,1,0,0,1,1,1,0
13595,,,NathanielHundt,21,1,22,22,1,23,0.047619,0.14043,0,0,0,0
13596,,,peony_drops,0,1,1,0,1,1,0,0,1,1,1,0
13597,,,gabriellabm35,0,1,1,0,1,1,0,0,1,1,1,0
13598,,,PeguyDj,0,1,1,0,1,1,0,0,1,1,1,0
13599,,,bugmada,0,2,2,0,2,2,0,0,3,0.571429,0.708333,0
13600,,,Cherry_chii__,0,1,1,0,1,1,0,0,1,1,1,0
13601,,,bantita_uni,0,1,1,0,1,1,0,0,1,1,1,0
13602,,,milopugg,0,1,1,0,1,1,0,0,1,1,1,0
13603,,,taekookieful,0,1,1,0,1,1,0,0,1,1,1,0
13604,,,resendez_briana,0,1,1,0,1,1,0,0,1,1,1,0
13605,,,capnwatsisname,0,1,1,0,1,1,0,0,1,1,1,0
13606,,,RicaDiAngelo,0,1,1,0,1,1,0,0,1,1,1,0
13607,,,superchamchi7,0,1,1,0,1,1,0,0,1,1,1,0
13608,,,PvBDcLn3JBHxJNo,0,1,1,0,1,1,0,0,1,1,1,0
13609,,,luvlyjunie,0,1,1,0,1,1,0,0,1,1,1,0
13610,,,ryuuseigai,0,1,1,0,1,1,0,0,1,1,1,0
13611,,,404vrs,0,1,1,0,1,1,0,0,1,1,1,0
13612,,,edilyujin,0,1,1,0,1,1,0,0,2,0.666667,0.75,0
13613,,,Doomykins,0,1,1,0,1,1,0,0,2,0.666667,0.75,0
13614,,,vivienhernandez,0,1,1,0,1,1,0,0,2,0.666667,0.75,0
13615,,,IntrepidReportr,0,1,1,0,1,1,0,0,2,0.666667,0.75,0
13616,,,bloojaibloo,0,1,1,0,1,1,0,0,2,0.666667,0.75,0
13617,,,bretisrael,1,1,2,1,1,2,0,0.006687,0,0,0,0
13618,,,phaedinphaedout,9,1,10,9,1,10,0.111111,0.060184,0,0,0,0
13619,,,d1_iz,0,1,1,0,1,1,0,0,1,1,1,0
13620,,,sykes_eba,0,1,1,0,1,1,0,0,1,1,1,0
13621,,,caterdiaa,0,2,2,0,2,2,0,0,3,0.571429,0.708333,0
13622,,,varr9741,0,1,1,0,1,1,0,0,1,1,1,0
13623,,,kristaldlr,0,1,1,0,1,1,0,0,1,1,1,0
13624,,,__dandeli0ns,0,1,1,0,1,1,0,0,1,1,1,0
13625,,,mynameisjea,1,1,2,1,1,2,0,0.006687,0,0,0,0
13626,,,Ryan_Mod12,7,1,8,7,1,8,0.142857,0.04681,0,0,0,0
13627,,,TCK2007TCK,0,1,1,0,1,1,0,0,1,1,1,0
13628,,,robynmp3,0,1,1,0,1,1,0,0,1,1,1,0
13629,,,cloudyseance,0,1,1,0,1,1,0,0,1,1,1,0
13630,,,XianxiaHell,0,1,1,0,1,1,0,0,1,1,1,0
13631,,,TJskatinfan,0,1,1,0,1,1,0,0,1,1,1,0
13632,,,baileyc722,9,1,10,9,1,10,0.111111,0.067173,0,0,0,0
13633,,,_ashleyortiz_,0,1,1,0,1,1,0,0,1,1,1,0
13634,,,FoggyTao,0,1,1,0,1,1,0,0,1,1,1,0
13635,,,wonheauxx,2,2,4,2,2,4,0.333333,0.013374,1,1,1,1
13636,,,H3abi,0,1,1,0,1,1,0,0,1,1,1,0
13637,,,cedricsbussy,0,1,1,0,1,1,0,0,1,1,1,0
13638,,,Byakuya1207,0,1,1,0,1,1,0,0,1,1,1,0
13639,,,nxtrabzmom,0,1,1,0,1,1,0,0,1,1,1,0
13640,,,steffdaz,0,1,1,0,1,1,0,0,1,1,1,0
13641,,,cutelyjongin,0,1,1,0,1,1,0,0,1,1,1,0
13642,,,jjk1mono,0,1,1,0,1,1,0,0,1,1,1,0
13643,,,kiwienha,0,1,1,0,1,1,0,0,1,1,1,0
13644,,,liddolhobi,0,1,1,0,1,1,0,0,1,1,1,0
13645,,,xeh157,0,1,1,0,1,1,0,0,1,1,1,0
13646,,,CSYisalovelyfox,0,1,1,0,1,1,0,0,1,1,1,0
13647,,,heathert7900,0,1,1,0,1,1,0,0,1,1,1,0
13648,,,Dilan_Okcuoglu,2,1,3,2,1,3,0.5,0.013374,0,0,0,0
13649,,,Txguy9012,0,1,1,0,1,1,0,0,1,1,1,0
13650,,,Iuvpainter,0,1,1,0,1,1,0,0,1,1,1,0
13651,,,Candi12301,0,3,3,0,3,3,0,0,1,1,1,0
13652,,,candle_finder,0,1,1,0,1,1,0,0,1,1,1,0
13653,,,ChasonDailey,0,1,1,0,1,1,0,0,1,1,1,0
13654,,,stupidhorse420,5,1,6,5,1,6,0.2,0.033436,0,0,0,0
13655,,,randomdayo,0,1,1,0,1,1,0,0,1,1,1,0
13656,,,MaureenMannion2,0,1,1,0,1,1,0,0,1,1,1,0
13657,,,BunnybunnyKino,0,1,1,0,1,1,0,0,1,1,1,0
13658,,,nathskylar,0,3,3,0,4,4,0,0,1,1,1,0
13659,,,adaptivemindful,9,1,10,9,1,10,0.111111,0.060184,0,0,0,0
13660,,,bbkenn92,0,1,1,0,1,1,0,0,1,1,1,0
13661,,,morganxgoode,0,1,1,0,1,1,0,0,1,1,1,0
13662,,,Callawaynoxid,0,1,1,0,1,1,0,0,1,1,1,0
13663,,,karma_city7,0,2,2,0,2,2,0,0,2,0.571429,0.625,0
13664,,,Danbo_Kentucky,0,1,1,0,1,1,0,0,1,1,1,0
13665,,,tomatoya3,0,1,1,0,1,1,0,0,1,1,1,0
13666,,,Joshua75266978,0,1,1,0,1,1,0,0,1,1,1,0
13667,,,littlepeachnv17,0,1,1,0,1,1,0,0,1,1,1,0
13668,,,rommyelle,2,2,4,2,2,4,0.333333,0.013374,2,0.666667,0.75,2
13669,,,DaniiHart_,6,1,7,6,1,7,0.166667,0.043617,0,0,0,0
13670,,,yoniarrozyleche,0,1,1,0,1,1,0,0,1,1,1,0
13671,,,youbringnohair,0,1,1,0,1,1,0,0,1,1,1,0
13672,,,GoodHombrette,1,2,3,1,2,3,0.5,0.006687,1,1,1,0
13673,,,crubinsky,1,1,2,1,1,2,0,0.006687,0,0,0,0
13674,,,cgstefko,5,1,6,5,1,6,0.2,0.033436,0,0,0,0
13675,,,2015cocoro,0,1,1,0,1,1,0,0,1,1,1,0
13676,,,aVerySalad,0,2,2,0,2,2,0,0,1,1,1,0
13677,,,KiaMarie2003,0,1,1,0,1,1,0,0,1,1,1,0
13678,,,harusemhana,0,1,1,0,1,1,0,0,1,1,1,0
13679,,,kimbere640,1,1,2,1,1,2,0,0.006687,0,0,0,0
13680,,,wordlequeen,9,1,10,9,1,10,0.111111,0.060184,0,0,0,0
13681,,,Fer_0613,0,1,1,0,1,1,0,0,1,1,1,0
13682,,,Cheollwt,0,1,1,0,1,1,0,0,1,1,1,0
13683,,,LEISUREGODDESS,0,1,1,0,1,1,0,0,1,1,1,0
13684,,,fairychiminie,0,1,1,0,1,1,0,0,1,1,1,0
13685,,,freckllixiie,0,2,2,0,2,2,0,0,1,1,1,0
13686,,,fanyul6c,0,1,1,0,1,1,0,0,1,1,1,0
13687,,,momocunt,0,1,1,0,1,1,0,0,1,1,1,0
13688,,,788906432fg,0,1,1,0,1,1,0,0,1,1,1,0
13689,,,roundyuzu,0,1,1,0,1,1,0,0,1,1,1,0
13690,,,sporephyte,0,1,1,0,1,1,0,0,2,0.666667,0.75,0
13691,,,SEUNGSTARZ,0,2,2,0,2,2,0,0,2,0.75,0.833333,0
13692,,,kgG8PTQB83476zI,0,1,1,0,1,1,0,0,2,0.666667,0.75,0
13693,,,tatiana00777,9,1,10,10,2,12,0.111111,0.144828,0,0,0,0
13694,,,ConortKelleher,5,1,6,5,1,6,0.2,0.033436,0,0,0,0
13695,,,markIeena,0,1,1,0,1,1,0,0,1,1,1,0
13696,,,bailey_breani,0,1,1,0,1,1,0,0,1,1,1,0
13697,,,suxarchives,1,1,2,1,1,2,0,0.006687,0,0,0,0
13698,,,Kpop16631110,0,1,1,0,1,1,0,0,1,1,1,0
13699,,,poergdameron,0,1,1,0,1,1,0,0,1,1,1,0
13700,,,Alis2316,0,1,1,0,1,1,0,0,1,1,1,0
13701,,,turkeyandmayo,1,1,2,1,1,2,0,0.006687,0,0,0,0
13702,,,crowder,1,1,2,1,1,2,0,0.006687,0,0,0,0
13703,,,LxurxGxrcixda,0,1,1,0,1,1,0,0,1,1,1,0
13704,,,hensleragency,4,1,5,4,1,5,0.25,0.026749,0,0,0,0
13705,,,dalbissi,0,1,1,0,1,1,0,0,1,1,1,0
13706,,,junidraws,0,1,1,0,1,1,0,0,1,1,1,0
13707,,,Bela_Cinderella,1,1,2,1,1,2,0,0.006687,0,0,0,0
13708,,,AlexKaseberg,1,1,2,1,1,2,0,0.006687,0,0,0,0
13709,,,manaonaonao,0,1,1,0,1,1,0,0,2,0.555556,0.6,0
13710,,,Zhong_Hilario,0,1,1,0,1,1,0,0,2,0.555556,0.6,0
13711,,,beautesee,0,1,1,0,1,1,0,0,2,0.555556,0.6,0
13712,,,matsuge13apfel,0,1,1,0,1,1,0,0,2,0.666667,0.75,0
13713,,,guillaumetta,0,1,1,0,1,1,0,0,2,0.666667,0.75,0
13714,,,karlacyj,0,1,1,0,1,1,0,0,2,0.666667,0.75,0
13715,,,edwardslea2008,0,1,1,0,1,1,0,0,2,0.666667,0.75,0
13716,,,pri_twts,0,1,1,0,1,1,0,0,2,0.666667,0.75,0
13717,,,taelrc5,0,1,1,0,1,1,0,0,2,0.666667,0.75,0
13718,,,Epic0311,0,1,1,0,1,1,0,0,1,1,1,0
13719,,,PatrickNewsAlt,0,1,1,0,1,1,0,0,1,1,1,0
13720,,,KristiReardon,0,1,1,0,1,1,0,0,1,1,1,0
13721,,,M8GUMIS,0,2,2,0,2,2,0,0,1,1,1,0
13722,,,saltealitchi,0,1,1,0,1,1,0,0,1,1,1,0
13723,,,objuanquenove,0,1,1,0,1,1,0,0,1,1,1,0
13724,,,rmnstr,2,1,3,2,1,3,0.5,0.013374,0,0,0,0
13725,,,Gigi_Gambino,5,1,6,5,1,6,0.2,0.033436,0,0,0,0
13726,,,hairspraykv,0,1,1,0,1,1,0,0,1,1,1,0
13727,,,yedamisty,0,1,1,0,1,1,0,0,1,1,1,0
13728,,,googlethisd,0,1,1,0,1,1,0,0,1,1,1,0
13729,,,RZLHongKong,1,1,2,1,1,2,0,0.006687,0,0,0,0
13730,,,MEZ57_,0,1,1,0,1,1,0,0,1,1,1,0
13731,,,hyyoons,0,1,1,0,1,1,0,0,1,1,1,0
13732,,,KarmYapa,0,2,2,0,2,2,0,0,1,1,1,0
13733,,,neconojo_,0,1,1,0,1,1,0,0,1,1,1,0
13734,,,ddaengyeon,0,2,2,0,2,2,0,0,1,1,1,0
13735,,,Sami12737373,0,1,1,0,1,1,0,0,1,1,1,0
13736,,,coldcoffeecry,0,1,1,0,1,1,0,0,1,1,1,0
13737,,,romane_fonseka,0,1,1,0,1,1,0,0,1,1,1,0
13738,,,vicky_luz_tw,0,1,1,0,1,1,0,0,1,1,1,0
13739,,,hellchan_,0,1,1,0,1,1,0,0,1,1,1,0
13740,,,entropygloss,0,1,1,0,1,1,0,0,1,1,1,0
13741,,,treintonrocket,0,1,1,0,1,1,0,0,1,1,1,0
13742,,,lifeofclau,0,1,1,0,1,1,0,0,1,1,1,0
13743,,,BiadaszKovbojs,0,1,1,0,1,1,0,0,1,1,1,0
13744,,,KongPhengPha,0,1,1,0,1,1,0,0,1,1,1,0
13745,,,dcoppel,0,1,1,0,1,1,0,0,1,1,1,0
13746,,,blue_green_neko,0,1,1,0,1,1,0,0,1,1,1,0
13747,,,TotallyMakayla,0,1,1,0,1,1,0,0,1,1,1,0
13748,,,Reasony11,0,2,2,0,2,2,0,0,1,1,1,0
13749,,,InferenceLadder,0,6,6,0,6,6,0,0,1,1,1,0
13750,,,Dellinger_Aug11,0,1,1,0,1,1,0,0,1,1,1,0
13751,,,ZenDiva63,0,1,1,0,1,1,0,0,1,1,1,0
13752,,,milgramjp,8,2,10,8,2,10,0.111111,0.053497,1,1,1,7
13753,,,gameofyouu,0,1,1,0,1,1,0,0,1,1,1,0
13754,,,n0tbrb,0,1,1,0,1,1,0,0,1,1,1,0
13755,,,cathyw03,0,1,1,0,1,1,0,0,1,1,1,0
13756,,,philipcwong,0,1,1,0,1,1,0,0,1,1,1,0
13757,,,BTS_enthucutlet,0,1,1,0,1,1,0,0,1,1,1,0
13758,,,Loudmouthkid62,0,1,1,0,1,1,0,0,1,1,1,0
13759,,,rinazai,0,1,1,0,1,1,0,0,1,1,1,0
13760,,,coves_thonks,0,1,1,0,1,1,0,0,1,1,1,0
13761,,,toabeans,0,1,1,0,1,1,0,0,1,1,1,0
13762,,,dankusuo,8,1,9,8,1,9,0.125,0.053497,0,0,0,0
13763,,,StayGOLDxyz,0,1,1,0,1,1,0,0,1,1,1,0
13764,,,avabiia,0,1,1,0,1,1,0,0,1,1,1,0
13765,,,eaudenayeon,0,1,1,0,1,1,0,0,1,1,1,0
13766,,,mina32832773,0,1,1,0,1,1,0,0,1,1,1,0
13767,,,wiltingsprouts,0,1,1,0,1,1,0,0,1,1,1,0
13768,,,tresureeee,0,1,1,0,1,1,0,0,1,1,1,0
13769,,,teaismyreligion,5,1,6,5,1,6,0.2,0.033436,0,0,0,0
13770,,,hajima_ri,0,1,1,0,1,1,0,0,1,1,1,0
13771,,,muqingsgf_,0,1,1,0,1,1,0,0,1,1,1,0
13772,,,S4SHAQUAD,0,1,1,0,1,1,0,0,1,1,1,0
13773,,,jsandovalCF78,0,1,1,0,1,1,0,0,1,1,1,0
13774,,,clrih9,0,1,1,0,1,1,0,0,1,1,1,0
13775,,,kevgraic,0,1,1,0,1,1,0,0,1,1,1,0
13776,,,LevisLeftTittie,0,1,1,0,1,1,0,0,1,1,1,0
13777,,,Kayurna,0,1,1,0,1,1,0,0,1,1,1,0
13778,,,weverome,0,1,1,0,1,1,0,0,1,1,1,0
13779,,,ivanbc31,0,1,1,0,1,1,0,0,1,1,1,0
13780,,,soriikuwu,0,1,1,0,1,1,0,0,1,1,1,0
13781,,,producerloey,0,1,1,0,1,1,0,0,1,1,1,0
13782,,,joyuriful,0,1,1,0,1,1,0,0,1,1,1,0
13783,,,hawksIvt,0,1,1,0,1,1,0,0,1,1,1,0
13784,,,Makkim77,6,1,7,6,1,7,0.166667,0.040123,0,0,0,0
13785,,,SheldonAYS,0,1,1,0,1,1,0,0,1,1,1,0
13786,,,jiniousmin,0,1,1,0,1,1,0,0,1,1,1,0
13787,,,candressalazar,2,1,3,2,1,3,0.5,0.013374,0,0,0,0
13788,,,eunaocaibo,0,1,1,0,1,1,0,0,1,1,1,0
13789,,,Itsuko1250309,0,1,1,0,1,1,0,0,2,0.666667,0.75,0
13790,,,zmarygo,9,1,10,9,1,10,0.111111,0.060184,0,0,0,0
13791,,,lsw0516,0,1,1,0,1,1,0,0,1,1,1,0
13792,,,CDB300,0,1,1,0,1,1,0,0,1,1,1,0
13793,,,melonisapotato,0,1,1,0,1,1,0,0,1,1,1,0
13794,,,courtneyltpg,0,1,1,0,1,1,0,0,1,1,1,0
13795,,,filtrjhs,0,1,1,0,1,1,0,0,1,1,1,0
13796,,,Jgioello1,0,1,1,0,1,1,0,0,1,1,1,0
13797,,,Mawiiixx,0,1,1,0,1,1,0,0,1,1,1,0
13798,,,larrywo88803281,0,1,1,0,1,1,0,0,1,1,1,0
13799,,,starcrow54,4,1,5,4,1,5,0.25,0.026749,0,0,0,0
13800,,,podcast_kitchen,0,1,1,0,1,1,0,0,1,1,1,0
13801,,,Gpoljunkie,0,1,1,0,1,1,0,0,1,1,1,0
13802,,,jiminstaejoon,0,1,1,0,1,1,0,0,1,1,1,0
13803,,,siynetax,4,1,5,4,1,5,0.25,0.030243,0,0,0,0
13804,,,Qnnie203,0,1,1,0,1,1,0,0,1,1,1,0
13805,,,mikro_pjm,0,1,1,0,1,1,0,0,1,1,1,0
13806,,,SwiftieCat17,0,2,2,0,2,2,0,0,1,1,1,0
13807,,,wanasnoo,0,1,1,0,1,1,0,0,1,1,1,0
13808,,,niconyxtorres,0,1,1,0,1,1,0,0,1,1,1,0
13809,,,seraphicskys,0,1,1,0,1,1,0,0,1,1,1,0
13810,,,lLOVEH00N,0,1,1,0,1,1,0,0,1,1,1,0
13811,,,_silversmith,0,1,1,0,1,1,0,0,1,1,1,0
13812,,,bunniepheeb,0,1,1,0,1,1,0,0,1,1,1,0
13813,,,transjostens,0,1,1,0,1,1,0,0,1,1,1,0
13814,,,ACLAYsuper,0,2,2,0,2,2,0,0,2,0.75,0.833333,0
13815,,,kvlomls,0,1,1,0,1,1,0,0,1,1,1,0
13816,,,TessaBlue18,0,1,1,0,1,1,0,0,1,1,1,0
13817,,,morgaskofen,0,1,1,0,1,1,0,0,1,1,1,0
13818,,,JackieKrizanic1,0,1,1,0,1,1,0,0,1,1,1,0
13819,,,beetadori,4,1,5,4,1,5,0.25,0.026749,0,0,0,0
13820,,,cosmicoSeven7s,0,1,1,0,1,1,0,0,1,1,1,0
13821,,,MariahRirianais,0,1,1,0,1,1,0,0,1,1,1,0
13822,,,jocelynnlydia,0,1,1,0,1,1,0,0,1,1,1,0
13823,,,Nobody_Nowhere8,0,1,1,0,1,1,0,0,1,1,1,0
13824,,,EmmaDrozen,30,1,31,31,1,32,0.033333,0.200614,0,0,0,0
13825,,,_soughtflower,0,1,1,0,1,1,0,0,1,1,1,0
13826,,,Innflvr,0,1,1,0,1,1,0,0,1,1,1,0
13827,,,Stavi__,0,1,1,0,1,1,0,0,1,1,1,0
13828,,,julsfoley,0,1,1,0,1,1,0,0,1,1,1,0
13829,,,katjolufan,0,1,1,0,1,1,0,0,1,1,1,0
13830,,,k1mm1nseok,0,1,1,0,1,1,0,0,1,1,1,0
13831,,,beomie_s,0,1,1,0,1,1,0,0,1,1,1,0
13832,,,84giverny,0,1,1,0,1,1,0,0,1,1,1,0
13833,,,junhaomeal,0,1,1,0,1,1,0,0,1,1,1,0
13834,,,justHOME28,0,1,1,0,1,1,0,0,1,1,1,0
13835,,,beavergril,0,1,1,0,1,1,0,0,1,1,1,0
13836,,,thatnerd06,0,1,1,0,1,1,0,0,1,1,1,0
13837,,,dianabechini93,0,1,1,0,1,1,0,0,1,1,1,0
13838,,,chikoguch1203,0,1,1,0,1,1,0,0,1,1,1,0
13839,,,pavedis1,0,1,1,0,1,1,0,0,1,1,1,0
13840,,,stlmrn1,0,1,1,0,1,1,0,0,1,1,1,0
13841,,,dismantlegop,0,1,1,0,1,1,0,0,1,1,1,0
13842,,,AngelicaAraujoG,0,1,1,0,1,1,0,0,1,1,1,0
13843,,,Pal050870,0,1,1,0,1,1,0,0,1,1,1,0
13844,,,Bewitched9,0,1,1,0,1,1,0,0,1,1,1,0
13845,,,MichaelVadok,0,1,1,0,1,1,0,0,1,1,1,0
13846,,,bangtamsay,0,1,1,0,1,1,0,0,1,1,1,0
13847,,,chuuesz,0,1,1,0,1,1,0,0,1,1,1,0
13848,,,femcel_girlboss,6,2,8,6,2,8,0.142857,0.047111,1,1,1,6
13849,,,wanwannw,0,1,1,0,1,1,0,0,2,0.666667,0.75,0
13850,,,jkuforia,0,1,1,0,1,1,0,0,2,0.666667,0.75,0
13851,,,dnpkie,0,1,1,0,1,1,0,0,2,0.666667,0.75,0
13852,,,Ragtoring,0,1,1,0,1,1,0,0,2,0.666667,0.75,0
13853,,,slcoody,4,1,5,4,1,5,0.25,0.026749,0,0,0,0
13854,,,kittyjunmyeon,0,1,1,0,1,1,0,0,1,1,1,0
13855,,,pinkerodababy,0,1,1,0,1,1,0,0,1,1,1,0
13856,,,mirax3domino777,0,1,1,0,1,1,0,0,1,1,1,0
13857,,,tatsuki_fuji,0,1,1,0,1,1,0,0,1,1,1,0
13858,,,vsratorafik,0,1,1,0,1,1,0,0,1,1,1,0
13859,,,MigMorales4,0,1,1,0,1,1,0,0,1,1,1,0
13860,,,LanaReads,0,1,1,0,1,1,0,0,1,1,1,0
13861,,,caratran8597,0,1,1,0,1,1,0,0,1,1,1,0
13862,,,CalicoCLC,0,1,1,0,1,1,0,0,1,1,1,0
13863,,,danhaprasangrai,0,1,1,0,1,1,0,0,1,1,1,0
13864,,,tedcahill,20,1,21,21,1,22,0.05,0.137237,0,0,0,0
13865,,,KarlaGo93706959,0,1,1,0,1,1,0,0,1,1,1,0
13866,,,PradoQuijano,0,1,1,0,1,1,0,0,1,1,1,0
13867,,,ZmiluskaF,0,1,1,0,2,2,0,0,1,1,1,0
13868,,,CowieKaunweigh,0,1,1,0,1,1,0,0,1,1,1,0
13869,,,hueninkgai,0,1,1,0,1,1,0,0,1,1,1,0
13870,,,blkjirou,0,1,1,0,1,1,0,0,1,1,1,0
13871,,,iloveuwayvmuch,0,1,1,0,1,1,0,0,1,1,1,0
13872,,,whitekoongyaa,0,1,1,0,1,1,0,0,1,1,1,0
13873,,,tobiotgcf,0,1,1,0,1,1,0,0,1,1,1,0
13874,,,leetaetenmark,0,1,1,0,1,1,0,0,1,1,1,0
13875,,,milkbraeds,0,1,1,0,1,1,0,0,1,1,1,0
13876,,,mymyvale,0,1,1,0,1,1,0,0,1,1,1,0
13877,,,Minnak_cadi1,0,1,1,0,1,1,0,0,1,1,1,0
13878,,,CJ_isnowblue,0,1,1,0,1,1,0,0,1,1,1,0
13879,,,jiminjungoogie,0,1,1,0,1,1,0,0,1,1,1,0
13880,,,Sylvaners,6,1,7,6,1,7,0.166667,0.061088,0,0,0,0
13881,,,jonghoribos,0,1,1,0,1,1,0,0,1,1,1,0
13882,,,chaoticgyu,0,1,1,0,1,1,0,0,1,1,1,0
13883,,,neobex_,0,1,1,0,1,1,0,0,1,1,1,0
13884,,,LarryDePaoli,7,1,8,7,1,8,0.142857,0.04681,0,0,0,0
13885,,,publicspace_ll,0,1,1,0,1,1,0,0,1,1,1,0
13886,,,cxn4689,0,1,1,0,1,1,0,0,1,1,1,0
13887,,,MollaMiND,0,1,1,0,1,1,0,0,1,1,1,0
13888,,,halfdoomed_,0,1,1,0,1,1,0,0,1,1,1,0
13889,,,PepinoSama,0,1,1,0,1,1,0,0,1,1,1,0
13890,,,chen_yuh,0,1,1,0,1,1,0,0,1,1,1,0
13891,,,tittymic,23,1,24,26,1,27,0.043478,0.153804,0,0,0,0
13892,,,FightAlzNow,0,1,1,0,1,1,0,0,1,1,1,0
13893,,,tomkenn94364088,0,1,1,0,1,1,0,0,1,1,1,0
13894,,,yuzuru66862515,0,1,1,0,1,1,0,0,1,1,1,0
13895,,,_7isgo,0,1,1,0,1,1,0,0,1,1,1,0
13896,,,kyokoeika,0,10,10,0,14,14,0,0,3,0.8,0.902778,0
13897,,,plutovvv,0,1,1,0,1,1,0,0,1,1,1,0
13898,,,Wvikt0rr,0,1,1,0,1,1,0,0,1,1,1,0
13899,,,malissa18cx,0,1,1,0,1,1,0,0,1,1,1,0
13900,,,junwenjunhui,0,1,1,0,1,1,0,0,1,1,1,0
13901,,,ryuunyasuke,0,1,1,0,1,1,0,0,1,1,1,0
13902,,,buIbbuI,0,1,1,0,1,1,0,0,1,1,1,0
13903,,,lilmeowjk_,0,1,1,0,1,1,0,0,1,1,1,0
13904,,,jennonthego,0,1,1,0,1,1,0,0,4,0.384615,0.483333,0
13905,,,t_toripy,0,1,1,0,1,1,0,0,4,0.384615,0.483333,0
13906,,,eyesonyugjae,0,1,1,0,1,1,0,0,4,0.384615,0.483333,0
13907,,,thatflowerpetal,0,1,1,0,1,1,0,0,4,0.384615,0.483333,0
13908,,,jinijini618,0,1,1,0,1,1,0,0,4,0.384615,0.483333,0
13909,,,vminjinchim,0,1,1,0,1,1,0,0,4,0.384615,0.483333,0
13910,,,haosju,1,1,2,1,1,2,0,0.006687,0,0,0,0
13911,,,echopress,7,1,8,7,1,8,0.142857,0.04681,0,0,0,0
13912,,,yuzubear,0,1,1,0,1,1,0,0,1,1,1,0
13913,,,ANTlMOON,0,1,1,0,1,1,0,0,1,1,1,0
13914,,,whitepupjh,0,1,1,0,1,1,0,0,1,1,1,0
13915,,,lanjiejiee,0,1,1,0,1,1,0,0,1,1,1,0
13916,,,eunyoonease,0,1,1,0,1,1,0,0,1,1,1,0
13917,,,melissadelmonte,4,1,5,4,1,5,0.25,0.026749,0,0,0,0
13918,,,joloism,0,1,1,0,1,1,0,0,1,1,1,0
13919,,,PrezLives2022,0,1,1,0,1,1,0,0,1,1,1,0
13920,,,sunkhyu,9,1,10,9,1,10,0.111111,0.06898,0,0,0,0
13921,,,jeglek,0,1,1,0,1,1,0,0,1,1,1,0
13922,,,HoangNhi344,0,1,1,0,1,1,0,0,1,1,1,0
13923,,,biasless,0,1,1,0,1,1,0,0,1,1,1,0
13924,,,yutasfavorite,0,1,1,0,1,1,0,0,1,1,1,0
13925,,,eu4eyah4,0,1,1,0,1,1,0,0,1,1,1,0
13926,,,dreamnwastaken,0,1,1,0,1,1,0,0,1,1,1,0
13927,,,SCMPNews,1,1,2,1,1,2,0,0.006687,0,0,0,0
13928,,,ZaaboCole,6,1,7,6,1,7,0.166667,0.040123,0,0,0,0
13929,,,onathanchi,0,2,2,0,2,2,0,0,1,1,1,0
13930,,,vernxnbae,0,1,1,0,1,1,0,0,1,1,1,0
13931,,,swearimnotmaria,0,1,1,0,1,1,0,0,1,1,1,0
13932,,,enbycoraline,0,1,1,0,1,1,0,0,1,1,1,0
13933,,,lgqxf2,18,1,19,18,1,19,0.055556,0.120369,0,0,0,0
13934,,,2pmkhunrok,0,1,1,0,1,1,0,0,1,1,1,0
13935,,,tianshianne,0,1,1,0,1,1,0,0,1,1,1,0
13936,,,PlumYuan,0,1,1,0,1,1,0,0,1,1,1,0
13937,,,mooncoldd,0,1,1,0,1,1,0,0,1,1,1,0
13938,,,BishICareNone,0,1,1,0,1,1,0,0,1,1,1,0
13939,,,Dainsleiph,0,1,1,0,1,1,0,0,1,1,1,0
13940,,,GIASFS,0,1,1,0,1,1,0,0,1,1,1,0
13941,,,countingvowels,0,1,1,0,1,1,0,0,1,1,1,0
13942,,,infinityonsoo,0,1,1,0,1,1,0,0,1,1,1,0
13943,,,Tsingzc,0,1,1,0,1,1,0,0,1,1,1,0
13944,,,4cssy,0,1,1,0,1,1,0,0,1,1,1,0
13945,,,mervikascyare,0,1,1,0,1,1,0,0,1,1,1,0
13946,,,_rosaceaefolia,0,1,1,0,1,1,0,0,1,1,1,0
13947,,,SenchaBag,8,1,9,8,1,9,0.125,0.056991,0,0,0,0
13948,,,dspringwillcome,0,1,1,0,1,1,0,0,1,1,1,0
13949,,,notyourfmoon,0,1,1,0,1,1,0,0,1,1,1,0
13950,,,bxyq_,0,1,1,0,1,1,0,0,1,1,1,0
13951,,,HertlToEklund,0,1,1,0,1,1,0,0,1,1,1,0
13952,,,Lavenderine_,0,1,1,0,1,1,0,0,1,1,1,0
13953,,,radoncnotes,4,1,5,4,1,5,0.25,0.026749,0,0,0,0
13954,,,rosecoloredsuga,0,1,1,0,1,1,0,0,1,1,1,0
13955,,,BLESSK0,0,1,1,0,1,1,0,0,1,1,1,0
13956,,,X1A0TlNG,0,1,1,0,1,1,0,0,1,1,1,0
13957,,,commieVarian,10,1,11,11,1,12,0.1,0.075667,0,0,0,0
13958,,,ohjiso_,0,1,1,0,1,1,0,0,1,1,1,0
13959,,,tearthemoon_,0,1,1,0,1,1,0,0,1,1,1,0
13960,,,charliekvvn,0,2,2,0,2,2,0,0,1,1,1,0
13961,,,chinchiraaa,0,1,1,0,1,1,0,0,1,1,1,0
13962,,,emmie_796,14,1,15,14,1,15,0.071429,0.116392,0,0,0,0
13963,,,A_effervescent,0,1,1,0,1,1,0,0,1,1,1,0
13964,,,GAPABALaw,0,1,1,0,1,1,0,0,1,1,1,0
13965,,,h0neyggukie,0,1,1,0,1,1,0,0,1,1,1,0
13966,,,ellejaygeek21,0,1,1,0,1,1,0,0,1,1,1,0
13967,,,seokjinsluvbot,0,1,1,0,1,1,0,0,1,1,1,0
13968,,,Lithium43113082,0,1,1,0,1,1,0,0,1,1,1,0
13969,,,NenethskiB54,0,1,1,0,1,1,0,0,1,1,1,0
13970,,,_nahoemiecartz,0,1,1,0,1,1,0,0,1,1,1,0
13971,,,thotaegi,0,1,1,0,1,1,0,0,1,1,1,0
13972,,,seokjinier,17,1,18,18,1,19,0.058824,0.122477,0,0,0,0
13973,,,TeaParty0000,0,1,1,0,1,1,0,0,1,1,1,0
13974,,,nomj00nie,0,1,1,0,1,1,0,0,1,1,1,0
13975,,,Tania_and_Bunny,0,1,1,0,1,1,0,0,1,1,1,0
13976,,,Whatthenugget,0,1,1,0,1,1,0,0,1,1,1,0
13977,,,_stormbirdie,0,1,1,0,1,1,0,0,1,1,1,0
13978,,,prisciIalovely,0,1,1,0,1,1,0,0,1,1,1,0
13979,,,Abidemi_17,0,1,1,0,1,1,0,0,1,1,1,0
13980,,,swen_ryan,0,1,1,0,1,1,0,0,1,1,1,0
13981,,,heavenlyhannie,0,1,1,0,1,1,0,0,1,1,1,0
13982,,,ChaEvans1,0,1,1,0,1,1,0,0,1,1,1,0
13983,,,SHIZI41327718,0,1,1,0,1,1,0,0,1,1,1,0
13984,,,fuyuziao,0,1,1,0,1,1,0,0,1,1,1,0
13985,,,ballisafterlife,0,1,1,0,1,1,0,0,1,1,1,0
13986,,,Natalie08856991,0,1,1,0,1,1,0,0,1,1,1,0
13987,,,s4pphicbeidou,0,1,1,0,1,1,0,0,1,1,1,0
13988,,,taegikooknovios,0,1,1,0,1,1,0,0,1,1,1,0
13989,,,venibaek,0,1,1,0,1,1,0,0,1,1,1,0
13990,,,txtjkbg,0,1,1,0,1,1,0,0,1,1,1,0
13991,,,papipoo,0,1,1,0,1,1,0,0,1,1,1,0
13992,,,morgan_aren,9,1,10,9,1,10,0.111111,0.065639,0,0,0,0
13993,,,aijaiy,0,1,1,0,1,1,0,0,1,1,1,0
13994,,,koushinoai,0,1,1,0,1,1,0,0,1,1,1,0
13995,,,ThuhleaNotTalia,0,1,1,0,1,1,0,0,1,1,1,0
13996,,,yoonsangle,0,1,1,0,1,1,0,0,1,1,1,0
13997,,,onenonlysuh,0,1,1,0,1,1,0,0,1,1,1,0
13998,,,dazailuvs,0,1,1,0,1,1,0,0,1,1,1,0
13999,,,ceemeterydrive,2,1,3,2,1,3,0,0.00792,1,1,1,2
14000,,,Mitchultlan,0,1,1,0,1,1,0,0,1,1,1,0
14001,,,CawCaw82814248,0,1,1,0,1,1,0,0,1,1,1,0
14002,,,EmergencySXM,2,1,3,2,1,3,0.5,0.013374,0,0,0,0
14003,,,thornebone,0,1,1,0,1,1,0,0,1,1,1,0
14004,,,TheCeeJay_S,2,1,3,2,1,3,0.5,0.013374,0,0,0,0
14005,,,funglau2k,2,1,3,2,1,3,0.5,0.013374,0,0,0,0
14006,,,wendyrhps,0,1,1,0,1,1,0,0,1,1,1,0
14007,,,RahulSKofficial,1,1,2,1,1,2,0,0.006687,0,0,0,0
14008,,,OwlLeeCec,2,1,3,2,1,3,0.5,0.013374,0,0,0,0
14009,,,stainless_jug,0,1,1,0,1,1,0,0,1,1,1,0
14010,,,KevinPHayes13,0,1,1,0,1,1,0,0,3,0.5,0.611111,0
14011,,,ccc_chercar,0,1,1,0,1,1,0,0,3,0.5,0.611111,0
14012,,,xiaol_ng,0,1,1,0,1,1,0,0,3,0.5,0.611111,0
14013,,,joy_kardashian,0,1,1,0,1,1,0,0,3,0.5,0.611111,0
14014,,,breecreates_kai,0,1,1,0,2,2,0,0,3,0.5,0.611111,0
14015,,,taekoopout,0,1,1,0,1,1,0,0,3,0.5,0.611111,0
14016,,,penglin88839559,0,1,1,0,1,1,0,0,3,0.5,0.611111,0
14017,,,hsmcnp,0,2,2,0,2,2,0,0,3,0.571429,0.708333,0
14018,,,Whitesure810,0,1,1,0,1,1,0,0,3,0.5,0.611111,0
14019,,,ShakarHye,1,1,2,1,1,2,0,0.006687,0,0,0,0
14020,,,_repugnant,2,1,3,2,1,3,0.5,0.013374,0,0,0,0
14021,,,yuzuruhan94,0,5,5,0,9,9,0.05,0,1,1,1,0
14022,,,xuthoria,5,1,6,5,1,6,0.2,0.033436,0,0,0,0
14023,,,CalaHincapie,0,1,1,0,1,1,0,0,1,1,1,0
14024,,,thvhanyu,0,1,1,0,1,1,0,0,1,1,1,0
14025,,,myhopewrld,0,1,1,0,1,1,0,0,1,1,1,0
14026,,,vstolbruin,4,1,5,4,1,5,0.25,0.026749,0,0,0,0
14027,,,02Kariii1,0,1,1,0,1,1,0,0,1,1,1,0
14028,,,4yzy053210,0,1,1,0,1,1,0,0,1,1,1,0
14029,,,luna_crystalbb,10,1,11,10,1,11,0.1,0.066871,0,0,0,0
14030,,,Chimjam1,0,1,1,0,1,1,0,0,1,1,1,0
14031,,,_MonetAkira_,0,1,1,0,1,1,0,0,1,1,1,0
14032,,,Larara_11,0,1,1,0,1,1,0,0,1,1,1,0
14033,,,fskatingdrama,0,1,1,0,1,1,0,0,1,1,1,0
14034,,,jkohlmann,0,1,1,0,1,1,0,0,1,1,1,0
14035,,,xtakatamashiho,0,1,1,0,1,1,0,0,1,1,1,0
14036,,,hanyuchopin,0,1,1,0,1,1,0,0,1,1,1,0
14037,,,fightingsan,4,1,5,4,1,5,0.25,0.026749,0,0,0,0
14038,,,iTorento,0,1,1,0,1,1,0,0,1,1,1,0
14039,,,u7CbxtZdEPgdNDc,0,2,2,0,2,2,0,0,1,1,1,0
14040,,,Shreyakhuranaa,0,1,1,0,1,1,0,0,1,1,1,0
14041,,,ViviannnCarp,17,2,19,17,2,19,0.055556,0.14375,1,1,1,24
14042,,,Vesustae,0,1,1,0,1,1,0,0,2,0.666667,0.75,0
14043,,,stefihane,0,1,1,0,1,1,0,0,2,0.666667,0.75,0
14044,,,anxietea9,0,1,1,0,1,1,0,0,2,0.666667,0.75,0
14045,,,misako38,0,1,1,0,1,1,0,0,2,0.666667,0.75,0
14046,,,sandyalx,0,1,1,0,1,1,0,0,2,0.666667,0.75,0
14047,,,hiroroyuzu,0,1,1,0,1,1,0,0,2,0.666667,0.75,0
14048,,,khunswhore,0,1,1,0,1,1,0,0,2,0.666667,0.75,0
14049,,,takamisienne,0,1,1,0,1,1,0,0,2,0.666667,0.75,0
14050,,,myunhoppe,0,1,1,0,1,1,0,0,2,0.666667,0.75,0
14051,,,AnnaSaephan,0,1,1,0,1,1,0,0,1,1,1,0
14052,,,TARO2022,0,1,1,0,1,1,0,0,1,1,1,0
14053,,,madeloo,0,1,1,0,1,1,0,0,1,1,1,0
14054,,,Grassuke,7,1,8,7,1,8,0.142857,0.04681,0,0,0,0
14055,,,zemlei,0,1,1,0,1,1,0,0,1,1,1,0
14056,,,doubleblaq,0,1,1,0,1,1,0,0,1,1,1,0
14057,,,Coltongirlovato,0,1,1,0,1,1,0,0,1,1,1,0
14058,,,wybh0954,0,1,1,0,1,1,0,0,1,1,1,0
14059,,,vla13,0,1,1,0,1,1,0,0,1,1,1,0
14060,,,andreakoifish,3,1,4,3,1,4,0.333333,0.020061,0,0,0,0
14061,,,jaseirvs,0,2,2,0,2,2,0,0,1,1,1,0
14062,,,moonl1ghtmelody,2,1,3,2,1,3,0.5,0.013374,0,0,0,0
14063,,,doie4lifer,24,1,25,25,1,26,0.043478,0.260734,0,0,0,0
14064,,,parkjmsgirl,0,1,1,0,1,1,0,0,1,1,1,0
14065,,,Peaxh04,0,1,1,0,1,1,0,0,1,1,1,0
14066,,,swissscot,0,2,2,0,2,2,0,0,1,1,1,0
14067,,,Miyo_moment,0,1,1,0,1,1,0,0,1,1,1,0
14068,,,dscheinm,0,1,1,0,1,1,0,0,1,1,1,0
14069,,,monicarans,0,1,1,0,1,1,0,0,1,1,1,0
14070,,,dgrayi13,0,1,1,0,1,1,0,0,1,1,1,0
14071,,,jaebiscuit,0,1,1,0,1,1,0,0,1,1,1,0
14072,,,LuciWithAnI,0,1,1,0,1,1,0,0,1,1,1,0
14073,,,NaniRd1,0,1,1,0,1,1,0,0,1,1,1,0
14074,,,fin_queenie,0,1,1,0,1,1,0,0,1,1,1,0
14075,,,Forestwoodwood,0,2,2,0,2,2,0,0,1,1,1,0
14076,,,laurespin,0,1,1,0,1,1,0,0,1,1,1,0
14077,,,Shiuan403,0,1,1,0,1,1,0,0,1,1,1,0
14078,,,jhoside,0,1,1,0,1,1,0,0,1,1,1,0
14079,,,hobi_amour,0,1,1,0,1,1,0,0,1,1,1,0
14080,,,marissamaym,0,1,1,0,1,1,0,0,1,1,1,0
14081,,,chainstokes14,0,1,1,0,1,1,0,0,1,1,1,0
14082,,,Forest08199718,5,1,6,6,2,8,0.2,0.033436,0,0,0,0
14083,,,_aliuska,0,1,1,0,1,1,0,0,1,1,1,0
14084,,,chante_twt,0,1,1,0,1,1,0,0,1,1,1,0
14085,,,mikeouye,1,1,2,1,1,2,0,0.006687,0,0,0,0
14086,,,choya160,4,1,5,4,1,5,0.25,0.026749,0,0,0,0
14087,,,malademar,0,1,1,0,1,1,0,0,1,1,1,0
14088,,,RomerJohnJames1,0,2,2,0,2,2,0,0,1,1,1,0
14089,,,JozaCornett101,0,1,1,0,1,1,0,0,1,1,1,0
14090,,,hinatas_simp,5,1,6,5,1,6,0.2,0.033436,0,0,0,0
14091,,,CrystalCinn,0,1,1,0,1,1,0,0,1,1,1,0
14092,,,atincali4nia,9,1,10,9,1,10,0.125,0.255502,0,0,0,0
14093,,,annylai0816,0,1,1,0,1,1,0,0,1,1,1,0
14094,,,deuxvelvet,0,1,1,0,1,1,0,0,1,1,1,0
14095,,,ocanto_de_uma_s,0,1,1,0,1,1,0,0,1,1,1,0
14096,,,fuckingjello_,0,1,1,0,1,1,0,0,1,1,1,0
14097,,,kiyocc_yuzu,0,1,1,0,1,1,0,0,1,1,1,0
14098,,,mizpiggy111,0,1,1,0,1,1,0,0,1,1,1,0
14099,,,elizaelsaian,12,1,13,13,1,14,0.083333,0.08374,0,0,0,0
14100,,,SondraCosgrove,0,1,1,0,1,1,0,0,1,1,1,0
14101,,,yoda,0,1,1,0,1,1,0,0,1,1,1,0
14102,,,SusanTrear,0,1,1,0,1,1,0,0,1,1,1,0
14103,,,Mandyvainilla,0,1,1,0,1,1,0,0,1,1,1,0
14104,,,hilynxm_,0,1,1,0,1,1,0,0,1,1,1,0
14105,,,sweet_sshi,0,1,1,0,1,1,0,0,1,1,1,0
14106,,,EmmaQiaoping,0,1,1,0,1,1,0,0,1,1,1,0
14107,,,nikapaprika,1,2,3,1,2,3,0.5,0.006687,1,1,1,0
14108,,,xiaolore,6,1,7,6,1,7,0.166667,0.040123,0,0,0,0
14109,,,alexisohanian,0,1,1,0,1,1,0,0,1,1,1,0
14110,,,BTheCobb,0,1,1,0,1,1,0,0,1,1,1,0
14111,,,xzgucciboy_,0,1,1,0,1,1,0,0,1,1,1,0
14112,,,Icesmurfette,0,1,1,0,1,1,0,0,1,1,1,0
14113,,,litareads,2,1,3,2,1,3,0.5,0.013374,0,0,0,0
14114,,,LazyMiKki,0,1,1,0,1,1,0,0,1,1,1,0
14115,,,TheUSArmenians,3,1,4,3,1,4,0.333333,0.020061,0,0,0,0
14116,,,B0Hrb3aD1YKr9w8,0,1,1,0,1,1,0,0,1,1,1,0
14117,,,ImekaSF,0,1,1,0,1,1,0,0,1,1,1,0
14118,,,ghoibla,1,1,2,1,1,2,0,0.006687,0,0,0,0
14119,,,JordanESP,12,1,13,12,1,13,0.083333,0.080246,0,0,0,0
14120,,,taremimipanda,0,1,1,0,1,1,0,0,1,1,1,0
14121,,,__miaka__,0,1,1,0,1,1,0,0,1,1,1,0
14122,,,mmooyyaa25,0,1,1,0,1,1,0,0,1,1,1,0
14123,,,mocchimonac,0,1,1,0,1,1,0,0,1,1,1,0
14124,,,deeznutwt,0,5,5,0,5,5,0,0,1,1,1,0
14125,,,SENILAETITIA2,0,1,1,0,1,1,0,0,1,1,1,0
14126,,,taegithetiger,0,1,1,0,1,1,0,0,1,1,1,0
14127,,,LOVEURSELFTEAR,0,1,1,0,1,1,0,0,1,1,1,0
14128,,,okay_k3nny,0,1,1,0,1,1,0,0,1,1,1,0
14129,,,Crowkarlayahoo1,0,1,1,0,1,1,0,0,2,0.666667,0.75,0
14130,,,nouveau3a,0,1,1,0,1,1,0,0,2,0.666667,0.75,0
14131,,,yuzuwooseok,0,1,1,0,1,1,0,0,2,0.666667,0.75,0
14132,,,Na_o_cchiFC_28,0,1,1,0,1,1,0,0,2,0.666667,0.75,0
14133,,,macolon2,0,1,1,0,1,1,0,0,2,0.666667,0.75,0
14134,,,SEATALIA,0,1,1,0,1,1,0,0,2,0.666667,0.75,0
14135,,,JentoftMichael,0,1,1,0,1,1,0,0,2,0.666667,0.75,0
14136,,,byethewayyy,0,1,1,0,1,1,0,0,2,0.666667,0.75,0
14137,,,Lovablejhope,0,1,1,0,1,1,0,0,2,0.666667,0.75,0
14138,,,lacey57246999,0,4,4,0,5,5,0,0,2,0.833333,0.9,0
14139,,,ziyiliu31687052,0,1,1,0,1,1,0,0,2,0.666667,0.75,0
14140,,,txtinvictus,0,1,1,0,1,1,0,0,2,0.666667,0.75,0
14141,,,ktuohyfans,0,1,1,0,1,1,0,0,2,0.666667,0.75,0
14142,,,JawadPullin,0,1,1,0,1,1,0,0,2,0.666667,0.75,0
14143,,,diccids,0,1,1,0,1,1,0,0,2,0.666667,0.75,0
14144,,,hrsepowr04,0,1,1,0,1,1,0,0,3,0.5,0.583333,0
14145,,,Patrici20765403,0,1,1,0,1,1,0,0,3,0.5,0.583333,0
14146,,,germankar26,6,1,7,6,1,7,0.166667,0.040123,0,0,0,0
14147,,,jmnswirl,0,1,1,0,1,1,0,0,1,1,1,0
14148,,,wizkid5000,0,1,1,0,1,1,0,0,1,1,1,0
14149,,,random_fandms,0,1,1,0,1,1,0,0,1,1,1,0
14150,,,lejenma,0,1,1,0,1,1,0,0,1,1,1,0
14151,,,aileenlee,2,1,3,2,1,3,0.5,0.013374,0,0,0,0
14152,,,lxx_prettymuch,0,1,1,0,1,1,0,0,1,1,1,0
14153,,,vertigoal,8,1,9,9,1,10,0.125,0.053497,0,0,0,0
14154,,,KaahanuiIkaika,0,1,1,0,2,2,0,0,1,1,1,0
14155,,,n3gHDrkmeR7kb27,0,1,1,0,1,1,0,0,1,1,1,0
14156,,,Colraz825,0,1,1,0,1,1,0,0,1,1,1,0
14157,,,minnobara,0,1,1,0,1,1,0,0,1,1,1,0
14158,,,YEONTANSYOONGI,0,1,1,0,1,1,0,0,1,1,1,0
14159,,,nosliwyelhsa,0,1,1,0,1,1,0,0,1,1,1,0
14160,,,DJimjn,0,1,1,0,1,1,0,0,1,1,1,0
14161,,,wihyeonyi,3,1,4,3,1,4,0.333333,0.020061,0,0,0,0
14162,,,j9hnny5,0,1,1,0,1,1,0,0,1,1,1,0
14163,,,han_xiaolei,0,1,1,0,1,1,0,0,3,0.5,0.583333,0
14164,,,jjangskiz,0,1,1,0,1,1,0,0,3,0.5,0.583333,0
14165,,,TDeiei,0,1,1,0,1,1,0,0,3,0.5,0.583333,0
14166,,,icyyuzujun,2,1,3,2,1,3,0.5,0.013374,0,0,0,0
14167,,,saffsquires,0,1,1,0,1,1,0,0,1,1,1,0
14168,,,babysseoks,0,1,1,0,1,1,0,0,1,1,1,0
14169,,,Shawnft305,0,1,1,0,1,1,0,0,1,1,1,0
14170,,,Jose__Briceno,0,2,2,0,2,2,0,0,1,1,1,0
14171,,,magetano_,0,1,1,0,1,1,0,0,1,1,1,0
14172,,,decmberstragedy,3,1,4,3,1,4,0.333333,0.020061,0,0,0,0
14173,,,purpleroses102,0,1,1,0,1,1,0,0,1,1,1,0
14174,,,jinjinsuger3,0,3,3,0,3,3,0,0,1,1,1,0
14175,,,packer_nat12,6,1,7,7,1,8,0.166667,0.043617,0,0,0,0
14176,,,_kjmsupremacist,0,1,1,0,1,1,0,0,1,1,1,0
14177,,,dpryuru,0,1,1,0,1,1,0,0,1,1,1,0
14178,,,chim_calicocat,0,1,1,0,1,1,0,0,1,1,1,0
14179,,,nazmulmarketer1,14,1,15,17,1,18,0.071429,0.09362,0,0,0,0
14180,,,beomkaizt,0,1,1,0,1,1,0,0,1,1,1,0
14181,,,Jjktaegukk,0,1,1,0,1,1,0,0,1,1,1,0
14182,,,EmmaBallerinaa,0,1,1,0,1,1,0,0,1,1,1,0
14183,,,chuuslip,0,1,1,0,1,1,0,0,1,1,1,0
14184,,,fruity_fan,0,1,1,0,1,1,0,0,1,1,1,0
14185,,,archiveyoonie,0,1,1,0,1,1,0,0,1,1,1,0
14186,,,clandersen,0,1,1,0,1,1,0,0,1,1,1,0
14187,,,KINGJULIENST0ES,0,1,1,0,2,2,0,0,1,1,1,0
14188,,,serabee808,0,1,1,0,1,1,0,0,1,1,1,0
14189,,,krakesama,5,1,6,5,1,6,0.2,0.033436,0,0,0,0
14190,,,aayXX8812,0,1,1,0,1,1,0,0,1,1,1,0
14191,,,bloompow_,0,1,1,0,1,1,0,0,1,1,1,0
14192,,,joonietae7,0,1,1,0,1,1,0,0,1,1,1,0
14193,,,sdurso5,0,1,1,0,1,1,0,0,1,1,1,0
14194,,,marcosarellano,3,1,4,3,1,4,0.333333,0.020061,0,0,0,0
14195,,,agustmehhh,0,1,1,0,1,1,0,0,1,1,1,0
14196,,,chaenoze,0,1,1,0,1,1,0,0,1,1,1,0
14197,,,Bosefina,9,1,10,9,1,10,0.111111,0.063679,0,0,0,0
14198,,,LamboGold,0,1,1,0,1,1,0,0,1,1,1,0
14199,,,Dianna222,0,1,1,0,1,1,0,0,1,1,1,0
14200,,,TheJediAshCash,0,1,1,0,1,1,0,0,1,1,1,0
14201,,,auscoups,0,1,1,0,1,1,0,0,1,1,1,0
14202,,,taemingmyass,0,1,1,0,1,1,0,0,1,1,1,0
14203,,,glittermess,0,1,1,0,1,1,0,0,1,1,1,0
14204,,,Hanferd1,6,1,7,6,1,7,0.166667,0.040123,0,0,0,0
14205,,,ckemp3,0,1,1,0,1,1,0,0,1,1,1,0
14206,,,d0506007army,0,1,1,0,1,1,0,0,1,1,1,0
14207,,,sammmbaty,0,1,1,0,1,1,0,0,1,1,1,0
14208,,,chainofmelody,0,1,1,0,1,1,0,0,1,1,1,0
14209,,,binniefrost,0,1,1,0,1,1,0,0,1,1,1,0
14210,,,ATSUSHIIST,4,1,5,4,1,5,0.25,0.026749,0,0,0,0
14211,,,Mlha5GneTIgKJ8H,0,2,2,0,2,2,0,0,1,1,1,0
14212,,,Joni_Looking,0,1,1,0,1,1,0,0,1,1,1,0
14213,,,naevisdrive,0,1,1,0,1,1,0,0,1,1,1,0
14214,,,ZHANXlAO,5,1,6,5,1,6,0.2,0.033436,0,0,0,0
14215,,,childemyochii,0,1,1,0,1,1,0,0,1,1,1,0
14216,,,Softkenmaa,0,1,1,0,1,1,0,0,1,1,1,0
14217,,,haruuuuuuu20,0,1,1,0,1,1,0,0,1,1,1,0
14218,,,taejunniegf,0,1,1,0,1,1,0,0,1,1,1,0
14219,,,eunwoospockets,4,1,5,4,1,5,0.25,0.054702,0,0,0,0
14220,,,taelfriend,1,1,2,1,1,2,0,0.006687,0,0,0,0
14221,,,frshwaterotter,3,2,5,3,2,5,0.25,0.020061,1,1,1,2
14222,,,smolitto,0,1,1,0,1,1,0,0,2,0.666667,0.75,0
14223,,,eltongianni,4,1,5,4,1,5,0.25,0.051755,0,0,0,0
14224,,,JiminsSideBitcg,0,1,1,0,1,1,0,0,1,1,1,0
14225,,,zappnap,1,1,2,1,1,2,0,0.006687,0,0,0,0
14226,,,Andy_Beebe,4,1,5,4,1,5,0.25,0.026749,0,0,0,0
14227,,,taehyunluvr02,0,1,1,0,1,1,0,0,1,1,1,0
14228,,,h0lyseok,0,1,1,0,1,1,0,0,1,1,1,0
14229,,,kimmmaaaaa,22,1,23,23,1,24,0.045455,0.178565,0,0,0,0
14230,,,goldenmikaeIa,0,1,1,0,1,1,0,0,1,1,1,0
14231,,,ur_all_sick,0,1,1,0,1,1,0,0,1,1,1,0
14232,,,LittleRJ6,0,1,1,0,1,1,0,0,1,1,1,0
14233,,,qhMyzWvDj5TtLfY,0,1,1,0,1,1,0,0,1,1,1,0
14234,,,NavyDeQualite,0,1,1,0,1,1,0,0,1,1,1,0
14235,,,Musical_Otter,0,1,1,0,1,1,0,0,1,1,1,0
14236,,,Xenophon9,0,1,1,0,1,1,0,0,1,1,1,0
14237,,,tonjapowell,0,1,1,0,1,1,0,0,1,1,1,0
14238,,,bekind_please,0,1,1,0,1,1,0,0,1,1,1,0
14239,,,WittyHendrix,0,1,1,0,1,1,0,0,1,1,1,0
14240,,,SarahReed06,0,3,3,0,3,3,0,0,1,1,1,0
14241,,,nowisthetimedsw,0,1,1,0,1,1,0,0,1,1,1,0
14242,,,medallegheny1,0,1,1,0,1,1,0,0,1,1,1,0
14243,,,promiseaxc,0,1,1,0,1,1,0,0,1,1,1,0
14244,,,cecyrocconi,13,1,14,13,1,14,0.076923,0.086933,0,0,0,0
14245,,,azarassey,0,1,1,0,1,1,0,0,1,1,1,0
14246,,,em_pelant,0,1,1,0,1,1,0,0,1,1,1,0
14247,,,murcocks,0,1,1,0,1,1,0,0,1,1,1,0
14248,,,shotoukeki,0,2,2,0,2,2,0,0,1,1,1,0
14249,,,racha_lea,0,1,1,0,1,1,0,0,1,1,1,0
14250,,,adyfaye_,0,1,1,0,1,1,0,0,1,1,1,0
14251,,,FkhmJp,0,2,2,0,2,2,0,0,1,1,1,0
14252,,,JoeMSimEducator,0,1,1,0,1,1,0,0,1,1,1,0
14253,,,mengimben,0,1,1,0,1,1,0,0,1,1,1,0
14254,,,LouisaCornell,5,1,6,5,1,6,0.2,0.033436,0,0,0,0
14255,,,korozs2,0,1,1,0,1,1,0,0,1,1,1,0
14256,,,MidtermsPlease,0,1,1,0,1,1,0,0,1,1,1,0
14257,,,lazypasty,2,1,3,2,1,3,0.5,0.013374,0,0,0,0
14258,,,dilucfly,0,1,1,0,1,1,0,0,1,1,1,0
14259,,,Gmasterg4,2,1,3,2,1,3,0.5,0.013374,0,0,0,0
14260,,,BalladeNo1_Op23,0,1,1,0,1,1,0,0,1,1,1,0
14261,,,Jacobskatee,9,1,10,9,1,10,0.111111,0.067173,0,0,0,0
14262,,,usergolcha,0,1,1,0,1,1,0,0,1,1,1,0
14263,,,zoazoaly,0,1,1,0,1,1,0,0,1,1,1,0
14264,,,Kat4Obama,0,1,1,0,1,1,0,0,1,1,1,0
14265,,,yugenstation,0,1,1,0,1,1,0,0,1,1,1,0
14266,,,Jeremiah092,0,1,1,0,1,1,0,0,1,1,1,0
14267,,,SuzanneLieb4,0,1,1,0,1,1,0,0,1,1,1,0
14268,,,Rachel_Sunset,12,1,13,12,1,13,0.083333,0.097717,0,0,0,0
14269,,,andyrasda_78,0,1,1,0,1,1,0,0,1,1,1,0
14270,,,atinychaeng,0,1,1,0,1,1,0,0,1,1,1,0
14271,,,see_tea_kay,0,1,1,0,1,1,0,0,1,1,1,0
14272,,,moonlightsky_,0,1,1,0,1,1,0,0,1,1,1,0
14273,,,MEIHA0SUN,0,2,2,0,2,2,0,0,1,1,1,0
14274,,,bokutochan,0,1,1,0,1,1,0,0,1,1,1,0
14275,,,naganosilver98,0,2,2,0,2,2,0,0,1,1,1,0
14276,,,mommajessiec,0,1,1,0,1,1,0,0,1,1,1,0
14277,,,ShannonBP2020,0,1,1,0,1,1,0,0,1,1,1,0
14278,,,ActuallyDSW,7,1,8,7,1,8,0.142857,0.04681,0,0,0,0
14279,,,skeluko,0,1,1,0,1,1,0,0,1,1,1,0
14280,,,Ladybug81063923,0,2,2,0,2,2,0,0,1,1,1,0
14281,,,pjmlover13,0,1,1,0,1,1,0,0,1,1,1,0
14282,,,meri443,0,1,1,0,1,1,0,0,1,1,1,0
14283,,,nobleglaze,0,1,1,0,1,1,0,0,1,1,1,0
14284,,,alondra_1712,0,1,1,0,1,1,0,0,2,0.666667,0.75,0
14285,,,ilyseungwoo,12,1,13,12,1,13,0.083333,0.080246,0,0,0,0
14286,,,dnewbern01,0,3,3,0,3,3,0,0,1,1,1,0
14287,,,Sh0ut02,0,1,1,0,1,1,0,0,1,1,1,0
14288,,,MNO10925,0,1,1,0,1,1,0,0,1,1,1,0
14289,,,quite_delight,0,1,1,0,1,1,0,0,1,1,1,0
14290,,,bluethorn2018,0,1,1,0,1,1,0,0,1,1,1,0
14291,,,hz_udhr,6,1,7,6,1,7,0.166667,0.040123,0,0,0,0
14292,,,gabyvousaime,0,1,1,0,1,1,0,0,1,1,1,0
14293,,,kashiragi0710,0,1,1,0,1,1,0,0,1,1,1,0
14294,,,karouworld,0,1,1,0,1,1,0,0,1,1,1,0
14295,,,ubudoc,0,2,2,0,2,2,0,0,1,1,1,0
14296,,,MOORAKAMl,0,1,1,0,1,1,0,0,1,1,1,0
14297,,,StarlightxYuna,0,1,1,0,1,1,0,0,1,1,1,0
14298,,,DetectiveGomez,0,1,1,0,1,1,0,0,1,1,1,0
14299,,,backsideisadeep,0,1,1,0,1,1,0,0,1,1,1,0
14300,,,hari_raang,0,1,1,0,1,1,0,0,1,1,1,0
14301,,,Mardigroan,4,1,5,4,1,5,0.25,0.026749,0,0,0,0
14302,,,ktrez17_2,0,3,3,0,3,3,0,0,1,1,1,0
14303,,,Yoongi_Thighs,0,2,2,0,2,2,0,0,1,1,1,0
14304,,,awesomea1ecis,3,1,4,3,1,4,0.333333,0.020061,0,0,0,0
14305,,,ceg001,0,1,1,0,1,1,0,0,1,1,1,0
14306,,,panfanabbeh,0,1,1,0,1,1,0,0,1,1,1,0
14307,,,richie_bressler,5,1,6,5,1,6,0.2,0.074975,0,0,0,0
14308,,,jr_09_,0,1,1,0,1,1,0,0,1,1,1,0
14309,,,gxsjsy,0,1,1,0,1,1,0,0,1,1,1,0
14310,,,aboutNathanwvid,6,1,7,7,2,9,0.166667,0.048918,0,0,0,0
14311,,,MsJR88,0,1,1,0,1,1,0,0,1,1,1,0
14312,,,_realbigmack,0,1,1,0,1,1,0,0,1,1,1,0
14313,,,boguskazofia,8,1,9,8,1,9,0.125,0.053497,0,0,0,0
14314,,,Katbeloo,0,1,1,0,1,1,0,0,1,1,1,0
14315,,,mofustrofus,0,1,1,0,1,1,0,0,1,1,1,0
14316,,,sopesaur,0,1,1,0,1,1,0,0,1,1,1,0
14317,,,MoSquitoXS,0,1,1,0,1,1,0,0,1,1,1,0
14318,,,cutebluebinnies,8,1,9,9,2,11,0.125,0.101002,0,0,0,0
14319,,,epiinoya,0,1,1,0,1,1,0,0,1,1,1,0
14320,,,simoncee,0,1,1,0,1,1,0,0,1,1,1,0
14321,,,christineniSF,3,1,4,3,1,4,0.333333,0.020061,0,0,0,0
14322,,,sonokocentral,0,1,1,0,1,1,0,0,1,1,1,0
14323,,,microbialmess,21,1,22,21,1,22,0.047619,0.237877,0,0,0,0
14324,,,SkatingLesson,0,1,1,0,1,1,0,0,1,1,1,0
14325,,,nightsky098,0,1,1,0,1,1,0,0,1,1,1,0
14326,,,ashomastanlol,0,1,1,0,1,1,0,0,1,1,1,0
14327,,,nittanyrich,0,1,1,0,1,1,0,0,1,1,1,0
14328,,,hellscrime,0,1,1,0,1,1,0,0,1,1,1,0
14329,,,syhdhssli,0,1,1,0,1,1,0,0,1,1,1,0
14330,,,SGtae_studio,0,1,1,0,1,1,0,0,1,1,1,0
14331,,,swagwatermelonn,0,1,1,0,1,1,0,0,1,1,1,0
14332,,,kookvmze,0,1,1,0,1,1,0,0,1,1,1,0
14333,,,702sundevil,0,1,1,0,1,1,0,0,1,1,1,0
14334,,,Bummies2005,0,1,1,0,1,1,0,0,1,1,1,0
14335,,,joyrevels28,0,1,1,0,1,1,0,0,1,1,1,0
14336,,,ToxicTokyo3,0,1,1,0,1,1,0,0,1,1,1,0
14337,,,anneparkehome,0,1,1,0,1,1,0,0,1,1,1,0
14338,,,jaywill73097884,0,1,1,0,1,1,0,0,1,1,1,0
14339,,,1Lavishone,0,1,1,0,1,1,0,0,2,0.666667,0.75,0
14340,,,breadjoonie,0,1,1,0,1,1,0,0,2,0.666667,0.75,0
14341,,,Angela56396604,0,1,1,0,1,1,0,0,2,0.666667,0.75,0
14342,,,yyokiki,0,1,1,0,1,1,0,0,2,0.666667,0.75,0
14343,,,softforjunhwan,5,1,6,5,1,6,0.2,0.033436,0,0,0,0
14344,,,kj_hardesty,0,1,1,0,1,1,0,0,1,1,1,0
14345,,,Varun9Vijay,0,1,1,0,1,1,0,0,1,1,1,0
14346,,,isabellaxlayne,0,2,2,0,2,2,0,0,1,1,1,0
14347,,,inkigayso,0,1,1,0,1,1,0,0,1,1,1,0
14348,,,yuk1shiro,0,1,1,0,1,1,0,0,1,1,1,0
14349,,,GLucivero,3,1,4,3,1,4,0.333333,0.020061,0,0,0,0
14350,,,fadwinwin,6,1,7,6,1,7,0.166667,0.040123,0,0,0,0
14351,,,Ak1uSapisuK,0,1,1,0,1,1,0,0,1,1,1,0
14352,,,lunarhrj,0,1,1,0,1,1,0,0,1,1,1,0
14353,,,BTSFlyToMyRoom,0,1,1,0,1,1,0,0,1,1,1,0
14354,,,mprebo,3,1,4,3,1,4,0.333333,0.020061,0,0,0,0
14355,,,radicalxrad,3,1,4,3,1,4,0.333333,0.020061,0,0,0,0
14356,,,yerimmiehh,0,1,1,0,1,1,0,0,1,1,1,0
14357,,,soodandansoo,0,1,1,0,1,1,0,0,1,1,1,0
14358,,,tomoonshot,4,1,5,5,1,6,0.25,0.026749,0,0,0,0
14359,,,tattsunss,0,1,1,0,2,2,0,0,1,1,1,0
14360,,,babejeonkook,0,1,1,0,1,1,0,0,1,1,1,0
14361,,,nqlhdm,0,1,1,0,1,1,0,0,1,1,1,0
14362,,,dannyboi866,4,1,5,4,1,5,0.25,0.040725,0,0,0,0
14363,,,Kiker16R,0,1,1,0,1,1,0,0,1,1,1,0
14364,,,sunbxna,5,1,6,5,1,6,0.2,0.033436,0,0,0,0
14365,,,shinyoshii,0,1,1,0,1,1,0,0,1,1,1,0
14366,,,WatcherInWater,0,1,1,0,1,1,0,0,1,1,1,0
14367,,,myhlee,0,1,1,0,1,1,0,0,1,1,1,0
14368,,,gimternet,11,1,12,11,1,12,0.090909,0.096825,0,0,0,0
14369,,,oofderliana,0,1,1,0,1,1,0,0,1,1,1,0
14370,,,figureskatoma,0,1,1,0,1,1,0,0,1,1,1,0
14371,,,Hoshi_moonshine,0,1,1,0,1,1,0,0,1,1,1,0
14372,,,beamsna,0,1,1,0,1,1,0,0,1,1,1,0
14373,,,FruityAlia,0,2,2,0,2,2,0,0,1,1,1,0
14374,,,iTAEUNHWI,0,1,1,0,1,1,0,0,1,1,1,0
14375,,,JSJdarling,9,1,10,9,1,10,0.111111,0.060184,0,0,0,0
14376,,,wonhyuking,0,1,1,0,1,1,0,0,1,1,1,0
14377,,,wingrls,0,2,2,0,2,2,0,0,1,1,1,0
14378,,,ayirpelle,0,1,1,0,1,1,0,0,1,1,1,0
14379,,,blossom___os,0,1,1,0,1,1,0,0,1,1,1,0
14380,,,yejunfarts,0,1,1,0,1,1,0,0,1,1,1,0
14381,,,postapop,0,1,1,0,1,1,0,0,1,1,1,0
14382,,,shestoyork,0,1,1,0,1,1,0,0,1,1,1,0
14383,,,Aaronwuf,16,1,17,17,2,19,0.0625,0.106994,0,0,0,0
14384,,,obitosgoggles,0,1,1,0,1,1,0,0,1,1,1,0
14385,,,Rx2Wfalcon,0,1,1,0,1,1,0,0,1,1,1,0
14386,,,MonaLis71231447,0,1,1,0,1,1,0,0,1,1,1,0
14387,,,LUNECERISE,0,2,2,0,2,2,0,0,1,1,1,0
14388,,,AzucenaKyung,0,1,1,0,1,1,0,0,1,1,1,0
14389,,,uarebreathtakin,0,1,1,0,1,1,0,0,1,1,1,0
14390,,,ctrlshiftae,0,1,1,0,1,1,0,0,1,1,1,0
14391,,,Min13Be,0,1,1,0,1,1,0,0,1,1,1,0
14392,,,nhgrown,0,1,1,0,1,1,0,0,1,1,1,0
14393,,,forwooandyo,0,1,1,0,1,1,0,0,1,1,1,0
14394,,,tkmryk,0,1,1,0,1,1,0,0,1,1,1,0
14395,,,IngrydMndz,0,1,1,0,1,1,0,0,1,1,1,0
14396,,,TokinForever,0,1,1,0,1,1,0,0,1,1,1,0
14397,,,EvRoundTable,20,1,21,20,1,21,0.05,0.137237,0,0,0,0
14398,,,AstridC38396273,0,1,1,0,1,1,0,0,1,1,1,0
14399,,,rangerstrash,0,1,1,0,1,1,0,0,1,1,1,0
14400,,,EqualityWorld,0,1,1,0,1,1,0,0,1,1,1,0
14401,,,KyuMinSmut,0,1,1,0,1,1,0,0,1,1,1,0
14402,,,Fried49G,0,1,1,0,1,1,0,0,1,1,1,0
14403,,,RAKlotsky,0,1,1,0,1,1,0,0,1,1,1,0
14404,,,akatsukisosa,0,1,1,0,1,1,0,0,1,1,1,0
14405,,,shiroyoshikuro,0,1,1,0,1,1,0,0,1,1,1,0
14406,,,Taigiquan,0,1,1,0,1,1,0,0,1,1,1,0
14407,,,rockleefucker,0,2,2,0,2,2,0,0,1,1,1,0
14408,,,vixisan,0,1,1,0,1,1,0,0,1,1,1,0
14409,,,xunguangyue1,0,1,1,0,1,1,0,0,1,1,1,0
14410,,,_Till7,0,1,1,0,1,1,0,0,1,1,1,0
14411,,,abarooski,0,2,2,0,2,2,0,0,1,1,1,0
14412,,,jellodejjk,0,1,1,0,1,1,0,0,1,1,1,0
14413,,,MalidarUthai,0,1,1,0,1,1,0,0,1,1,1,0
14414,,,Austin55713770,0,1,1,0,1,1,0,0,1,1,1,0
14415,,,ndntshmyg,0,1,1,0,1,1,0,0,1,1,1,0
14416,,,GaryJon58745857,0,1,1,0,1,1,0,0,1,1,1,0
14417,,,mazethesoul,0,1,1,0,1,1,0,0,1,1,1,0
14418,,,hi_butter_fly,0,1,1,0,1,1,0,0,1,1,1,0
14419,,,rikusoraumi5,0,1,1,0,1,1,0,0,1,1,1,0
14420,,,tayguksus,0,2,2,0,2,2,0,0,1,1,1,0
14421,,,jeonwthu,0,1,1,0,1,1,0,0,1,1,1,0
14422,,,kattrina_m,0,1,1,0,1,1,0,0,1,1,1,0
14423,,,ushuz_,0,1,1,0,1,1,0,0,1,1,1,0
14424,,,Collinleef,0,1,1,0,1,1,0,0,1,1,1,0
14425,,,Artemishazel7,0,1,1,0,1,1,0,0,1,1,1,0
14426,,,preciouseokjinn,0,1,1,0,1,1,0,0,1,1,1,0
14427,,,patstagepage,0,1,1,0,1,1,0,0,1,1,1,0
14428,,,alluwra,4,1,5,4,1,5,0,0.01584,1,1,1,4
14429,,,glitterwoos,0,1,1,0,1,1,0,0,1,1,1,0
14430,,,takami_sahi,0,1,1,0,1,1,0,0,1,1,1,0
14431,,,dchanlaw,1,1,2,1,1,2,0,0.006687,0,0,0,0
14432,,,how2Bawesome,23,1,24,23,1,24,0.043478,0.157299,0,0,0,0
14433,,,Celiafer77,0,1,1,0,1,1,0,0,1,1,1,0
14434,,,ug_ugi1314,0,1,1,0,1,1,0,0,1,1,1,0
14435,,,_eleot_,0,1,1,0,1,1,0,0,1,1,1,0
14436,,,aaamanda,1,3,4,1,3,4,0.333333,0.006687,2,0.75,0.833333,0
14437,,,moorigold,0,1,1,0,1,1,0,0,1,1,1,0
14438,,,YoongiLeftPinky,0,1,1,0,1,1,0,0,1,1,1,0
14439,,,conbinikaraage,0,1,1,0,1,1,0,0,1,1,1,0
14440,,,syle139,0,1,1,0,1,1,0,0,1,1,1,0
14441,,,ladaxknw,0,1,1,0,1,1,0,0,1,1,1,0
14442,,,SELMAMARIADESO9,0,1,1,0,1,1,0,0,1,1,1,0
14443,,,choco_iceYM,0,1,1,0,1,1,0,0,1,1,1,0
14444,,,paulhunsinger69,0,1,1,0,1,1,0,0,1,1,1,0
14445,,,damlaymben,0,1,1,0,1,1,0,0,1,1,1,0
14446,,,atsuthighs,0,1,1,0,1,1,0,0,1,1,1,0
14447,,,QueenCeleste888,0,1,1,0,1,1,0,0,1,1,1,0
14448,,,leeaaoong,0,1,1,0,1,1,0,0,1,1,1,0
14449,,,jungkooprint,2,1,3,2,1,3,0.5,0.013374,0,0,0,0
14450,,,TokyoSanctuary,0,1,1,0,1,1,0,0,1,1,1,0
14451,,,dilfcnu,6,2,8,6,2,8,0.142857,0.043617,1,1,1,5
14452,,,BoystownTweets,0,1,1,0,1,1,0,0,2,0.666667,0.75,0
14453,,,iJuyeonHello,0,1,1,0,1,1,0,0,2,0.666667,0.75,0
14454,,,Elizabeth_Whyte,0,1,1,0,1,1,0,0,1,1,1,0
14455,,,MurreyJacobson,2,1,3,2,1,3,0.5,0.013374,0,0,0,0
14456,,,lianbunbun,0,1,1,0,1,1,0,0,1,1,1,0
14457,,,RollingStone,1,1,2,1,1,2,0,0.006687,0,0,0,0
14458,,,whoskevinla,3,1,4,3,1,4,0.333333,0.04193,0,0,0,0
14459,,,Nathy2895,0,1,1,0,1,1,0,0,1,1,1,0
14460,,,the_milky_white,6,1,7,7,1,8,0.166667,0.040123,0,0,0,0
14461,,,sunsethues_,0,1,1,0,1,1,0,0,1,1,1,0
14462,,,Rachmahnah,0,2,2,0,2,2,0,0,1,1,1,0
14463,,,iam_seanbond,0,1,1,0,2,2,0,0,1,1,1,0
14464,,,thepigprint,6,1,7,6,1,7,0.166667,0.040123,0,0,0,0
14465,,,Cubanitoray2005,0,1,1,0,1,1,0,0,1,1,1,0
14466,,,3Ababe,0,1,1,0,1,1,0,0,1,1,1,0
14467,,,seokjinniescute,0,1,1,0,1,1,0,0,1,1,1,0
14468,,,pudwon,1,1,2,1,1,2,0,0.006687,0,0,0,0
14469,,,cuntwayv,6,1,7,6,1,7,0.166667,0.040123,0,0,0,0
14470,,,vvielien,0,1,1,0,1,1,0,0,1,1,1,0
14471,,,omgplay13,0,1,1,0,1,1,0,0,1,1,1,0
14472,,,spideyjkk,0,2,2,0,2,2,0,0,1,1,1,0
14473,,,3ningz,0,1,1,0,1,1,0,0,2,0.666667,0.75,0
14474,,,mayumi18fsbb,0,1,1,0,1,1,0,0,2,0.666667,0.75,0
14475,,,mandarin0808,0,1,1,0,1,1,0,0,2,0.666667,0.75,0
14476,,,minnnieyoongles,0,1,1,0,1,1,0,0,1,1,1,0
14477,,,fucksyoon,6,1,7,6,1,7,0,0.02376,1,1,1,6
14478,,,MissMiaMina,3,1,4,3,1,4,0.333333,0.020061,0,0,0,0
14479,,,aquilineburns,0,1,1,0,1,1,0,0,1,1,1,0
14480,,,ClaudiaMayPhD,3,1,4,3,1,4,0.333333,0.020061,0,0,0,0
14481,,,HillaryVilleno,0,1,1,0,1,1,0,0,1,1,1,0
14482,,,miyoko_suzuki,0,1,1,0,1,1,0,0,1,1,1,0
14483,,,dove_xxxx,0,1,1,0,1,1,0,0,1,1,1,0
14484,,,CeeEyes,0,1,1,0,1,1,0,0,1,1,1,0
14485,,,CindisPLace,0,1,1,0,1,1,0,0,1,1,1,0
14486,,,peachuufilter,0,1,1,0,1,1,0,0,1,1,1,0
14487,,,knikuzushitxt,0,1,1,0,1,1,0,0,1,1,1,0
14488,,,maxwelllyons,0,1,1,0,1,1,0,0,1,1,1,0
14489,,,LucyC_inNC,0,1,1,0,1,1,0,0,1,1,1,0
14490,,,WandaValverde,2,1,3,2,1,3,0.5,0.013374,0,0,0,0
14491,,,sheep741108,0,1,1,0,1,1,0,0,1,1,1,0
14492,,,pikavik,2,1,3,2,1,3,0.5,0.013374,0,0,0,0
14493,,,yunyurus,0,1,1,0,1,1,0,0,1,1,1,0
14494,,,lodzoppolon,0,1,1,0,1,1,0,0,1,1,1,0
14495,,,nerdandlace,0,1,1,0,1,1,0,0,1,1,1,0
14496,,,DocHPJones,3,1,4,3,1,4,0.333333,0.020061,0,0,0,0
14497,,,Mitam00523319,0,1,1,0,1,1,0,0,1,1,1,0
14498,,,yuzupie1207,0,1,1,0,1,1,0,0,1,1,1,0
14499,,,jillchristy,8,1,9,8,1,9,0.125,0.053497,0,0,0,0
14500,,,piscis_pieri,0,1,1,0,1,1,0,0,1,1,1,0
14501,,,azag0th,0,1,1,0,1,1,0,0,1,1,1,0
14502,,,yeonntteokgu,0,1,1,0,1,1,0,0,1,1,1,0
14503,,,xiaotai71489309,0,1,1,0,1,1,0,0,1,1,1,0
14504,,,meleggen,0,1,1,0,1,1,0,0,1,1,1,0
14505,,,nuoyitaro,17,1,18,18,2,20,0.058824,0.133113,0,0,0,0
14506,,,koosdiminie,0,2,2,0,2,2,0,0,1,1,1,0
14507,,,jungwoncin,0,1,1,0,1,1,0,0,1,1,1,0
14508,,,DubiHobi,0,4,4,0,4,4,0,0,2,0.833333,0.9,0
14509,,,doddsie161,0,1,1,0,1,1,0,0,1,1,1,0
14510,,,ANGELAAAANG,0,1,1,0,1,1,0,0,1,1,1,0
14511,,,blanceee04,0,1,1,0,1,1,0,0,1,1,1,0
14512,,,Ohse_vanilasky,0,1,1,0,1,1,0,0,1,1,1,0
14513,,,myoongyuji,0,1,1,0,1,1,0,0,1,1,1,0
14514,,,moonibbi,0,1,1,0,1,1,0,0,2,0.666667,0.75,0
14515,,,heracrosat78,0,1,1,0,1,1,0,0,2,0.666667,0.75,0
14516,,,actualhamlet,4,1,5,4,1,5,0.25,0.026749,0,0,0,0
14517,,,dms_249,0,1,1,0,1,1,0,0,1,1,1,0
14518,,,rkivetwt,0,1,1,0,1,1,0,0,1,1,1,0
14519,,,Angely10021,0,1,1,0,1,1,0,0,1,1,1,0
14520,,,spiccollihm,0,1,1,0,1,1,0,0,1,1,1,0
14521,,,Disney_Sam728,11,1,12,11,1,12,0.090909,0.073559,0,0,0,0
14522,,,BlueGoldFlower1,0,1,1,0,1,1,0,0,1,1,1,0
14523,,,sashaterry50,0,1,1,0,1,1,0,0,1,1,1,0
14524,,,Codstergirl,0,1,1,0,1,1,0,0,1,1,1,0
14525,,,marometa97,0,1,1,0,1,1,0,0,1,1,1,0
14526,,,monojoonses,0,1,1,0,1,1,0,0,1,1,1,0
14527,,,exhoefanboi,0,1,1,0,1,1,0,0,1,1,1,0
14528,,,sFKUZec0WNgk2iq,0,1,1,0,1,1,0,0,1,1,1,0
14529,,,Delhi_Yogi,0,2,2,0,2,2,0,0,1,1,1,0
14530,,,kolyadasm,0,1,1,0,1,1,0,0,1,1,1,0
14531,,,rcmaniac25,0,1,1,0,1,1,0,0,1,1,1,0
14532,,,2lauree2anne,6,1,7,7,2,9,0.166667,0.047111,0,0,0,0
14533,,,butter_yuzu,0,1,1,0,1,1,0,0,1,1,1,0
14534,,,melide7,10,1,11,10,1,11,0.1,0.066871,0,0,0,0
14535,,,mizelse,0,1,1,0,1,1,0,0,1,1,1,0
14536,,,RReika1,0,1,1,0,1,1,0,0,1,1,1,0
14537,,,Cuhlexah,0,1,1,0,1,1,0,0,1,1,1,0
14538,,,toranitas,0,1,1,0,1,1,0,0,1,1,1,0
14539,,,miraesbts,0,1,1,0,1,1,0,0,1,1,1,0
14540,,,whynotloona_,0,1,1,0,1,1,0,0,1,1,1,0
14541,,,21scy,0,1,1,0,1,1,0,0,1,1,1,0
14542,,,mai4101,0,1,1,0,1,1,0,0,1,1,1,0
14543,,,seansramblings,6,1,7,6,1,7,0.166667,0.040123,0,0,0,0
14544,,,KeyTheBunny,0,1,1,0,1,1,0,0,1,1,1,0
14545,,,bt21svan,0,1,1,0,1,1,0,0,1,1,1,0
14546,,,akusbsf,0,1,1,0,1,1,0,0,1,1,1,0
14547,,,MeAndMyDogToo,4,1,5,4,1,5,0.25,0.026749,0,0,0,0
14548,,,xX_emoaznboi_Xx,0,3,3,0,3,3,0,0,2,0.636364,0.714286,0
14549,,,marla_vous,0,1,1,0,1,1,0,0,1,1,1,0
14550,,,lydiakye,0,1,1,0,1,1,0,0,1,1,1,0
14551,,,oronhienha,1,1,2,1,1,2,0,0.006687,0,0,0,0
14552,,,goyysgf,0,1,1,0,1,1,0,0,2,0.555556,0.6,0
14553,,,heels_R_better,0,1,1,0,1,1,0,0,2,0.555556,0.6,0
14554,,,originofspring,0,1,1,0,1,1,0,0,2,0.555556,0.6,0
14555,,,linaaluvly,0,1,1,0,1,1,0,0,2,0.555556,0.6,0
14556,,,Willers_Tom,0,1,1,0,1,1,0,0,2,0.555556,0.6,0
14557,,,dilftaepie,0,1,1,0,1,1,0,0,2,0.555556,0.6,0
14558,,,ElaineRomero,4,1,5,4,1,5,0.25,0.026749,0,0,0,0
14559,,,kuriume1,0,2,2,0,2,2,0,0,1,1,1,0
14560,,,hollers_l,0,1,1,0,1,1,0,0,1,1,1,0
14561,,,ya0133352,0,1,1,0,1,1,0,0,1,1,1,0
14562,,,I_Am_Kate_Bent,1,1,2,1,1,2,0,0.006687,0,0,0,0
14563,,,Eggburial,0,1,1,0,1,1,0,0,1,1,1,0
14564,,,clangunlanbun,0,1,1,0,1,1,0,0,1,1,1,0
14565,,,melturciosf,0,1,1,0,1,1,0,0,1,1,1,0
14566,,,imanthonytran,0,1,1,0,1,1,0,0,1,1,1,0
14567,,,teolaegii,0,1,1,0,1,1,0,0,1,1,1,0
14568,,,wxntermoon,2,1,3,2,1,3,0.5,0.013374,0,0,0,0
14569,,,Iuv_uu,0,1,1,0,1,1,0,0,1,1,1,0
14570,,,rrukoo_,11,1,12,11,1,12,0.090909,0.077053,0,0,0,0
14571,,,Vyrite_,0,1,1,0,1,1,0,0,1,1,1,0
14572,,,hi_ko_yuzu,0,1,1,0,1,1,0,0,1,1,1,0
14573,,,MAOistheQueen,0,1,1,0,1,1,0,0,1,1,1,0
14574,,,pot0fgold,0,1,1,0,1,1,0,0,1,1,1,0
14575,,,Rsi913zmABVmK24,0,1,1,0,1,1,0,0,1,1,1,0
14576,,,philly171109,0,1,1,0,1,1,0,0,1,1,1,0
14577,,,FS_KissandCry,1,1,2,1,1,2,0,0.006687,0,0,0,0
14578,,,astrochic73,3,1,4,3,1,4,0.333333,0.020061,0,0,0,0
14579,,,fl8391070lopez,0,1,1,0,1,1,0,0,1,1,1,0
14580,,,taeilstummy,0,1,1,0,1,1,0,0,1,1,1,0
14581,,,Yoriko_may,0,1,1,0,1,1,0,0,1,1,1,0
14582,,,mahlerkarenina,0,1,1,0,1,1,0,0,1,1,1,0
14583,,,atsunoir,0,1,1,0,1,1,0,0,1,1,1,0
14584,,,KaliHecate,1,1,2,1,1,2,0,0.006687,0,0,0,0
14585,,,feitansbingbong,0,2,2,0,3,3,0,0,1,1,1,0
14586,,,jiunguniverse,0,1,1,0,1,1,0,0,1,1,1,0
14587,,,Tsukiboshii,0,1,1,0,1,1,0,0,1,1,1,0
14588,,,IMMABOS52901152,0,1,1,0,1,1,0,0,1,1,1,0
14589,,,mypresidenttknj,0,1,1,0,1,1,0,0,1,1,1,0
14590,,,risa_usami,0,1,1,0,1,1,0,0,1,1,1,0
14591,,,silaslej,6,1,7,6,1,7,0.166667,0.040123,0,0,0,0
14592,,,tobiovt,0,1,1,0,1,1,0,0,1,1,1,0
14593,,,kagewuki,0,1,1,0,1,1,0,0,1,1,1,0
14594,,,sheilamurphybos,0,1,1,0,1,1,0,0,1,1,1,0
14595,,,bohemiarmy,0,1,1,0,1,1,0,0,1,1,1,0
14596,,,mcp65202,0,1,1,0,1,1,0,0,1,1,1,0
14597,,,1014Want,1,1,2,1,1,2,0,0.006687,0,0,0,0
14598,,,Tichavakunda,12,1,13,12,1,13,0.083333,0.080246,0,0,0,0
14599,,,arumillia,0,1,1,0,1,1,0,0,1,1,1,0
14600,,,marcel_tracy,0,1,1,0,1,1,0,0,1,1,1,0
14601,,,planetborahae,0,1,1,0,1,1,0,0,1,1,1,0
14602,,,kiazun5,0,2,2,0,2,2,0,0,1,1,1,0
14603,,,MakominaBaby,0,1,1,0,1,1,0,0,1,1,1,0
14604,,,maofreak,0,1,1,0,1,1,0,0,1,1,1,0
14605,,,SubodhPokharel,0,1,1,0,1,1,0,0,1,1,1,0
14606,,,ttthw_,0,3,3,0,3,3,0,0,1,1,1,0
14607,,,garydobrien,1,1,2,1,1,2,0,0.006687,0,0,0,0
14608,,,RichardNguyenSJ,1,1,2,1,1,2,0,0.006687,0,0,0,0
14609,,,lisamariebasile,1,1,2,1,1,2,0,0.006687,0,0,0,0
14610,,,fmllolnews,0,1,1,0,1,1,0,0,1,1,1,0
14611,,,jasminetea51623,0,1,1,0,1,1,0,0,1,1,1,0
14612,,,bellyisnot15,0,1,1,0,1,1,0,0,1,1,1,0
14613,,,alittledewdrop,0,1,1,0,1,1,0,0,1,1,1,0
14614,,,itsdefinitelyy1,0,1,1,0,1,1,0,0,1,1,1,0
14615,,,nazuna_fujii,0,1,1,0,1,1,0,0,1,1,1,0
14616,,,streambtsdope,0,1,1,0,1,1,0,0,1,1,1,0
14617,,,yunshanganshan,0,1,1,0,1,1,0,0,1,1,1,0
14618,,,onheadphones,0,1,1,0,1,1,0,0,1,1,1,0
14619,,,misfitholic,0,1,1,0,1,1,0,0,1,1,1,0
14620,,,pamdwriter,0,1,1,0,1,1,0,0,1,1,1,0
14621,,,daddybg,0,1,1,0,1,1,0,0,1,1,1,0
14622,,,AllThingsBloom,3,1,4,3,1,4,0.333333,0.028243,0,0,0,0
14623,,,cjnapoet,8,1,9,8,1,9,0.125,0.053497,0,0,0,0
14624,,,azahrays,0,1,1,0,1,1,0,0,1,1,1,0
14625,,,YeKeyin,0,1,1,0,1,1,0,0,1,1,1,0
14626,,,Matt_Knaub,0,1,1,0,1,1,0,0,1,1,1,0
14627,,,chiharucatneko,0,1,1,0,1,1,0,0,1,1,1,0
14628,,,Sharon251019,0,1,1,0,1,1,0,0,1,1,1,0
14629,,,BrickWallJamieF,5,1,6,5,1,6,0.2,0.033436,0,0,0,0
14630,,,yenakult,0,1,1,0,1,1,0,0,1,1,1,0
14631,,,xunuoyi,0,1,1,0,1,1,0,0,1,1,1,0
14632,,,CinderScoria,0,1,1,0,1,1,0,0,1,1,1,0
14633,,,2chiemz,2,1,3,2,1,3,0.5,0.013374,0,0,0,0
14634,,,bulletandproof,0,1,1,0,1,1,0,0,1,1,1,0
14635,,,thegourmez,20,1,21,20,1,21,0.05,0.133743,0,0,0,0
14636,,,tragickoo,0,1,1,0,1,1,0,0,1,1,1,0
14637,,,yujateas,0,1,1,0,1,1,0,0,1,1,1,0
14638,,,heavenjiminnie,0,1,1,0,1,1,0,0,1,1,1,0
14639,,,joyciebuttons,0,1,1,0,1,1,0,0,1,1,1,0
14640,,,shinyyuzu,0,1,1,0,1,1,0,0,1,1,1,0
14641,,,abents23,0,1,1,0,1,1,0,0,1,1,1,0
14642,,,robloxgodbae,0,1,1,0,1,1,0,0,1,1,1,0
14643,,,lin_palomo,0,1,1,0,1,1,0,0,1,1,1,0
14644,,,6conniee9,0,1,1,0,1,1,0,0,1,1,1,0
14645,,,brockemily2,0,1,1,0,1,1,0,0,1,1,1,0
14646,,,kimbafed,0,1,1,0,1,1,0,0,1,1,1,0
14647,,,19luftballons,0,1,1,0,1,1,0,0,1,1,1,0
14648,,,TreesBooksCoffE,0,1,1,0,1,1,0,0,1,1,1,0
14649,,,ksnpcy,0,1,1,0,1,1,0,0,1,1,1,0
14650,,,bakusatsuuou,0,1,1,0,1,1,0,0,1,1,1,0
14651,,,MYFIRSTSTORY_TW,0,1,1,0,1,1,0,0,1,1,1,0
14652,,,bedazzletravels,0,1,1,0,1,1,0,0,1,1,1,0
14653,,,Doubleyou7788,3,1,4,3,1,4,0.333333,0.020061,0,0,0,0
14654,,,DEARGOOGI,0,1,1,0,1,1,0,0,1,1,1,0
14655,,,daetothebaek,0,1,1,0,1,1,0,0,1,1,1,0
14656,,,BenitaP57166585,1,1,2,1,1,2,0,0.006687,0,0,0,0
14657,,,Most_,0,1,1,0,1,1,0,0,1,1,1,0
14658,,,mbachand,7,1,8,7,1,8,0.142857,0.04681,0,0,0,0
14659,,,kryptobanana,0,1,1,0,1,1,0,0,1,1,1,0
14660,,,GraceOnEdges,0,1,1,0,1,1,0,0,1,1,1,0
14661,,,ribopyeong,0,1,1,0,1,1,0,0,1,1,1,0
14662,,,BlueCheese608,2,1,3,2,1,3,0.5,0.013374,0,0,0,0
14663,,,evancerclade,0,1,1,0,1,1,0,0,1,1,1,0
14664,,,BrokeGlowsticks,1,2,3,1,2,3,0.5,0.006687,1,1,1,0
14665,,,rgreenparadox,0,1,1,0,1,1,0,0,1,1,1,0
14666,,,KarianaVenti,0,1,1,0,1,1,0,0,1,1,1,0
14667,,,katrinka1975,0,1,1,0,1,1,0,0,1,1,1,0
14668,,,utsu_ho,0,1,1,0,1,1,0,0,1,1,1,0
14669,,,JosephMIV466,0,1,1,0,1,1,0,0,1,1,1,0
14670,,,_HurdleFloww,0,2,2,0,2,2,0,0,1,1,1,0
14671,,,GleefulViolin,0,1,1,0,1,1,0,0,1,1,1,0
14672,,,y9ongi,0,1,1,0,1,1,0,0,1,1,1,0
14673,,,GeraldFarinas,3,1,4,3,1,4,0.333333,0.020061,0,0,0,0
14674,,,Viciousfrijole,0,1,1,0,1,1,0,0,1,1,1,0
14675,,,aoneluvrr,12,1,13,12,1,13,0.083333,0.080246,0,0,0,0
14676,,,kaitlinmarks05,0,1,1,0,1,1,0,0,1,1,1,0
14677,,,loonalver,0,1,1,0,1,1,0,0,1,1,1,0
14678,,,HaleyMuhlbach,0,1,1,0,1,1,0,0,1,1,1,0
14679,,,aslanjadelynx0,0,1,1,0,1,1,0,0,1,1,1,0
14680,,,nnnlisu,0,1,1,0,1,1,0,0,1,1,1,0
14681,,,IllinoisGolfer,0,1,1,0,1,1,0,0,1,1,1,0
14682,,,savj0y,0,1,1,0,1,1,0,0,1,1,1,0
14683,,,TheGadryBlog,0,1,1,0,1,1,0,0,1,1,1,0
14684,,,Shama_Huang,3,1,4,3,1,4,0.333333,0.020061,0,0,0,0
14685,,,yuutasbff,0,1,1,0,1,1,0,0,1,1,1,0
14686,,,_EVELYN_15_,0,1,1,0,1,1,0,0,1,1,1,0
14687,,,farewellhorses,4,1,5,4,1,5,0.25,0.026749,0,0,0,0
14688,,,505melina,0,1,1,0,1,1,0,0,1,1,1,0
14689,,,WjBExc6ccnz25QY,0,1,1,0,1,1,0,0,1,1,1,0
14690,,,mikoss1957,0,1,1,0,1,1,0,0,1,1,1,0
14691,,,mindfulmono,1,1,2,1,1,2,0,0.006687,0,0,0,0
14692,,,RSolisByx,4,1,5,4,1,5,0.25,0.026749,0,0,0,0
14693,,,giorgioscorner,0,1,1,0,1,1,0,0,1,1,1,0
14694,,,Sassy14054125,0,1,1,0,1,1,0,0,1,1,1,0
14695,,,ponoyznmap,0,1,1,0,1,1,0,0,1,1,1,0
14696,,,EllBellBabyy,7,1,8,7,1,8,0.142857,0.04681,0,0,0,0
14697,,,LadyGodiva____,0,1,1,0,1,1,0,0,1,1,1,0
14698,,,__hechang,0,6,6,0,7,7,0,0,2,0.875,0.928571,0
14699,,,caIImecoochie,0,2,2,0,2,2,0,0,1,1,1,0
14700,,,whowiththewhat,0,1,1,0,1,1,0,0,1,1,1,0
14701,,,swaggyglassses,2,1,3,2,1,3,0.5,0.013374,0,0,0,0
14702,,,thehissilent3,0,1,1,0,1,1,0,0,1,1,1,0
14703,,,mconn7,4,1,5,4,1,5,0.25,0.026749,0,0,0,0
14704,,,LewisPherne,0,1,1,0,1,1,0,0,1,1,1,0
14705,,,VMlNDIPlTY,0,1,1,0,1,1,0,0,1,1,1,0
14706,,,RowdyQuattro,8,1,9,8,1,9,0.125,0.053497,0,0,0,0
14707,,,verenicekoo,0,1,1,0,1,1,0,0,1,1,1,0
14708,,,rkivebby,0,1,1,0,1,1,0,0,1,1,1,0
14709,,,momocan_14,0,1,1,0,1,1,0,0,1,1,1,0
14710,,,LKLiterary,0,1,1,0,1,1,0,0,1,1,1,0
14711,,,baryo_j,0,1,1,0,1,1,0,0,1,1,1,0
14712,,,idk_tbh_95,0,1,1,0,1,1,0,0,1,1,1,0
14713,,,tsukasa08302,0,1,1,0,1,1,0,0,1,1,1,0
14714,,,sprzyslp,0,1,1,0,1,1,0,0,1,1,1,0
14715,,,suiiiika,0,1,1,0,1,1,0,0,1,1,1,0
14716,,,Y_Mukai,2,1,3,2,1,3,0.5,0.013374,0,0,0,0
14717,,,papipupeponde,0,1,1,0,1,1,0,0,1,1,1,0
14718,,,Dekelly22,2,1,3,2,1,3,0.5,0.013374,0,0,0,0
14719,,,jyhfairy,0,1,1,0,1,1,0,0,1,1,1,0
14720,,,KazeShiba,1,1,2,2,2,4,0,0.006687,0,0,0,0
14721,,,luvsick4xiao,0,1,1,0,1,1,0,0,1,1,1,0
14722,,,050214__,0,1,1,0,1,1,0,0,1,1,1,0
14723,,,pretty_hoseok_,0,2,2,0,2,2,0,0,1,1,1,0
14724,,,dultwonisong,0,1,1,0,1,1,0,0,1,1,1,0
14725,,,iswearimsmart,1,1,2,1,1,2,0,0.006687,0,0,0,0
14726,,,thereaderfairy,3,2,5,3,2,5,0.25,0.020061,1,1,1,2
14727,,,Penmomtek,0,1,1,0,1,1,0,0,2,0.666667,0.75,0
14728,,,dumbassgremlinn,0,1,1,0,1,1,0,0,2,0.666667,0.75,0
14729,,,onehundredlight,5,1,6,5,1,6,0.2,0.033436,0,0,0,0
14730,,,pdp134340,0,1,1,0,1,1,0,0,1,1,1,0
14731,,,jpinlvnv,0,1,1,0,1,1,0,0,1,1,1,0
14732,,,popopoat289,0,1,1,0,1,1,0,0,1,1,1,0
14733,,,hitomijeu,3,1,4,3,1,4,0.333333,0.020061,0,0,0,0
14734,,,PinkWitchBunny,0,1,1,0,1,1,0,0,1,1,1,0
14735,,,rosylippie,2,1,3,2,1,3,0.5,0.016869,0,0,0,0
14736,,,cyjpeony,8,1,9,8,1,9,0.125,0.056991,0,0,0,0
14737,,,phen0480,0,1,1,0,1,1,0,0,1,1,1,0
14738,,,taebearsteefies,0,1,1,0,1,1,0,0,1,1,1,0
14739,,,usershonshon,0,1,1,0,1,1,0,0,1,1,1,0
14740,,,Peninna95697909,0,1,1,0,1,1,0,0,1,1,1,0
14741,,,kimberlychan0,0,2,2,0,2,2,0,0,1,1,1,0
14742,,,jmjknoviecitos,0,1,1,0,1,1,0,0,1,1,1,0
14743,,,DAYBREAKREQUIEM,0,1,1,0,1,1,0,0,1,1,1,0
14744,,,mouvements,0,1,1,0,1,1,0,0,1,1,1,0
14745,,,Emi0304_lm,0,1,1,0,1,1,0,0,1,1,1,0
14746,,,tonytex49,0,1,1,0,1,1,0,0,1,1,1,0
14747,,,reikazami,0,1,1,0,1,1,0,0,1,1,1,0
14748,,,gayfortenlee,0,1,1,0,1,1,0,0,1,1,1,0
14749,,,yuhanzybl,0,1,1,0,1,1,0,0,1,1,1,0
14750,,,yuzuenthusiast,0,1,1,0,1,1,0,0,1,1,1,0
14751,,,mundinhohannie,0,1,1,0,1,1,0,0,1,1,1,0
14752,,,tojiluvr2000,0,1,1,0,1,1,0,0,1,1,1,0
14753,,,_prodbwi,0,1,1,0,1,1,0,0,1,1,1,0
14754,,,jennthetutor,0,1,1,0,1,1,0,0,1,1,1,0
14755,,,KentaroTagawa,5,1,6,5,1,6,0.2,0.033436,0,0,0,0
14756,,,RBoomer45,0,1,1,0,1,1,0,0,1,1,1,0
14757,,,bethalee128,0,1,1,0,1,1,0,0,1,1,1,0
14758,,,HettyJ008,1,1,2,1,1,2,0,0.006687,0,0,0,0
14759,,,ccatko,0,1,1,0,1,1,0,0,1,1,1,0
14760,,,seokieyeokie,0,1,1,0,1,1,0,0,1,1,1,0
14761,,,cuddly_cuffs,0,2,2,0,2,2,0,0,1,1,1,0
14762,,,shirahime925,0,1,1,0,1,1,0,0,1,1,1,0
14763,,,Boscan88,0,1,1,0,1,1,0,0,1,1,1,0
14764,,,CurrenttimeN,2,1,3,2,1,3,0.5,0.013374,0,0,0,0
14765,,,auntmaggiep,0,2,2,0,2,2,0,0,1,1,1,0
14766,,,lavender_cielo,4,1,5,4,1,5,0.25,0.026749,0,0,0,0
14767,,,lizmelara9,0,1,1,0,1,1,0,0,1,1,1,0
14768,,,aubreybasilio,0,1,1,0,1,1,0,0,1,1,1,0
14769,,,lepetitsoleiI,0,3,3,0,3,3,0,0,1,1,1,0
14770,,,nekoyuzusama,0,1,1,0,1,1,0,0,1,1,1,0
14771,,,cotton___91,0,1,1,0,1,1,0,0,1,1,1,0
14772,,,kami060426,0,1,1,0,1,1,0,0,1,1,1,0
14773,,,rvagayboys,0,1,1,0,1,1,0,0,1,1,1,0
14774,,,dtpokemonkid,0,1,1,0,1,1,0,0,1,1,1,0
14775,,,cheekysu,10,1,11,12,3,15,0.1,0.066871,0,0,0,0
14776,,,tunnmTmOmUxIXaJ,0,1,1,0,1,1,0,0,1,1,1,0
14777,,,odetohyune,4,1,5,4,1,5,0.25,0.026749,0,0,0,0
14778,,,jieyazhang_,0,1,1,0,1,1,0,0,1,1,1,0
14779,,,OlympicEmperor,0,1,1,0,1,1,0,0,1,1,1,0
14780,,,mikanskyy,0,1,1,0,1,1,0,0,1,1,1,0
14781,,,KUEastAsia,7,1,8,7,1,8,0.142857,0.04681,0,0,0,0
14782,,,myuutarou08,0,1,1,0,1,1,0,0,1,1,1,0
14783,,,squishysin,0,1,1,0,1,1,0,0,1,1,1,0
14784,,,vgxky,0,1,1,0,1,1,0,0,1,1,1,0
14785,,,again_sky,0,2,2,0,2,2,0,0,1,1,1,0
14786,,,Nzgrim,4,1,5,4,1,5,0.25,0.082656,0,0,0,0
14787,,,moni_1973_,0,1,1,0,1,1,0,0,1,1,1,0
14788,,,petosis,0,1,1,0,1,1,0,0,1,1,1,0
14789,,,melodieha,3,1,4,3,1,4,0.333333,0.020061,0,0,0,0
14790,,,craw8600,0,1,1,0,1,1,0,0,1,1,1,0
14791,,,blacksheep16001,3,1,4,3,1,4,0.333333,0.020061,0,0,0,0
14792,,,_janice_ung_,0,1,1,0,1,1,0,0,1,1,1,0
14793,,,AndreaBall,3,1,4,4,2,6,0.333333,0.020061,0,0,0,0
14794,,,zhang33337124,0,1,1,0,1,1,0,0,1,1,1,0
14795,,,shixunqii,4,1,5,4,1,5,0.25,0.026749,0,0,0,0
14796,,,hyuckiexo,0,1,1,0,1,1,0,0,1,1,1,0
14797,,,AnnieLo46647337,0,1,1,0,1,1,0,0,1,1,1,0
14798,,,DLNewspapers,9,1,10,9,1,10,0.111111,0.060184,0,0,0,0
14799,,,CAROLYA04055910,0,1,1,0,1,1,0,0,1,1,1,0
14800,,,gerbear0915,0,1,1,0,1,1,0,0,1,1,1,0
14801,,,kinoko94,0,1,1,0,1,1,0,0,1,1,1,0
14802,,,strawberiberime,0,1,1,0,1,1,0,0,1,1,1,0
14803,,,backtohobiside,0,1,1,0,1,1,0,0,1,1,1,0
14804,,,tdshotoroki,0,2,2,0,2,2,0,0,1,1,1,0
14805,,,ethnicgoth,0,1,1,0,1,1,0,0,1,1,1,0
14806,,,Amery_Lovely,0,1,1,0,1,1,0,0,1,1,1,0
14807,,,TomWyne,0,1,1,0,1,1,0,0,1,1,1,0
14808,,,wrong_ca,0,1,1,0,1,1,0,0,1,1,1,0
14809,,,NaiSk8,0,1,1,0,1,1,0,0,1,1,1,0
14810,,,had3ssuckss_,0,1,1,0,1,1,0,0,1,1,1,0
14811,,,starryhangmo,0,1,1,0,1,1,0,0,1,1,1,0
14812,,,kur6m1,3,1,4,3,1,4,0.333333,0.020061,0,0,0,0
14813,,,prettyboyhwa,0,1,1,0,1,1,0,0,1,1,1,0
14814,,,pastelhottie,0,1,1,0,1,1,0,0,1,1,1,0
14815,,,QUACKYGYU,0,2,2,0,2,2,0,0,2,0.5625,0.611111,0
14816,,,tyongriki,0,1,1,0,1,1,0,0,1,1,1,0
14817,,,nnalmao,2,1,3,2,1,3,0.5,0.033232,0,0,0,0
14818,,,12DGOAT,4,1,5,4,1,5,0.25,0.026749,0,0,0,0
14819,,,exystentialist,0,1,1,0,1,1,0,0,1,1,1,0
14820,,,lwithers190,0,1,1,0,1,1,0,0,1,1,1,0
14821,,,m3ganlomaniac,0,1,1,0,1,1,0,0,1,1,1,0
14822,,,24TrendsUSA,6,1,7,7,2,9,0.166667,0.040123,0,0,0,0
14823,,,RahabReyes,0,1,1,0,1,1,0,0,1,1,1,0
14824,,,penisvt,0,1,1,0,1,1,0,0,1,1,1,0
14825,,,sudowoodyo,0,1,1,0,1,1,0,0,1,1,1,0
14826,,,Linghuiwu1,0,1,1,0,1,1,0,0,1,1,1,0
14827,,,much_spring,3,1,4,3,1,4,0.333333,0.020061,0,0,0,0
14828,,,piratehehet,0,1,1,0,1,1,0,0,1,1,1,0
14829,,,Esmi45747272,0,1,1,0,1,1,0,0,1,1,1,0
14830,,,24Trends_Canada,2,1,3,2,1,3,0.5,0.013374,0,0,0,0
14831,,,ruelle,1,1,2,1,1,2,0,0.006687,0,0,0,0
14832,,,rSoda,1,1,2,1,1,2,0,0.006687,0,0,0,0
14833,,,brismitty,6,1,7,6,1,7,0.166667,0.040123,0,0,0,0
14834,,,CatSkate0808,0,1,1,0,1,1,0,0,1,1,1,0
14835,,,Elena97233030,0,1,1,0,1,1,0,0,1,1,1,0
14836,,,ayuanism,0,1,1,0,1,1,0,0,1,1,1,0
14837,,,sussaaay,0,1,1,0,1,1,0,0,1,1,1,0
14838,,,toomanycommas3,0,1,1,0,1,1,0,0,1,1,1,0
14839,,,ChinaNewsDelhi,3,1,4,3,1,4,0.333333,0.020061,0,0,0,0
14840,,,youngfreverknj,0,1,1,0,1,1,0,0,1,1,1,0
14841,,,kira_ukimoora,0,1,1,0,1,1,0,0,1,1,1,0
14842,,,imnakedandsad,14,1,15,14,1,15,0.071429,0.09362,0,0,0,0
14843,,,tkmxiu,0,1,1,0,1,1,0,0,1,1,1,0
14844,,,vanessaeon,0,2,2,0,2,2,0,0,1,1,1,0
14845,,,cashswizzac,0,1,1,0,1,1,0,0,1,1,1,0
14846,,,zuzupooh_,0,1,1,0,1,1,0,0,1,1,1,0
14847,,,joawtan,0,1,1,0,1,1,0,0,1,1,1,0
14848,,,YMintana,0,1,1,0,1,1,0,0,1,1,1,0
14849,,,VickiVBowen2,0,1,1,0,1,1,0,0,1,1,1,0
14850,,,monstaexomenow,0,1,1,0,1,1,0,0,1,1,1,0
14851,,,nctetitas,0,1,1,0,1,1,0,0,1,1,1,0
14852,,,kardamdoll,0,1,1,0,1,1,0,0,1,1,1,0
14853,,,aleescamilla_,0,1,1,0,1,1,0,0,1,1,1,0
14854,,,Dahlia_PROetess,0,1,1,0,1,1,0,0,1,1,1,0
14855,,,jaeloml127,0,1,1,0,1,1,0,0,1,1,1,0
14856,,,Albert0423Hao,0,3,3,0,3,3,0,0,1,1,1,0
14857,,,nicholasvchen,0,1,1,0,1,1,0,0,1,1,1,0
14858,,,muzzeltov,0,1,1,0,1,1,0,0,1,1,1,0
14859,,,athenwea,0,1,1,0,1,1,0,0,1,1,1,0
14860,,,PhillCalvin1,5,1,6,5,1,6,0.2,0.033436,0,0,0,0
14861,,,ashleeabel,0,1,1,0,1,1,0,0,1,1,1,0
14862,,,meuu_u_,0,1,1,0,1,1,0,0,1,1,1,0
14863,,,yuzugnf,0,1,1,0,1,1,0,0,1,1,1,0
14864,,,michaelgreentea,9,1,10,10,1,11,0.111111,0.063679,0,0,0,0
14865,,,metamorfosisado,0,1,1,0,1,1,0,0,1,1,1,0
14866,,,VesperDs,0,1,1,0,1,1,0,0,1,1,1,0
14867,,,Jiminneee_,0,1,1,0,1,1,0,0,1,1,1,0
14868,,,YsanneBueno,0,2,2,0,2,2,0,0,1,1,1,0
14869,,,AXEofSteeeep,0,2,2,0,3,3,0,0,1,1,1,0
14870,,,muchswaglizs,0,1,1,0,1,1,0,0,1,1,1,0
14871,,,kaaneshun,0,1,1,0,1,1,0,0,1,1,1,0
14872,,,MAYAYaaa3,0,1,1,0,1,1,0,0,1,1,1,0
14873,,,YungYuzuru,0,1,1,0,1,1,0,0,1,1,1,0
14874,,,RyuuWaterDragon,0,1,1,0,1,1,0,0,1,1,1,0
14875,,,SMFulton3,0,1,1,0,1,1,0,0,1,1,1,0
14876,,,keczekaj,0,1,1,0,1,1,0,0,1,1,1,0
14877,,,KetCorrine,0,1,1,0,1,1,0,0,1,1,1,0
14878,,,ZJkoo7,0,1,1,0,1,1,0,0,1,1,1,0
14879,,,Blue12310153,0,1,1,0,1,1,0,0,1,1,1,0
14880,,,eomkyu,0,1,1,0,1,1,0,0,2,0.666667,0.75,0
14881,,,PookPatty,0,1,1,0,1,1,0,0,2,0.666667,0.75,0
14882,,,RilkeRainer,0,1,1,0,1,1,0,0,2,0.666667,0.75,0
14883,,,SulllivanLisa,1,1,2,1,1,2,0,0.006687,0,0,0,0
14884,,,Flaski6,1,1,2,1,1,2,0,0.006687,0,0,0,0
14885,,,filtaevv,4,1,5,4,1,5,0.25,0.026749,0,0,0,0
14886,,,DanvilleSanta,0,1,1,0,1,1,0,0,1,1,1,0
14887,,,marimo4177,0,1,1,0,1,1,0,0,1,1,1,0
14888,,,Marianworley,5,1,6,5,1,6,0.2,0.033436,0,0,0,0
14889,,,rosavioretta,0,1,1,0,1,1,0,0,1,1,1,0
14890,,,winwinslegs,0,2,2,0,2,2,0,0,1,1,1,0
14891,,,byunchonsa,14,1,15,14,1,15,0.071429,0.09362,0,0,0,0
14892,,,amuamu0615,0,1,1,0,1,1,0,0,1,1,1,0
14893,,,LisaSwedenburg1,0,1,1,0,1,1,0,0,1,1,1,0
14894,,,suzmarques,0,1,1,0,1,1,0,0,1,1,1,0
14895,,,JINS0N94,0,1,1,0,1,1,0,0,1,1,1,0
14896,,,frozenepcot,0,1,1,0,1,1,0,0,1,1,1,0
14897,,,FraydPleiades,0,1,1,0,1,1,0,0,1,1,1,0
14898,,,MCPlSS,0,1,1,0,1,1,0,0,1,1,1,0
14899,,,Miradora,0,1,1,0,1,1,0,0,1,1,1,0
14900,,,TAMMYPMC,0,1,1,0,1,1,0,0,1,1,1,0
14901,,,jimmortensen,1,1,2,1,1,2,0,0.006687,0,0,0,0
14902,,,atdavidhoffman,0,1,1,0,1,1,0,0,1,1,1,0
14903,,,TwoShowDays,0,1,1,0,1,1,0,0,1,1,1,0
14904,,,Bassicbobby,3,1,4,3,1,4,0.333333,0.020061,0,0,0,0
14905,,,Kivallica,0,1,1,0,1,1,0,0,1,1,1,0
14906,,,lily_boldman,0,1,1,0,1,1,0,0,1,1,1,0
14907,,,mlh3478,0,1,1,0,1,1,0,0,1,1,1,0
14908,,,meredithyuh2,7,1,8,7,1,8,0.142857,0.04681,0,0,0,0
14909,,,taebeavrsito,0,1,1,0,1,1,0,0,1,1,1,0
14910,,,shado3172,0,1,1,0,1,1,0,0,1,1,1,0
14911,,,1418_yy33,0,1,1,0,1,1,0,0,1,1,1,0
14912,,,_aridean,0,1,1,0,1,1,0,0,1,1,1,0
14913,,,Sans_UndertaIe,0,1,1,0,1,1,0,0,1,1,1,0
14914,,,krys_trbl,2,1,3,2,1,3,0.5,0.013374,0,0,0,0
14915,,,k_k_yu,0,1,1,0,1,1,0,0,1,1,1,0
14916,,,bemidji,1,1,2,1,1,2,0,0.006687,0,0,0,0
14917,,,SbeanieHobi,1,1,2,1,1,2,0,0.006687,0,0,0,0
14918,,,Romare,1,1,2,1,1,2,0,0.006687,0,0,0,0
14919,,,twobitsfourbits,1,1,2,1,1,2,0,0.006687,0,0,0,0
14920,,,keevah_,0,1,1,0,1,1,0,0,1,1,1,0
14921,,,ultethanlee,0,1,1,0,1,1,0,0,1,1,1,0
14922,,,kriskerzman,12,1,13,13,2,15,0.083333,0.136153,0,0,0,0
14923,,,cataricataricat,0,1,1,0,1,1,0,0,1,1,1,0
14924,,,bkpp_sun,0,1,1,0,1,1,0,0,1,1,1,0
14925,,,genuinesque,0,1,1,0,1,1,0,0,1,1,1,0
14926,,,aim_high__,0,2,2,0,2,2,0,0,1,1,1,0
14927,,,amyquispe,8,1,9,8,1,9,0.125,0.053497,0,0,0,0
14928,,,asparnotaspar,0,1,1,0,1,1,0,0,1,1,1,0
14929,,,Taetae_Googie,0,1,1,0,1,1,0,0,1,1,1,0
14930,,,JanCham76595306,0,1,1,0,1,1,0,0,1,1,1,0
14931,,,nahyuckbf,0,1,1,0,1,1,0,0,1,1,1,0
14932,,,KSJDADDYSHOME,0,1,1,0,1,1,0,0,1,1,1,0
14933,,,craebmini,0,1,1,0,1,1,0,0,1,1,1,0
14934,,,billchenpoker,1,1,2,1,1,2,0,0.006687,0,0,0,0
14935,,,cielosueloastro,1,1,2,1,1,2,0,0.006687,0,0,0,0
14936,,,rlaben,5,1,6,5,1,6,0.2,0.033436,0,0,0,0
14937,,,JIMINistrending,0,1,1,0,1,1,0,0,1,1,1,0
14938,,,MaggieS225,0,1,1,0,1,1,0,0,1,1,1,0
14939,,,bludflowerz,0,1,1,0,1,1,0,0,1,1,1,0
14940,,,Boatmamacita,5,1,6,5,1,6,0.2,0.033436,0,0,0,0
14941,,,semirose,0,1,1,0,1,1,0,0,1,1,1,0
14942,,,ConfessionToKai,0,1,1,0,1,1,0,0,1,1,1,0
14943,,,wolfjon4,10,1,11,10,1,11,0.1,0.066871,0,0,0,0
14944,,,jaegerdemons,0,1,1,0,1,1,0,0,1,1,1,0
14945,,,borasaegworld20,0,1,1,0,1,1,0,0,1,1,1,0
14946,,,A_mcmxci_,0,1,1,0,1,1,0,0,1,1,1,0
14947,,,_soobder,0,2,2,0,2,2,0,0,1,1,1,0
14948,,,FAIRYSOYA,0,1,1,0,1,1,0,0,1,1,1,0
14949,,,M00NSUG4,0,1,1,0,1,1,0,0,1,1,1,0
14950,,,UghhhDeja,0,1,1,0,1,1,0,0,1,1,1,0
14951,,,i43yizhan,0,2,2,0,2,2,0,0,1,1,1,0
14952,,,Avii_TheBomb,0,1,1,0,1,1,0,0,1,1,1,0
14953,,,ksjgoth,0,1,1,0,1,1,0,0,1,1,1,0
14954,,,rxcketpuncher,0,1,1,0,1,1,0,0,1,1,1,0
14955,,,lisajdubreuil,0,1,1,0,1,1,0,0,1,1,1,0
14956,,,iwabuchi1125,0,1,1,0,1,1,0,0,1,1,1,0
14957,,,nnnooan06,0,1,1,0,1,1,0,0,1,1,1,0
14958,,,FullmetalOwO,0,1,1,0,1,1,0,0,1,1,1,0
14959,,,namkookgothbfs,0,1,1,0,1,1,0,0,1,1,1,0
14960,,,kwjager,0,1,1,0,1,1,0,0,1,1,1,0
14961,,,Geve222,0,1,1,0,1,1,0,0,1,1,1,0
14962,,,moonchildbela8,0,1,1,0,1,1,0,0,2,0.533333,0.5625,0
14963,,,naaaaaaaaughty,0,1,1,0,1,1,0,0,2,0.533333,0.5625,0
14964,,,keron1992915,0,1,1,0,1,1,0,0,2,0.533333,0.5625,0
14965,,,zhang_heqing,4,2,6,4,2,6,0.2,0.026749,2,0.533333,0.5625,24
14966,,,william_durfey,0,2,2,0,4,4,0,0,2,0.5625,0.611111,0
14967,,,archietse,0,1,1,0,1,1,0,0,2,0.533333,0.5625,0
14968,,,devantighe,0,1,1,0,1,1,0,0,2,0.533333,0.5625,0
14969,,,jikookxbj,0,1,1,0,1,1,0,0,2,0.533333,0.5625,0
14970,,,JJPSM,0,1,1,0,1,1,0,0,2,0.533333,0.5625,0
14971,,,chefmaguita,0,1,1,0,1,1,0,0,2,0.533333,0.5625,0
14972,,,Ktpthilak,0,1,1,0,1,1,0,0,2,0.533333,0.5625,0
14973,,,Moonblzeira,0,1,1,0,1,1,0,0,2,0.533333,0.5625,0
14974,,,writtenbykelsey,0,2,2,0,2,2,0,0,1,1,1,0
14975,,,restart21miyabi,0,1,1,0,1,1,0,0,1,1,1,0
14976,,,BRXMlEN,0,1,1,0,1,1,0,0,1,1,1,0
14977,,,reweluv,0,1,1,0,1,1,0,0,1,1,1,0
14978,,,yeonjunilysm,0,1,1,0,1,1,0,0,1,1,1,0
14979,,,_antirom,3,1,4,3,1,4,0.333333,0.020061,0,0,0,0
14980,,,bIaackswan,0,1,1,0,1,1,0,0,1,1,1,0
14981,,,kiIIerdyke,0,1,1,0,1,1,0,0,1,1,1,0
14982,,,HRaleighspeaks,4,1,5,4,1,5,0.25,0.026749,0,0,0,0
14983,,,KellyWileyNews,0,1,1,0,1,1,0,0,1,1,1,0
14984,,,_laili_,0,1,1,0,1,1,0,0,1,1,1,0
14985,,,WmjhHarris,0,1,1,0,1,1,0,0,1,1,1,0
14986,,,Sundropsytoppsy,0,1,1,0,1,1,0,0,1,1,1,0
14987,,,slayk1tty,13,1,14,13,1,14,0.076923,0.121875,0,0,0,0
14988,,,maychangamer3,0,1,1,0,1,1,0,0,1,1,1,0
14989,,,Vsualbangtxn,0,2,2,0,2,2,0,0,1,1,1,0
14990,,,prfct_v,0,1,1,0,1,1,0,0,1,1,1,0
14991,,,MoontwoSeok,0,1,1,0,1,1,0,0,1,1,1,0
14992,,,zzzoja_atp,0,1,1,0,1,1,0,0,1,1,1,0
14993,,,norajanbalikian,0,1,1,0,1,1,0,0,1,1,1,0
14994,,,iama_carrot,0,1,1,0,1,1,0,0,1,1,1,0
14995,,,bankshot666,0,1,1,0,1,1,0,0,1,1,1,0
14996,,,magicshophana,17,1,18,20,2,22,0.058824,0.113681,0,0,0,0
14997,,,blueisnotred,0,1,1,0,2,2,0,0,1,1,1,0
14998,,,Wendyh1991,0,1,1,0,1,1,0,0,1,1,1,0
14999,,,geoffpilkington,2,1,3,2,1,3,0.5,0.013374,0,0,0,0
15000,,,maker42008759,6,1,7,6,1,7,0.166667,0.040123,0,0,0,0
15001,,,TayWuang,0,1,1,0,1,1,0,0,1,1,1,0
15002,,,T_Vazzy,0,1,1,0,1,1,0,0,1,1,1,0
15003,,,megasmar,0,1,1,0,1,1,0,0,1,1,1,0
15004,,,Lpine001,0,1,1,0,1,1,0,0,1,1,1,0
15005,,,age30s1,0,1,1,0,1,1,0,0,1,1,1,0
15006,,,mizumonoe,0,1,1,0,1,1,0,0,1,1,1,0
15007,,,kenialachula2,0,1,1,0,1,1,0,0,1,1,1,0
15008,,,sweetpiedpiper_,0,1,1,0,1,1,0,0,1,1,1,0
15009,,,wavvyy1,0,1,1,0,1,1,0,0,1,1,1,0
15010,,,NSsouth,0,1,1,0,1,1,0,0,1,1,1,0
15011,,,decalnyu,0,1,1,0,1,1,0,0,1,1,1,0
15012,,,tubaki5296,0,1,1,0,1,1,0,0,1,1,1,0
15013,,,PinguSinatra,0,1,1,0,1,1,0,0,1,1,1,0
15014,,,MusicArtHope1,0,4,4,0,5,5,0,0,1,1,1,0
15015,,,dantrbI,0,1,1,0,1,1,0,0,1,1,1,0
15016,,,Sunshine_4u_,0,2,2,0,2,2,0,0,1,1,1,0
15017,,,Mitchkq81,0,1,1,0,1,1,0,0,1,1,1,0
15018,,,mariannagroluna,0,1,1,0,1,1,0,0,1,1,1,0
15019,,,vividiepacretv,2,1,3,2,1,3,0.5,0.013374,0,0,0,0
15020,,,StageLeft_NYC,0,1,1,0,1,1,0,0,1,1,1,0
15021,,,Jala__WashTV,3,1,4,3,1,4,0.333333,0.020061,0,0,0,0
15022,,,mukudorii,0,1,1,0,1,1,0,0,1,1,1,0
15023,,,DTAY_M,2,1,3,2,1,3,0.5,0.013374,0,0,0,0
15024,,,back2market2013,2,1,3,2,1,3,0.5,0.013374,0,0,0,0
15025,,,joydownurheart,0,2,2,0,2,2,0,0,1,1,1,0
15026,,,_caratTeume1,9,1,10,9,1,10,0.111111,0.116092,0,0,0,0
15027,,,hxllxwgast,0,1,1,0,1,1,0,0,1,1,1,0
15028,,,ZenarosaFranci2,0,2,2,0,2,2,0,0,1,1,1,0
15029,,,sapphanji,0,1,1,0,1,1,0,0,1,1,1,0
15030,,,1120ENHA,0,1,1,0,1,1,0,0,1,1,1,0
15031,,,ymaerc1d,0,1,1,0,1,1,0,0,1,1,1,0
15032,,,carmen_wister18,0,1,1,0,1,1,0,0,1,1,1,0
15033,,,Emily_P_2001,0,1,1,0,1,1,0,0,1,1,1,0
15034,,,dudarnascimento,4,1,5,4,1,5,0.25,0.026749,0,0,0,0
15035,,,exidputa,0,4,4,0,4,4,0,0,1,1,1,0
15036,,,mare_yk,0,1,1,0,1,1,0,0,1,1,1,0
15037,,,AustinKellerman,0,1,1,0,1,1,0,0,1,1,1,0
15038,,,mccaingangmom,2,1,3,2,1,3,0.5,0.013374,0,0,0,0
15039,,,yglvrr,0,3,3,0,3,3,0,0,1,1,1,0
15040,,,shuanxyucrt,11,1,12,13,1,14,0.090909,0.080547,0,0,0,0
15041,,,mixedbylana,0,1,1,0,3,3,0,0,1,1,1,0
15042,,,AnayraCeleste,0,1,1,0,1,1,0,0,1,1,1,0
15043,,,navihateclub,0,2,2,0,2,2,0,0,1,1,1,0
15044,,,lynliyaibrahim,0,1,1,0,1,1,0,0,1,1,1,0
15045,,,cherryyyuzu,0,1,1,0,1,1,0,0,1,1,1,0
15046,,,hailey_worsham,0,1,1,0,1,1,0,0,1,1,1,0
15047,,,em_el_cee,5,1,6,5,1,6,0.2,0.033436,0,0,0,0
15048,,,sububbless,0,1,1,0,1,1,0,0,1,1,1,0
15049,,,djalexreyes,0,1,1,0,1,1,0,0,1,1,1,0
15050,,,Cezka05,0,1,1,0,1,1,0,0,1,1,1,0
15051,,,Iamlegend206,0,1,1,0,1,1,0,0,1,1,1,0
15052,,,emoleechen,1,1,2,1,1,2,0,0.006687,0,0,0,0
15053,,,2SEOKFILE,5,1,6,5,1,6,0.2,0.033436,0,0,0,0
15054,,,yukizingersand,0,1,1,0,1,1,0,0,1,1,1,0
15055,,,theycallmeVLM,0,1,1,0,1,1,0,0,1,1,1,0
15056,,,Soumonus,0,1,1,0,1,1,0,0,1,1,1,0
15057,,,hbakerutley,5,1,6,5,1,6,0.2,0.033436,0,0,0,0
15058,,,thedumbant,0,2,2,0,2,2,0,0,1,1,1,0
15059,,,bloodmoonazula,0,1,1,0,1,1,0,0,1,1,1,0
15060,,,GummyCowViv,0,2,2,0,2,2,0,0,1,1,1,0
15061,,,yutashole,0,3,3,0,3,3,0,0,2,0.8,0.875,0
15062,,,0108Georgie,0,1,1,0,1,1,0,0,1,1,1,0
15063,,,BChuSports,0,1,1,0,3,3,0,0,1,1,1,0
15064,,,MtHoodFinds,0,1,1,0,1,1,0,0,1,1,1,0
15065,,,bbyminie__,0,1,1,0,1,1,0,0,1,1,1,0
15066,,,JayJurden,0,1,1,0,1,1,0,0,1,1,1,0
15067,,,georgiegardenia,0,1,1,0,1,1,0,0,1,1,1,0
15068,,,PoopJournalist,6,1,7,6,1,7,0.166667,0.040123,0,0,0,0
15069,,,Maria_elarcd,0,1,1,0,1,1,0,0,1,1,1,0
15070,,,futnobwin,0,1,1,0,1,1,0,0,1,1,1,0
15071,,,0T7_2013,0,1,1,0,1,1,0,0,1,1,1,0
15072,,,gervdumplife,0,1,1,0,1,1,0,0,1,1,1,0
15073,,,yoongmono,2,1,3,2,1,3,0.5,0.013374,0,0,0,0
15074,,,MsStephGuzman,0,1,1,0,1,1,0,0,1,1,1,0
15075,,,maxisposting,3,1,4,3,1,4,0.333333,0.020061,0,0,0,0
15076,,,sunyudream,0,1,1,0,1,1,0,0,1,1,1,0
15077,,,LHOCTeam,0,1,1,0,1,1,0,0,1,1,1,0
15078,,,tede3e,2,1,3,2,1,3,0.5,0.013374,0,0,0,0
15079,,,iamhollyim,0,1,1,0,1,1,0,0,1,1,1,0
15080,,,DarkRey75,1,1,2,1,1,2,0,0.006687,0,0,0,0
15081,,,KyThePiGuy,22,1,23,22,1,23,0.045455,0.147117,0,0,0,0
15082,,,LoveandLucyx,0,1,1,0,1,1,0,0,1,1,1,0
15083,,,seulgiamond,0,3,3,0,3,3,0,0,1,1,1,0
15084,,,WenAndZhou,0,1,1,0,1,1,0,0,1,1,1,0
15085,,,c0rruptchuuya,0,1,1,0,1,1,0,0,1,1,1,0
15086,,,hipoposto,0,1,1,0,1,1,0,0,1,1,1,0
15087,,,aespafaeries,0,1,1,0,1,1,0,0,1,1,1,0
15088,,,dohangyull,0,1,1,0,1,1,0,0,1,1,1,0
15089,,,choichunhee,0,1,1,0,1,1,0,0,1,1,1,0
15090,,,Catslawrence,0,1,1,0,1,1,0,0,1,1,1,0
15091,,,amy_xingg,0,2,2,0,2,2,0,0,1,1,1,0
15092,,,n7amgi,0,1,1,0,1,1,0,0,1,1,1,0
15093,,,Birdonwing,0,2,2,0,2,2,0,0,1,1,1,0
15094,,,ye0ng_g,0,1,1,0,1,1,0,0,1,1,1,0
15095,,,amerine1000,0,1,1,0,1,1,0,0,1,1,1,0
15096,,,bunnyTamii,0,1,1,0,1,1,0,0,1,1,1,0
15097,,,msbyfrogs,0,1,1,0,1,1,0,0,1,1,1,0
15098,,,kgass_31,0,1,1,0,1,1,0,0,1,1,1,0
15099,,,moonfairy0613,0,1,1,0,1,1,0,0,1,1,1,0
15100,,,kvantgogh,0,1,1,0,1,1,0,0,1,1,1,0
15101,,,shaunhashim,4,1,5,4,1,5,0.25,0.026749,0,0,0,0
15102,,,alexmgunzalez,0,1,1,0,1,1,0,0,1,1,1,0
15103,,,army_nanami,0,2,2,0,2,2,0,0,1,1,1,0
15104,,,anppani,5,1,6,5,1,6,0.2,0.033436,0,0,0,0
15105,,,werdawrld,0,1,1,0,1,1,0,0,1,1,1,0
15106,,,whosgojo,0,2,2,0,2,2,0,0,1,1,1,0
15107,,,1cocapalsusto,0,1,1,0,1,1,0,0,1,1,1,0
15108,,,ZRebel13,0,1,1,0,1,1,0,0,1,1,1,0
15109,,,Rowantheunknown,1,1,2,1,1,2,0,0.006687,0,0,0,0
15110,,,smsunarto,6,1,7,6,1,7,0.166667,0.040123,0,0,0,0
15111,,,meltedpot2,0,1,1,0,1,1,0,0,1,1,1,0
15112,,,kickassssidy,0,1,1,0,1,1,0,0,1,1,1,0
15113,,,cobyofficial9,0,1,1,0,1,1,0,0,1,1,1,0
15114,,,warrior65610415,7,1,8,8,2,10,0.142857,0.04681,0,0,0,0
15115,,,MagicShopMari,0,1,1,0,1,1,0,0,1,1,1,0
15116,,,qiukoala,0,2,2,0,2,2,0,0,2,0.75,0.833333,0
15117,,,darIingnana,0,1,1,0,1,1,0,0,1,1,1,0
15118,,,lovelysasukeand,0,1,1,0,1,1,0,0,1,1,1,0
15119,,,reigensslover,0,1,1,0,1,1,0,0,1,1,1,0
15120,,,MonkeeBread,8,1,9,8,1,9,0.125,0.080667,0,0,0,0
15121,,,BrieWeasley,0,2,2,0,2,2,0,0,1,1,1,0
15122,,,X22_SG,0,1,1,0,1,1,0,0,1,1,1,0
15123,,,angie_keathly,0,2,2,0,2,2,0,0,1,1,1,0
15124,,,veryderpypizza,0,1,1,0,1,1,0,0,1,1,1,0
15125,,,_jackyyyyy,0,1,1,0,1,1,0,0,1,1,1,0
15126,,,wiIbursoupp,5,1,6,5,1,6,0.2,0.033436,0,0,0,0
15127,,,gookyy2,0,1,1,0,1,1,0,0,1,1,1,0
15128,,,weaswiftx,0,1,1,0,1,1,0,0,1,1,1,0
15129,,,emibebe,0,1,1,0,1,1,0,0,1,1,1,0
15130,,,sadgirlfio,0,1,1,0,1,1,0,0,1,1,1,0
15131,,,wilsonwillywong,3,1,4,3,1,4,0.333333,0.020061,0,0,0,0
15132,,,MorrisM4848,0,1,1,0,1,1,0,0,1,1,1,0
15133,,,Kuhachoco,0,1,1,0,1,1,0,0,1,1,1,0
15134,,,MMSlough,5,1,6,7,3,10,0.2,0.033436,0,0,0,0
15135,,,TVwebproducer,0,1,1,0,1,1,0,0,1,1,1,0
15136,,,nbc4i,0,1,1,0,1,1,0,0,1,1,1,0
15137,,,iKissItadori,0,1,1,0,1,1,0,0,1,1,1,0
15138,,,clownhye,0,1,1,0,1,1,0,0,1,1,1,0
15139,,,choikahyi,0,1,1,0,1,1,0,0,1,1,1,0
15140,,,seoholattae,0,1,1,0,1,1,0,0,1,1,1,0
15141,,,AnneWan53109365,8,1,9,8,1,9,0.125,0.053497,0,0,0,0
15142,,,10MilesStereo,0,1,1,0,1,1,0,0,1,1,1,0
15143,,,bluesidez,0,1,1,0,1,1,0,0,1,1,1,0
15144,,,toxyfixy,0,1,1,0,1,1,0,0,1,1,1,0
15145,,,love_fabela,0,1,1,0,1,1,0,0,1,1,1,0
15146,,,DeepxBreath,0,1,1,0,1,1,0,0,1,1,1,0
15147,,,laura_faletti,2,1,3,2,1,3,0.5,0.013374,0,0,0,0
15148,,,axyxia,8,1,9,8,1,9,0.125,0.056991,0,0,0,0
15149,,,coletteangelwyc,1,2,3,1,2,3,0.5,0.006687,1,1,1,0
15150,,,soups_for_coups,0,1,1,0,1,1,0,0,1,1,1,0
15151,,,VillanuevaYnigo,0,1,1,0,1,1,0,0,1,1,1,0
15152,,,Test3Zyc,0,1,1,0,1,1,0,0,1,1,1,0
15153,,,engIantina,0,1,1,0,1,1,0,0,1,1,1,0
15154,,,SerithVastyne,0,1,1,0,1,1,0,0,1,1,1,0
15155,,,WCTsports,2,1,3,2,1,3,0.5,0.027351,0,0,0,0
15156,,,emchpiss,4,2,6,4,2,6,0.2,0.026749,1,1,1,3
15157,,,MDR_Sports,9,1,10,9,1,10,0.111111,0.084644,0,0,0,0
15158,,,kim,7,2,9,7,2,9,0.125,0.04681,1,1,1,6
15159,,,adarshofsalt,0,1,1,0,1,1,0,0,1,1,1,0
15160,,,eaturfruitloops,0,1,1,0,1,1,0,0,1,1,1,0
15161,,,SugaMerry613,0,1,1,0,1,1,0,0,1,1,1,0
15162,,,ma_a_a_no,0,1,1,0,1,1,0,0,1,1,1,0
15163,,,nerd_yue,0,1,1,0,1,1,0,0,1,1,1,0
15164,,,Kaylen987,0,1,1,0,1,1,0,0,1,1,1,0
15165,,,byronicbf,0,1,1,0,1,1,0,0,1,1,1,0
15166,,,real_milymilyen,8,1,9,8,1,9,0.125,0.053497,0,0,0,0
15167,,,sk8rcyj,0,2,2,0,2,2,0,0,1,1,1,0
15168,,,crumb_emily,0,1,1,0,1,1,0,0,1,1,1,0
15169,,,shookookiee,0,1,1,0,1,1,0,0,1,1,1,0
15170,,,_Moonie_Joonie_,0,1,1,0,1,1,0,0,1,1,1,0
15171,,,Maddog4Biden,0,1,1,0,1,1,0,0,1,1,1,0
15172,,,Insteadofitall,0,1,1,0,1,1,0,0,1,1,1,0
15173,,,felixcherrypie,0,1,1,0,1,1,0,0,1,1,1,0
15174,,,stirlynn2_0,3,1,4,3,1,4,0.333333,0.020061,0,0,0,0
15175,,,uhhzula,0,1,1,0,1,1,0,0,1,1,1,0
15176,,,doublebbams1,0,1,1,0,1,1,0,0,1,1,1,0
15177,,,asongfrombea,7,1,8,7,1,8,0.142857,0.04681,0,0,0,0
15178,,,eternallyjjinie,0,1,1,0,1,1,0,0,1,1,1,0
15179,,,Maa61633444,0,1,1,0,1,1,0,0,1,1,1,0
15180,,,entenkwkm,0,1,1,0,1,1,0,0,1,1,1,0
15181,,,blueyellow29,0,1,1,0,1,1,0,0,1,1,1,0
15182,,,DrFakeJillBide1,0,1,1,0,1,1,0,0,1,1,1,0
15183,,,bambooshooti,0,1,1,0,1,1,0,0,1,1,1,0
15184,,,juliaren_e,0,1,1,0,1,1,0,0,1,1,1,0
15185,,,kristyechoi,0,1,1,0,1,1,0,0,1,1,1,0
15186,,,jinheoney,0,1,1,0,1,1,0,0,1,1,1,0
15187,,,foresttunic,0,1,1,0,1,1,0,0,1,1,1,0
15188,,,etherealjjk1,0,2,2,0,2,2,0,0,2,0.75,0.833333,0
15189,,,rachm528,0,1,1,0,1,1,0,0,2,0.666667,0.75,0
15190,,,sweetcheekshope,0,1,1,0,1,1,0,0,2,0.666667,0.75,0
15191,,,meggyleggyy,1,1,2,1,1,2,0,0.006687,0,0,0,0
15192,,,kouIicious,1,1,2,1,1,2,0,0.006687,0,0,0,0
15193,,,DavidSamuelBla4,1,1,2,1,1,2,0,0.006687,0,0,0,0
15194,,,jayothan,1,1,2,1,1,2,0,0.006687,0,0,0,0
15195,,,Jeremay_MD,0,1,1,0,1,1,0,0,1,1,1,0
15196,,,yoo08726,4,1,5,5,2,7,0.25,0.026749,0,0,0,0
15197,,,arisayakaba,0,2,2,0,2,2,0,0,1,1,1,0
15198,,,aceeeiou,3,1,4,3,1,4,0.333333,0.020061,0,0,0,0
15199,,,tweetybrd21,0,1,1,0,1,1,0,0,1,1,1,0
15200,,,aabbyleaa,18,1,19,19,1,20,0.055556,0.130851,0,0,0,0
15201,,,omipy_0808,0,1,1,0,1,1,0,0,1,1,1,0
15202,,,carrie0marie,0,1,1,0,1,1,0,0,1,1,1,0
15203,,,BuhnuudUul,0,1,1,0,1,1,0,0,1,1,1,0
15204,,,beth_vm,0,1,1,0,1,1,0,0,1,1,1,0
15205,,,krisshia12,0,1,1,0,1,1,0,0,1,1,1,0
15206,,,miniminkoo_,0,1,1,0,1,1,0,0,1,1,1,0
15207,,,musicalmarauder,0,1,1,0,1,1,0,0,1,1,1,0
15208,,,JayMerold,0,1,1,0,1,1,0,0,1,1,1,0
15209,,,parikh_khelan,0,1,1,0,1,1,0,0,1,1,1,0
15210,,,LuigiMurdoccaJr,0,1,1,0,1,1,0,0,1,1,1,0
15211,,,ko0filter,0,2,2,0,2,2,0,0,1,1,1,0
15212,,,kaeyascoochie,0,1,1,0,1,1,0,0,1,1,1,0
15213,,,jjchoozeme,0,1,1,0,1,1,0,0,1,1,1,0
15214,,,cain_fsk,0,1,1,0,1,1,0,0,1,1,1,0
15215,,,luvskm,10,1,11,10,1,11,0.1,0.066871,0,0,0,0
15216,,,DeniseB28480321,0,2,2,0,2,2,0,0,1,1,1,0
15217,,,SomHappySwing,0,1,1,0,1,1,0,0,1,1,1,0
15218,,,youzishaddock,0,1,1,0,1,1,0,0,1,1,1,0
15219,,,raicned1,0,1,1,0,1,1,0,0,1,1,1,0
15220,,,candypie22,0,1,1,0,1,1,0,0,1,1,1,0
15221,,,cursedaxel,2,1,3,2,1,3,0.5,0.022664,0,0,0,0
15222,,,SilkeLeFay,14,1,15,14,1,15,0.071429,0.09362,0,0,0,0
15223,,,CarmenShumate,0,1,1,0,1,1,0,0,1,1,1,0
15224,,,thebunnyflyyy,0,1,1,0,1,1,0,0,1,1,1,0
15225,,,suhventeen,0,1,1,0,1,1,0,0,1,1,1,0
15226,,,liznoteliza,0,1,1,0,1,1,0,0,1,1,1,0
15227,,,jikyuuala,0,1,1,0,1,1,0,0,1,1,1,0
15228,,,prixtwt,0,1,1,0,1,1,0,0,1,1,1,0
15229,,,Martaaaaa,0,1,1,0,1,1,0,0,1,1,1,0
15230,,,hlake72,0,1,1,0,1,1,0,0,1,1,1,0
15231,,,Iserith_,0,2,2,0,2,2,0,0,1,1,1,0
15232,,,MEMEEXP36267285,0,1,1,0,1,1,0,0,1,1,1,0
15233,,,freetangyi,0,1,1,0,1,1,0,0,1,1,1,0
15234,,,MazrulHisyem,0,1,1,0,1,1,0,0,1,1,1,0
15235,,,grant_ning,8,1,9,8,1,9,0.125,0.077957,0,0,0,0
15236,,,Rashlalala,0,1,1,0,1,1,0,0,1,1,1,0
15237,,,DayanaToapant13,0,1,1,0,1,1,0,0,1,1,1,0
15238,,,a_s_i_m1,0,1,1,0,1,1,0,0,1,1,1,0
15239,,,yssai_nne,0,1,1,0,1,1,0,0,1,1,1,0
15240,,,sun_morion_1,0,1,1,0,1,1,0,0,1,1,1,0
15241,,,underdog52,5,1,6,5,1,6,0.2,0.033436,0,0,0,0
15242,,,xueyutanhoe,0,1,1,0,1,1,0,0,1,1,1,0
15243,,,raviola_chow,0,2,2,0,2,2,0,0,1,1,1,0
15244,,,daegukingmyg,0,1,1,0,1,1,0,0,1,1,1,0
15245,,,aiai22190688,0,1,1,0,1,1,0,0,1,1,1,0
15246,,,stephestellar,3,1,4,3,1,4,0.333333,0.020061,0,0,0,0
15247,,,sunjayU_,0,1,1,0,1,1,0,0,1,1,1,0
15248,,,funkymny4,1,1,2,1,1,2,0,0.006687,0,0,0,0
15249,,,GUIDEDSETS,10,1,11,10,1,11,0.1,0.077354,0,0,0,0
15250,,,hooniewave,0,1,1,0,1,1,0,0,1,1,1,0
15251,,,iblamelauforth1,0,1,1,0,1,1,0,0,1,1,1,0
15252,,,the_kittiest,0,1,1,0,1,1,0,0,1,1,1,0
15253,,,soymilkdelight,0,1,1,0,1,1,0,0,1,1,1,0
15254,,,nik3135,0,1,1,0,1,1,0,0,1,1,1,0
15255,,,zalaluvsreki,1,2,3,1,2,3,0.5,0.006687,1,1,1,0
15256,,,sydsmama1997,1,2,3,1,2,3,0.5,0.006687,1,1,1,0
15257,,,Savvyy519,1,2,3,1,2,3,0.5,0.006687,1,1,1,0
15258,,,virgineatersawa,3,1,4,3,1,4,0.333333,0.020061,0,0,0,0
15259,,,quveen_,0,1,1,0,1,1,0,0,1,1,1,0
15260,,,jinyolove,0,1,1,0,1,1,0,0,1,1,1,0
15261,,,LindyRocha,4,1,5,4,1,5,0.25,0.026749,0,0,0,0
15262,,,bwilder67,0,1,1,0,1,1,0,0,1,1,1,0
15263,,,byunpathy,2,1,3,2,1,3,0.5,0.013374,0,0,0,0
15264,,,kindlywest,0,1,1,0,1,1,0,0,1,1,1,0
15265,,,RosemarieTishe1,9,1,10,9,1,10,0.111111,0.062911,0,0,0,0
15266,,,SelahttinYagc,0,1,1,0,1,1,0,0,1,1,1,0
15267,,,dianeinilm,0,1,1,0,1,1,0,0,1,1,1,0
15268,,,shueen_shin,1,1,2,1,1,2,0,0.00396,1,1,1,1
15269,,,RaviVS007,0,1,1,0,1,1,0,0,1,1,1,0
15270,,,pankass_black,0,1,1,0,1,1,0,0,1,1,1,0
15271,,,alf_yakusa,0,1,1,0,1,1,0,0,1,1,1,0
15272,,,mybabykimtae,0,1,1,0,1,1,0,0,1,1,1,0
15273,,,LJLasalle,8,1,9,9,2,11,0.125,0.053497,0,0,0,0
15274,,,joonwithluvvs,0,1,1,0,1,1,0,0,1,1,1,0
15275,,,melico24,4,1,5,4,1,5,0.25,0.026749,0,0,0,0
15276,,,jinxeptor,0,1,1,0,1,1,0,0,1,1,1,0
15277,,,yilia_leee,0,1,1,0,1,1,0,0,1,1,1,0
15278,,,GhosFae,1,3,4,1,3,4,0.333333,0.006687,1,1,1,0
15279,,,nakulguptamdi,0,1,1,0,1,1,0,0,1,1,1,0
15280,,,mayukii21,0,1,1,0,1,1,0,0,1,1,1,0
15281,,,bryx333,0,1,1,0,1,1,0,0,1,1,1,0
15282,,,FaithAnnWords,5,1,6,5,1,6,0.2,0.033436,0,0,0,0
15283,,,taevloml,0,1,1,0,1,1,0,0,1,1,1,0
15284,,,tedregencia,3,1,4,3,1,4,0.333333,0.020061,0,0,0,0
15285,,,uratch1,0,1,1,0,1,1,0,0,1,1,1,0
15286,,,toooeeecheese,0,1,1,0,1,1,0,0,1,1,1,0
15287,,,gothobito,13,1,14,14,1,15,0.076923,0.090427,0,0,0,0
15288,,,kayseeingsparks,0,1,1,0,1,1,0,0,1,1,1,0
15289,,,utopiados,0,1,1,0,1,1,0,0,1,1,1,0
15290,,,SidleV,0,1,1,0,1,1,0,0,1,1,1,0
15291,,,HelenLeeBooks,0,1,1,0,1,1,0,0,1,1,1,0
15292,,,AshleyW06729738,0,1,1,0,1,1,0,0,1,1,1,0
15293,,,jiminjooheonn,0,1,1,0,1,1,0,0,1,1,1,0
15294,,,darling_2night,0,1,1,0,1,1,0,0,1,1,1,0
15295,,,jhopehose0k,0,1,1,0,1,1,0,0,1,1,1,0
15296,,,gummy_smile11,0,2,2,0,3,3,0,0,1,1,1,0
15297,,,napes1039,0,1,1,0,1,1,0,0,1,1,1,0
15298,,,cottoncider,9,1,10,10,1,11,0.111111,0.063679,0,0,0,0
15299,,,wntrsimp,0,1,1,0,1,1,0,0,1,1,1,0
15300,,,mafecp4,0,1,1,0,1,1,0,0,1,1,1,0
15301,,,ryujisoo95,0,1,1,0,1,1,0,0,1,1,1,0
15302,,,modernprometheo,0,1,1,0,1,1,0,0,1,1,1,0
15303,,,CSoughtflower,0,1,1,0,1,1,0,0,1,1,1,0
15304,,,jinlaquiles,0,1,1,0,1,1,0,0,1,1,1,0
15305,,,William__III,5,1,6,5,1,6,0.2,0.033436,0,0,0,0
15306,,,ElReyLeonSoy,0,1,1,0,1,1,0,0,1,1,1,0
15307,,,virtuous_fox,0,1,1,0,1,1,0,0,1,1,1,0
15308,,,jadecloudss,0,1,1,0,1,1,0,0,1,1,1,0
15309,,,69sean1,0,1,1,0,1,1,0,0,1,1,1,0
15310,,,iceheller,3,1,4,3,1,4,0.333333,0.020061,0,0,0,0
15311,,,4WheelWorkOut,0,1,1,0,1,1,0,0,1,1,1,0
15312,,,agustdsbaby,2,1,3,2,1,3,0.5,0.013374,0,0,0,0
15313,,,mimi87228220,0,1,1,0,1,1,0,0,1,1,1,0
15314,,,MsbySupremacy,4,1,5,4,1,5,0.25,0.026749,0,0,0,0
15315,,,wintersweet_s,0,1,1,0,1,1,0,0,1,1,1,0
15316,,,abanannie,0,1,1,0,1,1,0,0,1,1,1,0
15317,,,NOdisisPATRICK,0,1,1,0,1,1,0,0,1,1,1,0
15318,,,burpingchirds,4,1,5,4,1,5,0.25,0.026749,0,0,0,0
15319,,,daemonyg,0,1,1,0,1,1,0,0,1,1,1,0
15320,,,tenninkassoudai,0,1,1,0,1,1,0,0,1,1,1,0
15321,,,peachalpacas,0,1,1,0,1,1,0,0,1,1,1,0
15322,,,Steve_Gibbs19,1,1,2,1,1,2,0,0.006687,0,0,0,0
15323,,,nody_meow,0,1,1,0,1,1,0,0,4,0.4,0.520833,0
15324,,,myonlykimjongin,0,2,2,0,3,3,0,0,4,0.454545,0.616667,0
15325,,,crashalan,0,1,1,0,1,1,0,0,4,0.4,0.520833,0
15326,,,MandarinNYC616,11,1,12,13,1,14,0.090909,0.073559,0,0,0,0
15327,,,trippyandcolors,0,1,1,0,2,2,0,0,1,1,1,0
15328,,,petricherie,0,1,1,0,1,1,0,0,1,1,1,0
15329,,,jinniesbae,0,1,1,0,1,1,0,0,1,1,1,0
15330,,,greasewoodbloom,0,1,1,0,1,1,0,0,1,1,1,0
15331,,,givtolive,0,1,1,0,1,1,0,0,1,1,1,0
15332,,,simplyycornelia,0,1,1,0,1,1,0,0,1,1,1,0
15333,,,rebs__chan,13,1,14,13,1,14,0.076923,0.107898,0,0,0,0
15334,,,anmisya1969,0,1,1,0,1,1,0,0,1,1,1,0
15335,,,Nishyyy785,0,1,1,0,1,1,0,0,1,1,1,0
15336,,,takoyakoo,0,1,1,0,1,1,0,0,1,1,1,0
15337,,,kookyent,0,1,1,0,1,1,0,0,1,1,1,0
15338,,,pat_scharmberg,0,1,1,0,1,1,0,0,1,1,1,0
15339,,,mashibahi,0,1,1,0,1,1,0,0,1,1,1,0
15340,,,KSteph_C,0,1,1,0,1,1,0,0,1,1,1,0
15341,,,brlrcr45,0,1,1,0,1,1,0,0,1,1,1,0
15342,,,dongwinwu,0,1,1,0,1,1,0,0,1,1,1,0
15343,,,corvettelady50,0,1,1,0,1,1,0,0,1,1,1,0
15344,,,yu_jaehyun,5,1,6,5,1,6,0.2,0.03693,0,0,0,0
15345,,,cchowso,0,1,1,0,1,1,0,0,1,1,1,0
15346,,,beommintindahan,0,1,1,0,1,1,0,0,1,1,1,0
15347,,,oky_um,0,1,1,0,1,1,0,0,1,1,1,0
15348,,,tksubunitpls,0,1,1,0,1,1,0,0,1,1,1,0
15349,,,aad34210,0,1,1,0,1,1,0,0,1,1,1,0
15350,,,PeaceMessenger1,0,1,1,0,1,1,0,0,1,1,1,0
15351,,,LindaSokolowski,0,1,1,0,1,1,0,0,1,1,1,0
15352,,,kolipokieh,2,1,3,2,1,3,0.5,0.013374,0,0,0,0
15353,,,nahceneej,0,1,1,0,1,1,0,0,1,1,1,0
15354,,,sincostango,2,1,3,2,1,3,0.5,0.013374,0,0,0,0
15355,,,myeongfairy,0,2,2,0,2,2,0,0,1,1,1,0
15356,,,Loreal_7401,8,1,9,8,1,9,0.125,0.074582,0,0,0,0
15357,,,linzgonerogue,0,1,1,0,1,1,0,0,1,1,1,0
15358,,,calikodzuken,0,1,1,0,1,1,0,0,1,1,1,0
15359,,,TinaConstantine,0,1,1,0,1,1,0,0,1,1,1,0
15360,,,nicolovjin,0,1,1,0,1,1,0,0,1,1,1,0
15361,,,AbundantAntonio,0,1,1,0,1,1,0,0,1,1,1,0
15362,,,kitakonno,0,1,1,0,1,1,0,0,1,1,1,0
15363,,,doIIspace,1,1,2,1,1,2,0,0.006687,0,0,0,0
15364,,,ConradLaskowski,0,1,1,0,1,1,0,0,1,1,1,0
15365,,,bekkybird,2,1,3,2,1,3,0.5,0.013374,0,0,0,0
15366,,,iluvbeingahater,1,1,2,1,1,2,0,0.006687,0,0,0,0
15367,,,ryanberdan,6,1,7,6,1,7,0.166667,0.040123,0,0,0,0
15368,,,BlueStarCaptain,0,1,1,0,1,1,0,0,1,1,1,0
15369,,,D18_,0,2,2,0,2,2,0,0,1,1,1,0
15370,,,gothotjin,0,1,1,0,1,1,0,0,1,1,1,0
15371,,,daybyharuu,0,1,1,0,1,1,0,0,1,1,1,0
15372,,,Sha27283777,4,1,5,4,1,5,0.25,0.026749,0,0,0,0
15373,,,Itz_Teairra,0,1,1,0,1,1,0,0,1,1,1,0
15374,,,gratianon,0,1,1,0,1,1,0,0,1,1,1,0
15375,,,bluebearcafe1,0,1,1,0,1,1,0,0,1,1,1,0
15376,,,Aknae09,0,1,1,0,1,1,0,0,1,1,1,0
15377,,,fabjulia,1,1,2,1,1,2,0,0.006687,0,0,0,0
15378,,,MoshangUsa,3,1,4,4,1,5,0.333333,0.020061,0,0,0,0
15379,,,yoinksthefag,0,1,1,0,1,1,0,0,1,1,1,0
15380,,,testAsus2,0,1,1,0,2,2,0,0,1,1,1,0
15381,,,JustLizabiz,2,1,3,2,1,3,0.5,0.013374,0,0,0,0
15382,,,monamour1013,0,1,1,0,1,1,0,0,1,1,1,0
15383,,,LightfootInHwd,5,1,6,5,1,6,0.2,0.03693,0,0,0,0
15384,,,ChloeLeshner,1,2,3,1,2,3,0.5,0.006687,1,1,1,0
15385,,,mimingsuu,0,2,2,0,2,2,0,0,1,1,1,0
15386,,,grittyyas,0,1,1,0,1,1,0,0,1,1,1,0
15387,,,VickiVanessa,1,1,2,1,1,2,0,0.006687,0,0,0,0
15388,,,sobasamii,0,1,1,0,1,1,0,0,1,1,1,0
15389,,,OhWvMiFl,1,1,2,1,1,2,0,0.006687,0,0,0,0
15390,,,wherbkat,5,1,6,5,1,6,0.2,0.033436,0,0,0,0
15391,,,priti30,0,1,1,0,1,1,0,0,1,1,1,0
15392,,,AlisaUnwritten,0,1,1,0,1,1,0,0,1,1,1,0
15393,,,LeiZhan19034394,3,1,4,3,1,4,0.333333,0.020061,0,0,0,0
15394,,,DamisCrabs,0,1,1,0,1,1,0,0,1,1,1,0
15395,,,wngshxn,4,1,5,4,1,5,0.25,0.04422,0,0,0,0
15396,,,MignonBambi,0,1,1,0,1,1,0,0,1,1,1,0
15397,,,jinsfart,0,1,1,0,1,1,0,0,1,1,1,0
15398,,,IsA_jm12,0,1,1,0,1,1,0,0,1,1,1,0
15399,,,melokooton,0,1,1,0,1,1,0,0,1,1,1,0
15400,,,KWONCRUSH,2,1,3,2,1,3,0.5,0.013374,0,0,0,0
15401,,,refaginator,1,1,2,1,1,2,0,0.006687,0,0,0,0
15402,,,ItsMeKaidinn,3,1,4,3,1,4,0.333333,0.020061,0,0,0,0
15403,,,ador_roty,0,1,1,0,1,1,0,0,1,1,1,0
15404,,,tkrvbaji,2,1,3,2,1,3,0.5,0.027351,0,0,0,0
15405,,,jihyoswh0re,0,1,1,0,1,1,0,0,2,0.666667,0.75,0
15406,,,bubbleemarrk,0,1,1,0,1,1,0,0,2,0.666667,0.75,0
15407,,,yessi_writes,0,1,1,0,1,1,0,0,2,0.666667,0.75,0
15408,,,AquaYuzu,0,1,1,0,1,1,0,0,2,0.666667,0.75,0
15409,,,natalisalazar_,0,1,1,0,1,1,0,0,2,0.6,0.666667,0
15410,,,TracyGreen24,0,1,1,0,1,1,0,0,2,0.6,0.666667,0
15411,,,bunnygojo,12,1,13,12,1,13,0.083333,0.080246,0,0,0,0
15412,,,tarbel,0,1,1,0,1,1,0,0,1,1,1,0
15413,,,mandu_riki,0,1,1,0,1,1,0,0,1,1,1,0
15414,,,KaidaStrife,0,1,1,0,1,1,0,0,1,1,1,0
15415,,,ayyyandi,0,1,1,0,1,1,0,0,1,1,1,0
15416,,,yliyoo,0,1,1,0,1,1,0,0,1,1,1,0
15417,,,mamemame231,0,1,1,0,1,1,0,0,1,1,1,0
15418,,,starlightbbyxo,0,1,1,0,1,1,0,0,1,1,1,0
15419,,,luminedefender,3,1,4,3,1,4,0.333333,0.020061,0,0,0,0
15420,,,EmilyHLee,0,1,1,0,1,1,0,0,1,1,1,0
15421,,,hamashoko,0,1,1,0,1,1,0,0,1,1,1,0
15422,,,getsit,1,1,2,1,1,2,0,0.006687,0,0,0,0
15423,,,splashedpretty,3,1,4,3,1,4,0.333333,0.020061,0,0,0,0
15424,,,yoruing,0,2,2,0,2,2,0,0,1,1,1,0
15425,,,ChanPeony1,0,1,1,0,1,1,0,0,1,1,1,0
15426,,,moistycheez,11,1,12,11,1,12,0.090909,0.098018,0,0,0,0
15427,,,JunJunieh,0,1,1,0,1,1,0,0,1,1,1,0
15428,,,ElaineT06427044,5,2,7,5,2,7,0.166667,0.033436,1,1,1,4
15429,,,catboynoctis,0,1,1,0,1,1,0,0,1,1,1,0
15430,,,dlcyun,0,1,1,0,1,1,0,0,1,1,1,0
15431,,,_wangxian_1,0,1,1,0,1,1,0,0,1,1,1,0
15432,,,universeyourls,0,1,1,0,1,1,0,0,1,1,1,0
15433,,,arpie05,14,1,15,14,1,15,0.071429,0.09362,0,0,0,0
15434,,,222taeil,0,1,1,0,1,1,0,0,1,1,1,0
15435,,,gcfslix,0,1,1,0,1,1,0,0,1,1,1,0
15436,,,ChrissyMHH,0,1,1,0,1,1,0,0,1,1,1,0
15437,,,hazysootings,0,1,1,0,1,1,0,0,1,1,1,0
15438,,,BayBrigade,0,1,1,0,1,1,0,0,1,1,1,0
15439,,,hemjhaveri,0,1,1,0,1,1,0,0,1,1,1,0
15440,,,gyvylnax,0,1,1,0,1,1,0,0,1,1,1,0
15441,,,buntartz,0,1,1,0,1,1,0,0,1,1,1,0
15442,,,roncapus,0,1,1,0,1,1,0,0,1,1,1,0
15443,,,lemmeseeee,0,1,1,0,1,1,0,0,1,1,1,0
15444,,,jecht_man71,0,1,1,0,1,1,0,0,1,1,1,0
15445,,,N4SGOR,0,1,1,0,1,1,0,0,1,1,1,0
15446,,,alkah3stry,0,1,1,0,1,1,0,0,1,1,1,0
15447,,,KSJblogs,4,1,5,4,1,5,0.25,0.026749,0,0,0,0
15448,,,sasukepill,1,1,2,1,1,2,0,0.006687,0,0,0,0
15449,,,vantedolls,1,1,2,1,1,2,0,0.006687,0,0,0,0
15450,,,ProblemChildFil,6,1,7,6,1,7,0.166667,0.040123,0,0,0,0
15451,,,atsumuishot,0,1,1,0,1,1,0,0,1,1,1,0
15452,,,ShirroSan125,0,1,1,0,1,1,0,0,1,1,1,0
15453,,,euBYRocgL6hgbeV,0,1,1,0,1,1,0,0,1,1,1,0
15454,,,MarkAiton2,0,1,1,0,1,1,0,0,1,1,1,0
15455,,,WandaBrady20,2,1,3,2,1,3,0.5,0.013374,0,0,0,0
15456,,,cloudanity,0,1,1,0,1,1,0,0,1,1,1,0
15457,,,Hawaiiantrash_,6,1,7,6,1,7,0.166667,0.040123,0,0,0,0
15458,,,anajumoon,0,1,1,0,1,1,0,0,1,1,1,0
15459,,,mox_ponce,0,1,1,0,1,1,0,0,1,1,1,0
15460,,,bunnisoobin,0,1,1,0,1,1,0,0,1,1,1,0
15461,,,sokigf,0,1,1,0,1,1,0,0,1,1,1,0
15462,,,Rubli11,0,1,1,0,1,1,0,0,1,1,1,0
15463,,,RANNIESUSISDEAD,9,1,10,9,1,10,0.111111,0.067173,0,0,0,0
15464,,,hanyudolls,0,1,1,0,1,1,0,0,1,1,1,0
15465,,,tsts240,0,1,1,0,1,1,0,0,1,1,1,0
15466,,,deimmz,0,1,1,0,1,1,0,0,1,1,1,0
15467,,,komala_hayes,0,1,1,0,1,1,0,0,1,1,1,0
15468,,,_adeedee,0,1,1,0,1,1,0,0,1,1,1,0
15469,,,jailpee,2,1,3,2,1,3,0.5,0.013374,0,0,0,0
15470,,,notabbrownn,0,1,1,0,1,1,0,0,1,1,1,0
15471,,,jngwvns,5,1,6,5,1,6,0.2,0.03693,0,0,0,0
15472,,,bugcatchings,0,1,1,0,1,1,0,0,1,1,1,0
15473,,,cblee_cblee,1,2,3,1,2,3,0.5,0.006687,1,1,1,0
15474,,,2FUYAO,0,1,1,0,1,1,0,0,1,1,1,0
15475,,,johnscholle,6,1,7,7,1,8,0.166667,0.040123,0,0,0,0
15476,,,mostillusive,0,1,1,0,2,2,0,0,1,1,1,0
15477,,,Restingrocklady,0,1,1,0,1,1,0,0,1,1,1,0
15478,,,Myassi1902,0,1,1,0,1,1,0,0,1,1,1,0
15479,,,JC38466948,0,2,2,0,2,2,0,0,1,1,1,0
15480,,,stevenusdavis,2,1,3,2,1,3,0.5,0.013374,0,0,0,0
15481,,,ikoovs,0,1,1,0,1,1,0,0,1,1,1,0
15482,,,taejuuls,0,1,1,0,1,1,0,0,4,0.4,0.520833,0
15483,,,ElRocco337,8,1,9,8,1,9,0.125,0.120473,0,0,0,0
15484,,,Lanuwis,0,1,1,0,1,1,0,0,1,1,1,0
15485,,,Rgc92890,0,1,1,0,1,1,0,0,1,1,1,0
15486,,,aquaventus2002,0,1,1,0,1,1,0,0,1,1,1,0
15487,,,as_the_universe,0,1,1,0,1,1,0,0,1,1,1,0
15488,,,ultweirdo,0,7,7,0,7,7,0,0,1,1,1,0
15489,,,sarahpasta,0,1,1,0,1,1,0,0,1,1,1,0
15490,,,Fanny_LY_,0,1,1,0,1,1,0,0,1,1,1,0
15491,,,aniwam,0,1,1,0,1,1,0,0,1,1,1,0
15492,,,221Bee,3,1,4,3,1,4,0.333333,0.020061,0,0,0,0
15493,,,ScribblesITM,0,1,1,0,1,1,0,0,1,1,1,0
15494,,,HIMvol666,0,1,1,0,1,1,0,0,1,1,1,0
15495,,,WGNRadioNews,5,1,6,5,1,6,0.2,0.040424,0,0,0,0
15496,,,HelenaVBeat,0,1,1,0,1,1,0,0,1,1,1,0
15497,,,jyanne_423,0,1,1,0,1,1,0,0,1,1,1,0
15498,,,elizgeise,0,1,1,0,1,1,0,0,1,1,1,0
15499,,,sarahzmadsen,21,1,22,21,1,22,0.047619,0.163696,0,0,0,0
15500,,,itsopiee,0,1,1,0,1,1,0,0,1,1,1,0
15501,,,_thv_2002,0,1,1,0,1,1,0,0,1,1,1,0
15502,,,ejungw0n,0,1,1,0,1,1,0,0,1,1,1,0
15503,,,yukko_1022,0,1,1,0,1,1,0,0,1,1,1,0
15504,,,fenali45239512,1,2,3,1,2,3,0.5,0.006687,1,1,1,0
15505,,,senraba,0,1,1,0,1,1,0,0,1,1,1,0
15506,,,urmomskpop,0,1,1,0,1,1,0,0,1,1,1,0
15507,,,MarthaDu,0,1,1,0,1,1,0,0,1,1,1,0
15508,,,ConnaghanGross,0,1,1,0,1,1,0,0,1,1,1,0
15509,,,wohvmn,7,1,8,7,1,8,0.142857,0.04681,0,0,0,0
15510,,,FooxyWolf,0,1,1,0,1,1,0,0,1,1,1,0
15511,,,Mariela17153719,0,1,1,0,1,1,0,0,1,1,1,0
15512,,,randallboy83,0,1,1,0,1,1,0,0,1,1,1,0
15513,,,hiyyihfairyy,0,1,1,0,1,1,0,0,1,1,1,0
15514,,,LeighannStrollo,1,1,2,1,1,2,0,0.006687,0,0,0,0
15515,,,RealDillonRW,0,1,1,0,1,1,0,0,1,1,1,0
15516,,,ktyla8,0,1,1,0,1,1,0,0,1,1,1,0
15517,,,smol_tangerine,1,1,2,1,1,2,0,0.006687,0,0,0,0
15518,,,AiflexCassandra,1,1,2,1,1,2,0,0.006687,0,0,0,0
15519,,,saintez,2,1,3,3,2,5,0.5,0.013374,0,0,0,0
15520,,,suibjan,1,1,2,1,1,2,0,0.006687,0,0,0,0
15521,,,b__matson,4,1,5,4,1,5,0.25,0.026749,0,0,0,0
15522,,,nogisige,0,1,1,0,1,1,0,0,1,1,1,0
15523,,,orangejiminist,0,1,1,0,1,1,0,0,1,1,1,0
15524,,,Michael91882018,0,1,1,0,1,1,0,0,1,1,1,0
15525,,,jjclose,2,1,3,2,1,3,0.5,0.013374,0,0,0,0
15526,,,missyp89,1,1,2,1,1,2,0,0.006687,0,0,0,0
15527,,,zlykkkk,0,1,1,0,1,1,0,0,1,1,1,0
15528,,,telegram_spam,0,1,1,0,1,1,0,0,1,1,1,0
15529,,,iFORDAEREN,0,1,1,0,1,1,0,0,1,1,1,0
15530,,,youngktkm,2,1,3,2,1,3,0.5,0.018829,0,0,0,0
15531,,,NinoGuz,0,1,1,0,1,1,0,0,1,1,1,0
15532,,,yoshimiese,0,1,1,0,1,1,0,0,1,1,1,0
15533,,,isteintraum,0,1,1,0,1,1,0,0,1,1,1,0
15534,,,akarident,0,1,1,0,1,1,0,0,1,1,1,0
15535,,,Justin_Halaska,0,1,1,0,1,1,0,0,1,1,1,0
15536,,,meIoday6,0,1,1,0,1,1,0,0,1,1,1,0
15537,,,strwbrrylixxie,0,2,2,0,2,2,0,0,1,1,1,0
15538,,,ribontotuki,0,1,1,0,1,1,0,0,1,1,1,0
15539,,,maiko_always,0,1,1,0,1,1,0,0,1,1,1,0
15540,,,tunghkk,0,1,1,0,1,1,0,0,1,1,1,0
15541,,,fairyvalent,0,1,1,0,1,1,0,0,1,1,1,0
15542,,,TheSahuNews,6,1,7,6,1,7,0.166667,0.050606,0,0,0,0
15543,,,Kaung_Min_Khank,0,1,1,0,1,1,0,0,1,1,1,0
15544,,,ruicover,0,1,1,0,1,1,0,0,1,1,1,0
15545,,,iocmedia,0,1,1,0,1,1,0,0,1,1,1,0
15546,,,sweatyboi,3,1,4,3,1,4,0.333333,0.020061,0,0,0,0
15547,,,cherryyyuto,0,2,2,0,2,2,0,0,1,1,1,0
15548,,,montran97,0,1,1,0,1,1,0,0,1,1,1,0
15549,,,kattlizz_,0,1,1,0,1,1,0,0,3,0.5,0.525641,0
15550,,,jmarieray,3,1,4,3,1,4,0.333333,0.020061,0,0,0,0
15551,,,Crassicollis,0,1,1,0,1,1,0,0,2,0.666667,0.75,0
15552,,,Bustamante1981,0,1,1,0,1,1,0,0,2,0.666667,0.75,0
15553,,,heavycrownpress,9,1,10,10,1,11,0.111111,0.060184,0,0,0,0
15554,,,IsabellaG_26,0,1,1,0,1,1,0,0,1,1,1,0
15555,,,akicoao,0,1,1,0,1,1,0,0,1,1,1,0
15556,,,saunders_alex,0,1,1,0,1,1,0,0,1,1,1,0
15557,,,AubreeMittel,0,1,1,0,1,1,0,0,1,1,1,0
15558,,,ptgberry,0,1,1,0,1,1,0,0,1,1,1,0
15559,,,CAcatlady,8,1,9,8,1,9,0.125,0.088951,0,0,0,0
15560,,,Jasmin_Mae98,0,1,1,0,1,1,0,0,1,1,1,0
15561,,,yutazen_,0,1,1,0,1,1,0,0,1,1,1,0
15562,,,View_Patimaporn,0,1,1,0,1,1,0,0,1,1,1,0
15563,,,NatashaNaik13,0,1,1,0,1,1,0,0,1,1,1,0
15564,,,barb_hill,0,1,1,0,1,1,0,0,1,1,1,0
15565,,,shawnarchen,0,1,1,0,1,1,0,0,1,1,1,0
15566,,,CloudFish410,13,1,14,13,1,14,0,0.051479,1,1,1,13
15567,,,sheila40657518,9,1,10,9,1,10,0.111111,0.060184,0,0,0,0
15568,,,YuHaanYu,0,1,1,0,1,1,0,0,1,1,1,0
15569,,,Sidnerita,0,1,1,0,1,1,0,0,1,1,1,0
15570,,,pangaswpcy,0,1,1,0,1,1,0,0,1,1,1,0
15571,,,kthstigmaballs,0,1,1,0,1,1,0,0,1,1,1,0
15572,,,Rzaame,0,1,1,0,1,1,0,0,1,1,1,0
15573,,,mandy_gyu17,0,3,3,0,3,3,0,0,1,1,1,0
15574,,,catie_lyons,0,1,1,0,1,1,0,0,1,1,1,0
15575,,,GAMoons,1,1,2,1,1,2,0,0.006687,0,0,0,0
15576,,,rreedsing,3,1,4,3,1,4,0.333333,0.020061,0,0,0,0
15577,,,Drewtendo64,0,1,1,0,1,1,0,0,1,1,1,0
15578,,,92kkyul,8,1,9,8,1,9,0.125,0.053497,0,0,0,0
15579,,,puppystan1,0,1,1,0,1,1,0,0,1,1,1,0
15580,,,ganyurealgf,0,1,1,0,1,1,0,0,1,1,1,0
15581,,,deannalaquian,0,1,1,0,1,1,0,0,1,1,1,0
15582,,,WoodyWoodcaster,0,1,1,0,1,1,0,0,1,1,1,0
15583,,,alphabakugou,0,1,1,0,1,1,0,0,1,1,1,0
15584,,,C_Bright1988,5,1,6,5,1,6,0.2,0.033436,0,0,0,0
15585,,,RuinDig,0,1,1,0,1,1,0,0,1,1,1,0
15586,,,jdwest20,0,1,1,0,1,1,0,0,1,1,1,0
15587,,,JoleighKirkland,0,1,1,0,1,1,0,0,1,1,1,0
15588,,,bbylilspoon,4,1,5,4,1,5,0.25,0.026749,0,0,0,0
15589,,,jenbertlaw,0,1,1,0,1,1,0,0,1,1,1,0
15590,,,jjstoller,0,1,1,0,1,1,0,0,1,1,1,0
15591,,,stefunnyfv,0,1,1,0,1,1,0,0,1,1,1,0
15592,,,12SportsAZ,1,1,2,1,1,2,0,0.006687,0,0,0,0
15593,,,12News,2,1,3,2,1,3,0.5,0.013374,0,0,0,0
15594,,,kyungsoosputo,0,1,1,0,1,1,0,0,1,1,1,0
15595,,,RacJr63,2,1,3,2,1,3,0.5,0.013374,0,0,0,0
15596,,,atzologist,0,1,1,0,1,1,0,0,1,1,1,0
15597,,,CBCOlympics,11,1,12,11,1,12,0.090909,0.101751,0,0,0,0
15598,,,maymal,0,1,1,0,1,1,0,0,1,1,1,0
15599,,,ojiibikaawi,0,1,1,0,1,1,0,0,1,1,1,0
15600,,,fayevallentinee,0,1,1,0,1,1,0,0,1,1,1,0
15601,,,yoonflan,0,1,1,0,1,1,0,0,1,1,1,0
15602,,,jaewhit,0,1,1,0,1,1,0,0,1,1,1,0
15603,,,BrandiLOsborne,0,1,1,0,1,1,0,0,1,1,1,0
15604,,,alec_flanagan,0,1,1,0,1,1,0,0,1,1,1,0
15605,,,rachel_ofcourse,3,1,4,3,1,4,0.333333,0.020061,0,0,0,0
15606,,,danibeans001,0,1,1,0,1,1,0,0,1,1,1,0
15607,,,iluvlucy922,0,1,1,0,1,1,0,0,1,1,1,0
15608,,,GODSGLORYGLORIA,5,1,6,5,1,6,0.2,0.033436,0,0,0,0
15609,,,MichelleBruton,0,1,1,0,1,1,0,0,1,1,1,0
15610,,,yuria_krn12,0,1,1,0,1,1,0,0,1,1,1,0
15611,,,peaceliberty,0,1,1,0,1,1,0,0,1,1,1,0
15612,,,Breanda_Newell,0,1,1,0,1,1,0,0,1,1,1,0
15613,,,festivesadboi,0,1,1,0,1,1,0,0,1,1,1,0
15614,,,colraz1028,0,1,1,0,1,1,0,0,1,1,1,0
15615,,,gainsthighs,0,1,1,0,1,1,0,0,1,1,1,0
15616,,,Iuisaaramirezz,0,1,1,0,1,1,0,0,1,1,1,0
15617,,,everneon,0,1,1,0,1,1,0,0,1,1,1,0
15618,,,lineysworld,0,1,1,0,1,1,0,0,1,1,1,0
15619,,,kevinsxu,1,1,2,1,1,2,0,0.006687,0,0,0,0
15620,,,alyroe,1,1,2,1,1,2,0,0.006687,0,0,0,0
15621,,,zutsinny,0,1,1,0,1,1,0,0,2,0.666667,0.75,0
15622,,,agwstrivia,0,1,1,0,1,1,0,0,2,0.666667,0.75,0
15623,,,evashougouki,0,1,1,0,1,1,0,0,2,0.666667,0.75,0
15624,,,lynsuze,0,1,1,0,1,1,0,0,2,0.666667,0.75,0
15625,,,Brigiittte_,0,1,1,0,1,1,0,0,1,1,1,0
15626,,,peachso35084934,0,1,1,0,1,1,0,0,1,1,1,0
15627,,,omochi_sky_,3,1,4,3,1,4,0.333333,0.020061,0,0,0,0
15628,,,BrogdonRalph,0,1,1,0,1,1,0,0,1,1,1,0
15629,,,vicki_Aspenb,0,1,1,0,1,1,0,0,1,1,1,0
15630,,,getoudealer,0,1,1,0,1,1,0,0,4,0.4,0.520833,0
15631,,,natiushkash,0,1,1,0,1,1,0,0,4,0.4,0.520833,0
15632,,,cambalaches,0,1,1,0,1,1,0,0,4,0.4,0.520833,0
15633,,,trudygonzales,0,1,1,0,1,1,0,0,4,0.4,0.520833,0
15634,,,REVEZ0NE,0,1,1,0,1,1,0,0,4,0.4,0.520833,0
15635,,,Limmered,0,1,1,0,1,1,0,0,4,0.4,0.520833,0
15636,,,SabsDodd,0,1,1,0,1,1,0,0,4,0.4,0.520833,0
15637,,,duetbusan,0,1,1,0,1,1,0,0,4,0.4,0.520833,0
15638,,,B4EJINIE,3,1,4,3,1,4,0.333333,0.023556,0,0,0,0
15639,,,monkey__127,0,1,1,0,1,1,0,0,1,1,1,0
15640,,,NE0YUT4S,4,1,5,4,1,5,0.25,0.026749,0,0,0,0
15641,,,IDNurseChristie,0,1,1,0,1,1,0,0,1,1,1,0
15642,,,unsavedegg,0,1,1,0,1,1,0,0,1,1,1,0
15643,,,serendipities,2,1,3,2,1,3,0.5,0.013374,0,0,0,0
15644,,,MVNVSVMV,0,1,1,0,1,1,0,0,1,1,1,0
15645,,,Scotty_Fit,3,1,4,3,1,4,0.333333,0.020061,0,0,0,0
15646,,,arv3nsis,1,1,2,1,1,2,0,0.006687,0,0,0,0
15647,,,MomsDemandFan,3,1,4,3,1,4,0.333333,0.020061,0,0,0,0
15648,,,youshouldstan,0,2,2,0,2,2,0,0,1,1,1,0
15649,,,ICDEB,1,1,2,1,1,2,0,0.006687,0,0,0,0
15650,,,knjbIackswan,0,1,1,0,1,1,0,0,1,1,1,0
15651,,,jjwanshope,1,1,2,1,1,2,0,0.006687,0,0,0,0
15652,,,marziebarz,1,1,2,1,1,2,0,0.006687,0,0,0,0
15653,,,beeriems,5,1,6,5,1,6,0.2,0.033436,0,0,0,0
15654,,,luvsicpart3,0,1,1,0,1,1,0,0,1,1,1,0
15655,,,pyrorbl,0,1,1,0,1,1,0,0,1,1,1,0
15656,,,KatSimkhovitch,0,1,1,0,1,1,0,0,1,1,1,0
15657,,,arcangelocoreli,0,1,1,0,1,1,0,0,1,1,1,0
15658,,,mimiverso,0,1,1,0,1,1,0,0,2,0.666667,0.75,0
15659,,,poetyartist,7,1,8,9,2,11,0.142857,0.049537,0,0,0,0
15660,,,ewwgyu,1,1,2,1,1,2,0,0.00396,1,1,1,1
15661,,,predesti_nated,0,1,1,0,1,1,0,0,1,1,1,0
15662,,,itoshiikoto,0,2,2,0,2,2,0,0,2,0.75,0.833333,0
15663,,,Evilmeow_meow,0,1,1,0,1,1,0,0,1,1,1,0
15664,,,Tomfoolerysh,0,1,1,0,1,1,0,0,1,1,1,0
15665,,,ohjo_sama,0,2,2,0,2,2,0,0,2,0.666667,0.75,0
15666,,,bunnyboyaether,0,1,1,0,1,1,0,0,1,1,1,0
15667,,,KSN00S,0,1,1,0,1,1,0,0,1,1,1,0
15668,,,luvpjongseong,0,1,1,0,1,1,0,0,1,1,1,0
15669,,,barbatosblved,0,1,1,0,1,1,0,0,1,1,1,0
15670,,,Ithairu21,0,1,1,0,1,1,0,0,1,1,1,0
15671,,,hima1217story,0,1,1,0,1,1,0,0,1,1,1,0
15672,,,morallymaligned,3,1,4,4,1,5,0.333333,0.020061,0,0,0,0
15673,,,kissyrry28,0,1,1,0,1,1,0,0,1,1,1,0
15674,,,hrrysduvetcver,1,1,2,1,1,2,0,0.006687,0,0,0,0
15675,,,tteokbeomggyu,0,1,1,0,1,1,0,0,1,1,1,0
15676,,,shan_fost22,0,1,1,0,1,1,0,0,1,1,1,0
15677,,,dgrantdcanet,0,1,1,0,2,2,0,0,2,0.666667,0.75,0
15678,,,peerlessbun,0,1,1,0,1,1,0,0,2,0.666667,0.75,0
15679,,,yummimatcha,0,1,1,0,1,1,0,0,2,0.666667,0.75,0
15680,,,0X1FEV3R,0,1,1,0,1,1,0,0,2,0.666667,0.75,0
15681,,,MouaGeorge,0,1,1,0,1,1,0,0,2,0.666667,0.75,0
15682,,,MyPresident21,0,1,1,0,2,2,0,0,2,0.666667,0.75,0
15683,,,penultimatepen,0,1,1,0,1,1,0,0,2,0.666667,0.75,0
15684,,,dd_ryy,0,1,1,0,1,1,0,0,2,0.666667,0.75,0
15685,,,v94dbsmn9z21,0,1,1,0,1,1,0,0,2,0.666667,0.75,0
15686,,,DlABLlTO,0,1,1,0,1,1,0,0,2,0.666667,0.75,0
15687,,,bi_ni_,0,1,1,0,1,1,0,0,2,0.666667,0.75,0
15688,,,beomaegyo,0,1,1,0,1,1,0,0,2,0.666667,0.75,0
15689,,,TallTallDaddy,0,1,1,0,1,1,0,0,2,0.666667,0.75,0
15690,,,yuzuzuyou,0,1,1,0,1,1,0,0,2,0.666667,0.75,0
15691,,,CopyinCity,4,1,5,4,1,5,0.25,0.026749,0,0,0,0
15692,,,parkj_luv,0,1,1,0,1,1,0,0,1,1,1,0
15693,,,jiminny_cricket,0,1,1,0,1,1,0,0,1,1,1,0
15694,,,girlcapitolvt,0,1,1,0,1,1,0,0,1,1,1,0
15695,,,HELLOHONEBI,4,1,5,4,1,5,0.25,0.026749,0,0,0,0
15696,,,nikumarukko,0,1,1,0,1,1,0,0,1,1,1,0
15697,,,monoD2hopeworld,0,1,1,0,1,1,0,0,1,1,1,0
15698,,,frewsitatk,0,1,1,0,1,1,0,0,1,1,1,0
15699,,,CarlosS56434233,1,1,2,1,1,2,0,0.006687,0,0,0,0
15700,,,hanjitopia,6,1,7,6,1,7,0.166667,0.040123,0,0,0,0
15701,,,MizukiHirose_,0,1,1,0,1,1,0,0,1,1,1,0
15702,,,aprilmayjuneeee,0,1,1,0,1,1,0,0,1,1,1,0
15703,,,spin0346,0,1,1,0,1,1,0,0,1,1,1,0
15704,,,ventisceo,0,1,1,0,1,1,0,0,1,1,1,0
15705,,,AkiRa_100716,0,1,1,0,1,1,0,0,1,1,1,0
15706,,,shineemeal,8,1,9,8,1,9,0.125,0.053497,0,0,0,0
15707,,,ttaemaze,0,1,1,0,1,1,0,0,1,1,1,0
15708,,,a_edgin98,0,1,1,0,1,1,0,0,1,1,1,0
15709,,,ButterflyMom322,0,1,1,0,1,1,0,0,1,1,1,0
15710,,,ifuckingloveki1,0,1,1,0,1,1,0,0,1,1,1,0
15711,,,lillywithtwoLs,0,1,1,0,1,1,0,0,1,1,1,0
15712,,,amand_nha,0,1,1,0,1,1,0,0,1,1,1,0
15713,,,Kat_0435,0,1,1,0,1,1,0,0,1,1,1,0
15714,,,triniwoodstock,3,1,4,3,1,4,0.333333,0.030544,0,0,0,0
15715,,,lavendershifts,3,2,5,3,2,5,0.25,0.020061,1,1,1,2
15716,,,xiunshinebear,0,1,1,0,1,1,0,0,1,1,1,0
15717,,,dowdydiva,5,1,6,5,1,6,0.2,0.033436,0,0,0,0
15718,,,aferracion,0,1,1,0,1,1,0,0,1,1,1,0
15719,,,annegreengd,0,1,1,0,1,1,0,0,1,1,1,0
15720,,,TKillinMachine,0,1,1,0,1,1,0,0,1,1,1,0
15721,,,LukeyPoohs,0,1,1,0,1,1,0,0,1,1,1,0
15722,,,au_shareplicity,1,1,2,1,1,2,0,0.006687,0,0,0,0
15723,,,Tom_Winter,8,1,9,8,1,9,0.125,0.053497,0,0,0,0
15724,,,samanthabecket7,0,1,1,0,1,1,0,0,1,1,1,0
15725,,,ayeeeeemel,0,1,1,0,1,1,0,0,1,1,1,0
15726,,,6lliooill9,0,1,1,0,1,1,0,0,1,1,1,0
15727,,,LynnYou32049261,0,1,1,0,1,1,0,0,1,1,1,0
15728,,,faamulans,0,1,1,0,1,1,0,0,1,1,1,0
15729,,,jiaqiluv,0,1,1,0,1,1,0,0,1,1,1,0
15730,,,Wareaglebiol,0,1,1,0,1,1,0,0,1,1,1,0
15731,,,politicalHEDGE,4,1,5,4,1,5,0.25,0.026749,0,0,0,0
15732,,,kensyy_14,0,1,1,0,1,1,0,0,1,1,1,0
15733,,,HamletLuvr69,0,1,1,0,1,1,0,0,1,1,1,0
15734,,,wujuzip,2,1,3,2,1,3,0.5,0.013374,0,0,0,0
15735,,,jason_kai,0,1,1,0,1,1,0,0,1,1,1,0
15736,,,Lovlymae,3,1,4,3,1,4,0.333333,0.020061,0,0,0,0
15737,,,clickondetroit,4,1,5,4,1,5,0.25,0.026749,0,0,0,0
15738,,,shaan_ren,0,1,1,0,1,1,0,0,1,1,1,0
15739,,,ArtmuseumNews,0,1,1,0,1,1,0,0,1,1,1,0
15740,,,WrexBen,6,1,7,6,1,7,0.166667,0.040123,0,0,0,0
15741,,,bangtansbeaner,0,1,1,0,1,1,0,0,1,1,1,0
15742,,,Sally_hwy_,0,1,1,0,1,1,0,0,1,1,1,0
15743,,,AmericaFightHim,0,2,2,0,2,2,0,0,1,1,1,0
15744,,,LewisWalpoleLib,1,1,2,1,1,2,0,0.006687,0,0,0,0
15745,,,falIawaymv,1,1,2,1,1,2,0,0.006687,0,0,0,0
15746,,,_queerli,2,1,3,2,1,3,0.5,0.013374,0,0,0,0
15747,,,jrtrashno1,0,1,1,0,1,1,0,0,1,1,1,0
15748,,,paljuresji,1,1,2,1,1,2,0,0.006687,0,0,0,0
15749,,,MID0RIYAZ,4,1,5,4,1,5,0.25,0.026749,0,0,0,0
15750,,,bangtan_core,0,2,2,0,2,2,0,0,1,1,1,0
15751,,,AnidaChingu,0,1,1,0,1,1,0,0,1,1,1,0
15752,,,arseneito,0,1,1,0,1,1,0,0,1,1,1,0
15753,,,intlibecosoc,15,1,16,15,1,16,0.066667,0.121272,0,0,0,0
15754,,,swiftbabe,0,1,1,0,1,1,0,0,1,1,1,0
15755,,,itstheinnocent,0,1,1,0,1,1,0,0,1,1,1,0
15756,,,jasonemiller,0,1,1,0,1,1,0,0,1,1,1,0
15757,,,reirei0218,0,1,1,0,1,1,0,0,1,1,1,0
15758,,,PPegwin,0,1,1,0,1,1,0,0,1,1,1,0
15759,,,funny398,0,1,1,0,1,1,0,0,1,1,1,0
15760,,,delitchiin,0,1,1,0,1,1,0,0,1,1,1,0
15761,,,LaterMornings,0,1,1,0,1,1,0,0,1,1,1,0
15762,,,castawayindonny,0,1,1,0,1,1,0,0,1,1,1,0
15763,,,BL33PBL00PP,0,1,1,0,1,1,0,0,1,1,1,0
15764,,,peachteajin,0,1,1,0,1,1,0,0,2,0.6,0.666667,0
15765,,,catboys3000,0,1,1,0,1,1,0,0,2,0.6,0.666667,0
15766,,,orange_qp,0,1,1,0,1,1,0,0,2,0.6,0.666667,0
15767,,,ikiiceland,0,1,1,0,1,1,0,0,2,0.6,0.666667,0
15768,,,nuwur111,0,1,1,0,1,1,0,0,2,0.6,0.666667,0
15769,,,axetremis,0,1,1,0,1,1,0,0,2,0.6,0.666667,0
15770,,,LauraMcSorleyDC,1,1,2,1,1,2,0,0.006687,0,0,0,0
15771,,,SantaMariaTimes,2,1,3,2,1,3,0.5,0.013374,0,0,0,0
15772,,,softkaii,0,1,1,0,1,1,0,0,1,1,1,0
15773,,,TALK1370,1,1,2,1,1,2,0,0.006687,0,0,0,0
15774,,,lightwoo_,2,1,3,2,1,3,0.5,0.013374,0,0,0,0
15775,,,hyunjstaa,0,1,1,0,1,1,0,0,1,1,1,0
15776,,,thenchipz,1,1,2,1,1,2,0,0.006687,0,0,0,0
15777,,,Emosungbeliever,0,1,1,0,1,1,0,0,1,1,1,0
15778,,,7317Haha,0,1,1,0,1,1,0,0,1,1,1,0
15779,,,bilerthecreator,0,1,1,0,1,1,0,0,1,1,1,0
15780,,,mamajess94,0,1,1,0,1,1,0,0,1,1,1,0
15781,,,tetebadgirl,0,1,1,0,1,1,0,0,1,1,1,0
15782,,,BenchoBasabe,0,3,3,0,3,3,0,0,1,1,1,0
15783,,,jost_tyler,0,1,1,0,1,1,0,0,1,1,1,0
15784,,,mmmaipd,0,1,1,0,1,1,0,0,1,1,1,0
15785,,,tanquindaheejin,0,1,1,0,1,1,0,0,1,1,1,0
15786,,,FrankChow,1,1,2,1,1,2,0,0.006687,0,0,0,0
15787,,,imfabrizio157,5,1,6,5,1,6,0.2,0.033436,0,0,0,0
15788,,,Iinosfish,0,1,1,0,1,1,0,0,1,1,1,0
15789,,,genkisakka,0,1,1,0,1,1,0,0,1,1,1,0
15790,,,chriscarletos,0,2,2,0,2,2,0,0,1,1,1,0
15791,,,ChaplainheArt,0,1,1,0,1,1,0,0,1,1,1,0
15792,,,katieelizbth,1,1,2,1,1,2,0,0.006687,0,0,0,0
15793,,,haragoochie,1,1,2,1,1,2,0,0.006687,0,0,0,0
15794,,,qushuhaze,16,1,17,16,1,17,0.0625,0.109721,0,0,0,0
15795,,,CaptCheesyBeard,0,1,1,0,1,1,0,0,1,1,1,0
15796,,,sailorxim,0,1,1,0,1,1,0,0,1,1,1,0
15797,,,shinyredmoon_,0,1,1,0,1,1,0,0,1,1,1,0
15798,,,patrickwkelly,0,1,1,0,1,1,0,0,1,1,1,0
15799,,,no_n_exist,0,1,1,0,1,1,0,0,1,1,1,0
15800,,,pawllock,0,1,1,0,1,1,0,0,1,1,1,0
15801,,,hsiwrld,0,1,1,0,1,1,0,0,1,1,1,0
15802,,,LUCYKBAND,0,1,1,0,1,1,0,0,1,1,1,0
15803,,,k0okieTime,0,1,1,0,1,1,0,0,1,1,1,0
15804,,,hqnhyuk,0,14,14,0,14,14,0,0,2,0.769231,0.85,0
15805,,,SooshiBaby,0,1,1,0,1,1,0,0,1,1,1,0
15806,,,CNeroTV,0,1,1,0,1,1,0,0,1,1,1,0
15807,,,ShannonPCzarko1,0,1,1,0,1,1,0,0,1,1,1,0
15808,,,Rubygirl_Tweets,0,1,1,0,1,1,0,0,1,1,1,0
15809,,,mayugemayu911,5,1,6,5,1,6,0.2,0.033436,0,0,0,0
15810,,,geminyu,0,1,1,0,1,1,0,0,1,1,1,0
15811,,,karin19970124,0,1,1,0,1,1,0,0,1,1,1,0
15812,,,tyrannotaurusx,0,1,1,0,1,1,0,0,1,1,1,0
15813,,,GlobalWatchCGTN,3,1,4,3,1,4,0.333333,0.020061,0,0,0,0
15814,,,JK_Sweetsmile,0,1,1,0,1,1,0,0,1,1,1,0
15815,,,chewrId,0,1,1,0,1,1,0,0,1,1,1,0
15816,,,Elizabeth_Levy_,4,1,5,4,1,5,0.25,0.026749,0,0,0,0
15817,,,skylvrzz,0,1,1,0,1,1,0,0,1,1,1,0
15818,,,wgmcewen,2,1,3,2,1,3,0.5,0.013374,0,0,0,0
15819,,,mhcmhw,0,1,1,0,1,1,0,0,1,1,1,0
15820,,,flodaddyy,5,1,6,5,1,6,0.2,0.033436,0,0,0,0
15821,,,3JtbMXXOyVC7iDa,0,1,1,0,1,1,0,0,1,1,1,0
15822,,,younievs,0,1,1,0,1,1,0,0,1,1,1,0
15823,,,MowgliPark,2,1,3,2,1,3,0.5,0.013374,0,0,0,0
15824,,,isabelarsz,0,1,1,0,1,1,0,0,1,1,1,0
15825,,,mrslorijg,1,1,2,1,1,2,0,0.006687,0,0,0,0
15826,,,yuzu_1207l,1,2,3,1,2,3,0.5,0.006687,1,1,1,0
15827,,,BloemMarguerite,8,1,9,8,1,9,0.125,0.056991,0,0,0,0
15828,,,BettyFellows,0,1,1,0,1,1,0,0,1,1,1,0
15829,,,TelekineticBlue,0,1,1,0,1,1,0,0,1,1,1,0
15830,,,just_reen1212,0,1,1,0,1,1,0,0,1,1,1,0
15831,,,diorsyh,0,2,2,0,2,2,0,0,1,1,1,0
15832,,,kare11,1,2,3,1,2,3,0.5,0.006687,1,1,1,0
15833,,,handsofgloss,0,1,1,0,1,1,0,0,1,1,1,0
15834,,,madelineceee,2,1,3,2,1,3,0.5,0.013374,0,0,0,0
15835,,,mimiwhocanbox,2,1,3,3,2,5,0.5,0.013374,0,0,0,0
15836,,,CMessink,4,1,5,4,1,5,0.25,0.026749,0,0,0,0
15837,,,zuraxels,0,1,1,0,1,1,0,0,1,1,1,0
15838,,,T_Chaze,3,1,4,3,1,4,0.333333,0.02705,0,0,0,0
15839,,,bbychudy,8,1,9,10,2,12,0.125,0.053497,0,0,0,0
15840,,,boobooz28,10,1,11,10,1,11,0.1,0.066871,0,0,0,0
15841,,,JVNGW0NT0N,0,1,1,0,1,1,0,0,1,1,1,0
15842,,,BTS_LiveAsWeAre,0,1,1,0,1,1,0,0,1,1,1,0
15843,,,BelnPaloma1,0,1,1,0,1,1,0,0,1,1,1,0
15844,,,TRYP0PH0B1A,0,1,1,0,1,1,0,0,1,1,1,0
15845,,,SusanSJMcGee,0,1,1,0,1,1,0,0,1,1,1,0
15846,,,hoggard_sharon,0,1,1,0,1,1,0,0,1,1,1,0
15847,,,butterflycrowns,0,1,1,0,1,1,0,0,1,1,1,0
15848,,,_mais_pourquoi_,6,1,7,6,1,7,0.166667,0.040123,0,0,0,0
15849,,,lauraladida,0,1,1,0,1,1,0,0,1,1,1,0
15850,,,nathanhapper,0,1,1,0,1,1,0,0,1,1,1,0
15851,,,belovedpadfoot,0,1,1,0,1,1,0,0,1,1,1,0
15852,,,michell57075063,0,1,1,0,1,1,0,0,1,1,1,0
15853,,,beomgyyu1,0,1,1,0,1,1,0,0,1,1,1,0
15854,,,HeidiWigdahl,4,1,5,4,1,5,0.25,0.026749,0,0,0,0
15855,,,Klaroline2000,0,1,1,0,1,1,0,0,1,1,1,0
15856,,,p_toskas,0,1,1,0,1,1,0,0,1,1,1,0
15857,,,GoHawksForever,1,1,2,1,1,2,0,0.006687,0,0,0,0
15858,,,kmeverington,6,1,7,6,1,7,0.166667,0.040123,0,0,0,0
15859,,,jeonkoogies,0,1,1,0,1,1,0,0,1,1,1,0
15860,,,crposner,0,1,1,0,1,1,0,0,1,1,1,0
15861,,,kekekenosayon,0,1,1,0,1,1,0,0,1,1,1,0
15862,,,WontCaveDave,0,1,1,0,1,1,0,0,1,1,1,0
15863,,,urvintage_anne,0,1,1,0,1,1,0,0,1,1,1,0
15864,,,bangtwicetea,3,1,4,3,1,4,0.333333,0.020061,0,0,0,0
15865,,,ohmnn0n,0,1,1,0,1,1,0,0,1,1,1,0
15866,,,ChouxDeCrema,0,1,1,0,1,1,0,0,1,1,1,0
15867,,,AslanCalves,3,1,4,3,1,4,0.333333,0.020061,0,0,0,0
15868,,,iloveteargas,0,2,2,0,2,2,0,0,1,1,1,0
15869,,,giftbook,2,1,3,2,1,3,0.5,0.013374,0,0,0,0
15870,,,goSkargo,3,1,4,3,1,4,0.333333,0.020061,0,0,0,0
15871,,,fjue,6,1,7,6,1,7,0.166667,0.040123,0,0,0,0
15872,,,Orion_Astronomy,0,1,1,0,1,1,0,0,1,1,1,0
15873,,,QueenCatia,0,1,1,0,1,1,0,0,1,1,1,0
15874,,,Jamesdeel1,0,1,1,0,1,1,0,0,1,1,1,0
15875,,,DavidMK187,0,1,1,0,1,1,0,0,1,1,1,0
15876,,,hysmheadache,0,1,1,0,1,1,0,0,1,1,1,0
15877,,,levinecorey70,0,1,1,0,1,1,0,0,1,1,1,0
15878,,,m_mandarinas,3,1,4,3,1,4,0.333333,0.020061,0,0,0,0
15879,,,tysglittertears,0,1,1,0,1,1,0,0,1,1,1,0
15880,,,jhsfIrt,0,1,1,0,1,1,0,0,1,1,1,0
15881,,,apbusch,1,1,2,1,1,2,0,0.006687,0,0,0,0
15882,,,quintupletwist,7,1,8,8,1,9,0.142857,0.054992,0,0,0,0
15883,,,teenieheej,0,1,1,0,1,1,0,0,1,1,1,0
15884,,,katyartist,0,1,1,0,1,1,0,0,1,1,1,0
15885,,,sanhwart,3,1,4,3,1,4,0,0.01188,1,1,1,3
15886,,,jugglingjenn,0,1,1,0,1,1,0,0,1,1,1,0
15887,,,widowwinchester,3,1,4,3,1,4,0.333333,0.022789,0,0,0,0
15888,,,TennisTrish,0,1,1,0,1,1,0,0,1,1,1,0
15889,,,BrookeHenige,0,1,1,0,1,1,0,0,1,1,1,0
15890,,,LiliaKhatib,0,2,2,0,2,2,0,0,1,1,1,0
15891,,,MJResister,0,1,1,0,1,1,0,0,1,1,1,0
15892,,,levis_bride,0,1,1,0,1,1,0,0,1,1,1,0
15893,,,DanielHSolomon,0,1,1,0,1,1,0,0,1,1,1,0
15894,,,douglasfrbnks,2,1,3,2,1,3,0.5,0.013374,0,0,0,0
15895,,,WolfmomH,0,2,2,0,2,2,0,0,1,1,1,0
15896,,,20_camellia,0,1,1,0,1,1,0,0,2,0.666667,0.75,0
15897,,,eskettit15,2,1,3,2,1,3,0.5,0.013374,0,0,0,0
15898,,,AlamOrtiz92,0,1,1,0,1,1,0,0,1,1,1,0
15899,,,Andrew_1997,1,1,2,1,1,2,0,0.006687,0,0,0,0
15900,,,MeiMeiMemeMe,0,1,1,0,1,1,0,0,1,1,1,0
15901,,,njp424,0,1,1,0,1,1,0,0,1,1,1,0
15902,,,Finnly013,0,1,1,0,1,1,0,0,1,1,1,0
15903,,,PJbleedbluex2,0,1,1,0,1,1,0,0,1,1,1,0
15904,,,sammi_w825,0,1,1,0,1,1,0,0,1,1,1,0
15905,,,mytreasurehobi,2,3,5,2,3,5,0.25,0.013374,1,1,1,2
15906,,,CT99O4,0,1,1,0,1,1,0,0,1,1,1,0
15907,,,bear_staley,2,1,3,2,1,3,0.5,0.013374,0,0,0,0
15908,,,b_rowell20,0,1,1,0,1,1,0,0,1,1,1,0
15909,,,ultimatechad420,1,1,2,1,1,2,0,0.006687,0,0,0,0
15910,,,Mike__Perkins,2,1,3,3,2,5,0.5,0.013374,0,0,0,0
15911,,,dls954,0,1,1,0,1,1,0,0,1,1,1,0
15912,,,renabanena,4,1,5,4,1,5,0.25,0.026749,0,0,0,0
15913,,,KOTTO14225,0,1,1,0,1,1,0,0,1,1,1,0
15914,,,ToffeeAitham,0,1,1,0,1,1,0,0,1,1,1,0
15915,,,doraspenlows,5,1,6,5,1,6,0.2,0.033436,0,0,0,0
15916,,,marc_palen,0,1,1,0,1,1,0,0,1,1,1,0
15917,,,shovelarose,0,1,1,0,1,1,0,0,1,1,1,0
15918,,,choiminho_o,0,1,1,0,1,1,0,0,1,1,1,0
15919,,,Astroprojector2,1,1,2,1,1,2,0,0.006687,0,0,0,0
15920,,,NotAnotherNick,5,1,6,5,1,6,0.2,0.033436,0,0,0,0
15921,,,nochuww,0,1,1,0,1,1,0,0,1,1,1,0
15922,,,JLF_comms,0,1,1,0,1,1,0,0,1,1,1,0
15923,,,AdeleCulp,0,1,1,0,1,1,0,0,1,1,1,0
15924,,,ReganMorris52,1,1,2,1,1,2,0,0.006687,0,0,0,0
15925,,,wmzraz,3,1,4,3,1,4,0.333333,0.020061,0,0,0,0
15926,,,Ragnell,0,1,1,0,1,1,0,0,1,1,1,0
15927,,,KristinWardle,5,1,6,5,1,6,0.2,0.033436,0,0,0,0
15928,,,yuzulov07,0,1,1,0,1,1,0,0,1,1,1,0
15929,,,TheNarbhakshi,0,1,1,0,1,1,0,0,1,1,1,0
15930,,,RyanBul05723394,0,1,1,0,1,1,0,0,1,1,1,0
15931,,,oiseaulibre3,0,1,1,0,1,1,0,0,1,1,1,0
15932,,,SaultgirlDonna,0,1,1,0,1,1,0,0,1,1,1,0
15933,,,oecpjs,0,1,1,0,1,1,0,0,1,1,1,0
15934,,,crbustamante,0,1,1,0,1,1,0,0,1,1,1,0
15935,,,danastar78,0,1,1,0,1,1,0,0,1,1,1,0
15936,,,cyberpunkgguk,0,2,2,0,3,3,0,0,1,1,1,0
15937,,,Eathbound420,0,1,1,0,1,1,0,0,1,1,1,0
15938,,,JsFish,0,1,1,0,1,1,0,0,1,1,1,0
15939,,,HeyGeek,3,1,4,3,1,4,0.333333,0.020061,0,0,0,0
15940,,,empressfiend,0,1,1,0,1,1,0,0,1,1,1,0
15941,,,scarlletmendoza,0,1,1,0,1,1,0,0,1,1,1,0
15942,,,ayeJuliennee,10,1,11,10,1,11,0.1,0.066871,0,0,0,0
15943,,,vibrantvante,0,1,1,0,1,1,0,0,1,1,1,0
15944,,,jjungoogies,0,1,1,0,1,1,0,0,1,1,1,0
15945,,,khaflund,0,1,1,0,1,1,0,0,1,1,1,0
15946,,,5c0K90q60YgtjzV,0,1,1,0,1,1,0,0,1,1,1,0
15947,,,LyndaRo35897467,0,1,1,0,1,1,0,0,1,1,1,0
15948,,,MeganERomano,0,1,1,0,1,1,0,0,1,1,1,0
15949,,,thedezzie,1,1,2,1,1,2,0,0.006687,0,0,0,0
15950,,,californiaaimee,6,1,7,6,1,7,0.166667,0.040123,0,0,0,0
15951,,,mchashuramen,0,1,1,0,1,1,0,0,1,1,1,0
15952,,,laurbits,0,1,1,0,1,1,0,0,1,1,1,0
15953,,,Miniondrm,0,1,1,0,1,1,0,0,1,1,1,0
15954,,,manytomenshaun,0,1,1,0,1,1,0,0,1,1,1,0
15955,,,minyoonglescult,2,5,7,2,5,7,0.166667,0.013374,1,1,1,4
15956,,,DeniseH_21,0,1,1,0,1,1,0,0,2,0.555556,0.6,0
15957,,,nuibalance,0,1,1,0,1,1,0,0,2,0.666667,0.75,0
15958,,,himbokirk,0,1,1,0,1,1,0,0,2,0.666667,0.75,0
15959,,,flrnceluvr,1,1,2,1,1,2,0,0.006687,0,0,0,0
15960,,,BrandonBukas,3,1,4,3,1,4,0.333333,0.020061,0,0,0,0
15961,,,ludivinue,0,1,1,0,1,1,0,0,1,1,1,0
15962,,,joshuapak,0,1,1,0,1,1,0,0,1,1,1,0
15963,,,BrianduNord,6,1,7,6,1,7,0.166667,0.047111,0,0,0,0
15964,,,TestAsus3,0,2,2,0,2,2,0,0,1,1,1,0
15965,,,chosolovr,0,1,1,0,1,1,0,0,1,1,1,0
15966,,,GaryGai87057405,0,1,1,0,1,1,0,0,1,1,1,0
15967,,,ny4carrie,0,1,1,0,1,1,0,0,1,1,1,0
15968,,,GogosTM,6,1,7,6,1,7,0.166667,0.040123,0,0,0,0
15969,,,JustJul87741611,0,1,1,0,1,1,0,0,1,1,1,0
15970,,,JaeOnasi,0,1,1,0,1,1,0,0,1,1,1,0
15971,,,anginlewat,0,1,1,0,1,1,0,0,1,1,1,0
15972,,,joonarcade,0,1,1,0,1,1,0,0,3,0.5,0.611111,0
15973,,,SangHua_,0,1,1,0,1,1,0,0,3,0.5,0.611111,0
15974,,,incxloro,0,1,1,0,1,1,0,0,3,0.5,0.611111,0
15975,,,brooksynemaria,0,1,1,0,1,1,0,0,3,0.5,0.611111,0
15976,,,EspKara,6,1,7,6,1,7,0.166667,0.040123,0,0,0,0
15977,,,JeffersonCruzJr,0,1,1,0,1,1,0,0,1,1,1,0
15978,,,unniebear0,0,1,1,0,1,1,0,0,1,1,1,0
15979,,,justTaekmeaway,0,1,1,0,1,1,0,0,1,1,1,0
15980,,,mnsotasportsgal,1,1,2,1,1,2,0,0.006687,0,0,0,0
15981,,,SLThomas,1,1,2,1,1,2,0,0.006687,0,0,0,0
15982,,,yaelovebot,1,1,2,1,1,2,0,0.006687,0,0,0,0
15983,,,Tev_an,14,1,15,14,1,15,0.071429,0.113818,0,0,0,0
15984,,,CUDDLEBUGTYUN,0,3,3,0,3,3,0,0,1,1,1,0
15985,,,starrylotus,0,1,1,0,1,1,0,0,1,1,1,0
15986,,,mccoyu58,0,1,1,0,1,1,0,0,1,1,1,0
15987,,,loserbih,0,2,2,0,2,2,0,0,1,1,1,0
15988,,,jessicabookie,3,2,5,3,2,5,0.25,0.020061,1,1,1,2
15989,,,loveyuzuemi,0,1,1,0,1,1,0,0,1,1,1,0
15990,,,jenna_bagcal,0,1,1,0,1,1,0,0,1,1,1,0
15991,,,JusttMaii,0,1,1,0,1,1,0,0,1,1,1,0
15992,,,AMAJAEKI,0,1,1,0,1,1,0,0,1,1,1,0
15993,,,jiurora,0,1,1,0,1,1,0,0,1,1,1,0
15994,,,csage04,2,1,3,2,1,3,0.5,0.013374,0,0,0,0
15995,,,Cafe12Latte,0,1,1,0,1,1,0,0,1,1,1,0
15996,,,svctaeh,4,1,5,4,1,5,0.25,0.026749,0,0,0,0
15997,,,kumiko_85,0,1,1,0,1,1,0,0,1,1,1,0
15998,,,nsaucn,0,1,1,0,1,1,0,0,1,1,1,0
15999,,,aiosh_412,0,1,1,0,1,1,0,0,1,1,1,0
16000,,,atoyyni,8,1,9,8,1,9,0.125,0.070968,0,0,0,0
16001,,,isabellashutup,0,1,1,0,1,1,0,0,1,1,1,0
16002,,,vaniakrisha,0,1,1,0,1,1,0,0,1,1,1,0
16003,,,ph1aph1a,1,1,2,1,1,2,0,0.006687,0,0,0,0
16004,,,JCHQMedia,1,1,2,1,1,2,0,0.006687,0,0,0,0
16005,,,sleepyeepee,2,1,3,2,1,3,0.5,0.013374,0,0,0,0
16006,,,Llli75821634,0,1,1,0,1,1,0,0,1,1,1,0
16007,,,ms_marymary,7,1,8,7,1,8,0.142857,0.067775,0,0,0,0
16008,,,dumbjenozen,0,1,1,0,1,1,0,0,1,1,1,0
16009,,,andreaslandwehr,0,1,1,0,1,1,0,0,1,1,1,0
16010,,,riddlegirlz,0,1,1,0,1,1,0,0,1,1,1,0
16011,,,KTynot,0,1,1,0,1,1,0,0,1,1,1,0
16012,,,savvy_trvlr,0,2,2,0,2,2,0,0,1,1,1,0
16013,,,AlyssaGibbons95,1,1,2,1,1,2,0,0.006687,0,0,0,0
16014,,,MullahAtari,5,1,6,5,1,6,0.2,0.040424,0,0,0,0
16015,,,Shlimazlo,0,1,1,0,1,1,0,0,1,1,1,0
16016,,,tiantian_ice,0,1,1,0,1,1,0,0,1,1,1,0
16017,,,Angry_M00se,2,1,3,2,1,3,0.5,0.013374,0,0,0,0
16018,,,dygenre,8,1,9,9,2,11,0.125,0.053497,0,0,0,0
16019,,,katiestaffen,0,1,1,0,1,1,0,0,1,1,1,0
16020,,,MeidasConk,0,1,1,0,1,1,0,0,1,1,1,0
16021,,,flourmelon,0,1,1,0,1,1,0,0,1,1,1,0
16022,,,_sojugirl_,0,1,1,0,1,1,0,0,1,1,1,0
16023,,,yuna27595375,0,1,1,0,1,1,0,0,1,1,1,0
16024,,,kkkwww1112,0,1,1,0,1,1,0,0,1,1,1,0
16025,,,nera_kg,4,1,5,4,1,5,0.25,0.026749,0,0,0,0
16026,,,NatalieChin14,0,1,1,0,1,1,0,0,1,1,1,0
16027,,,17Ringz,0,1,1,0,1,1,0,0,1,1,1,0
16028,,,jsf3388,0,1,1,0,1,1,0,0,1,1,1,0
16029,,,susiexoo,0,1,1,0,1,1,0,0,1,1,1,0
16030,,,denkihitujisan,0,1,1,0,1,1,0,0,1,1,1,0
16031,,,willxie82,0,1,1,0,1,1,0,0,1,1,1,0
16032,,,bvelllla,0,1,1,0,1,1,0,0,1,1,1,0
16033,,,s6ulvm,0,1,1,0,1,1,0,0,1,1,1,0
16034,,,plam388,0,3,3,0,3,3,0,0,1,1,1,0
16035,,,ButterflyLove_8,0,1,1,0,1,1,0,0,1,1,1,0
16036,,,keeissner,0,1,1,0,1,1,0,0,1,1,1,0
16037,,,CBNNews,1,1,2,1,1,2,0,0.006687,0,0,0,0
16038,,,zucchiniweeni,1,4,5,1,5,6,0.25,0.006687,1,1,1,0
16039,,,unGRACEfullll,0,2,2,0,2,2,0,0,2,0.75,0.833333,0
16040,,,StacyLeMelle,0,1,1,0,1,1,0,0,2,0.666667,0.75,0
16041,,,namgibisxul,0,1,1,0,1,1,0,0,2,0.666667,0.75,0
16042,,,bzsummit,0,1,1,0,1,1,0,0,2,0.666667,0.75,0
16043,,,aestisilva,0,1,1,0,1,1,0,0,2,0.666667,0.75,0
16044,,,nurivallbona,7,1,8,7,1,8,0.142857,0.04681,0,0,0,0
16045,,,arsenalmarco99,0,1,1,0,1,1,0,0,1,1,1,0
16046,,,bureaucrat_sg,0,1,1,0,1,1,0,0,1,1,1,0
16047,,,namjoonknee,0,1,1,0,1,1,0,0,1,1,1,0
16048,,,yamamotomaki7,0,1,1,0,1,1,0,0,1,1,1,0
16049,,,amyh98860652,0,1,1,0,1,1,0,0,1,1,1,0
16050,,,yxgengyin,0,1,1,0,1,1,0,0,1,1,1,0
16051,,,VinnySpaceball,1,1,2,1,1,2,0,0.006687,0,0,0,0
16052,,,CASRIGHTS,4,1,5,4,1,5,0.25,0.026749,0,0,0,0
16053,,,romanshoubu,0,1,1,0,1,1,0,0,1,1,1,0
16054,,,mariirra,0,1,1,0,1,1,0,0,1,1,1,0
16055,,,bobonnie,4,1,5,4,1,5,0.25,0.026749,0,0,0,0
16056,,,EileenForBlue,0,1,1,0,1,1,0,0,1,1,1,0
16057,,,biojiver1,0,1,1,0,1,1,0,0,1,1,1,0
16058,,,dpschmidt9,0,1,1,0,1,1,0,0,1,1,1,0
16059,,,janegorecki,0,1,1,0,1,1,0,0,2,0.555556,0.6,0
16060,,,BetsyGervasi,0,1,1,0,1,1,0,0,1,1,1,0
16061,,,denjibff,2,1,3,2,1,3,0.5,0.013374,0,0,0,0
16062,,,pillscloud,0,1,1,0,1,1,0,0,1,1,1,0
16063,,,EmmeMPLS,2,1,3,2,1,3,0.5,0.013374,0,0,0,0
16064,,,beomgyulovbot_,0,1,1,0,1,1,0,0,1,1,1,0
16065,,,gossamerpetals,0,3,3,0,3,3,0,0,3,0.428571,0.527778,0
16066,,,cek422,0,1,1,0,1,1,0,0,2,0.666667,0.75,0
16067,,,tyundgaf,5,1,6,5,1,6,0.2,0.033436,0,0,0,0
16068,,,sunny_days365,0,1,1,0,1,1,0,0,1,1,1,0
16069,,,kaikoizumi,0,1,1,0,1,1,0,0,1,1,1,0
16070,,,x634495757,0,1,1,0,1,1,0,0,1,1,1,0
16071,,,Imjoelbrady,0,1,1,0,1,1,0,0,1,1,1,0
16072,,,themissjenn,4,1,5,4,1,5,0.25,0.026749,0,0,0,0
16073,,,daoke71,0,1,1,0,1,1,0,0,1,1,1,0
16074,,,liasohl,0,1,1,0,1,1,0,0,1,1,1,0
16075,,,hogmine480,0,1,1,0,1,1,0,0,1,1,1,0
16076,,,taehbabiee,0,2,2,0,2,2,0,0,3,0.516129,0.552083,0
16077,,,AK53033346,0,1,1,0,1,1,0,0,2,0.538462,0.571429,0
16078,,,sara4SF,0,1,1,0,1,1,0,0,2,0.538462,0.571429,0
16079,,,kadar_k,0,1,1,0,1,1,0,0,2,0.538462,0.571429,0
16080,,,taeilsbian,0,1,1,0,1,1,0,0,1,1,1,0
16081,,,annafly13,0,1,1,0,1,1,0,0,1,1,1,0
16082,,,shawoolie,0,1,1,0,1,1,0,0,1,1,1,0
16083,,,DadsDiscernment,0,1,1,0,1,1,0,0,1,1,1,0
16084,,,joybmi,12,1,13,12,1,13,0.083333,0.08374,0,0,0,0
16085,,,K_JINT,0,1,1,0,1,1,0,0,1,1,1,0
16086,,,therealkylebas,0,1,1,0,1,1,0,0,1,1,1,0
16087,,,Bandmom98,0,1,1,0,1,1,0,0,1,1,1,0
16088,,,Spica_Sk8,0,1,1,0,1,1,0,0,1,1,1,0
16089,,,rara27k,0,1,1,0,1,1,0,0,1,1,1,0
16090,,,tashakun,0,1,1,0,1,1,0,0,1,1,1,0
16091,,,hrts4intak,0,1,1,0,1,1,0,0,1,1,1,0
16092,,,dalivanleecaso,3,1,4,4,1,5,0.333333,0.023556,0,0,0,0
16093,,,senseidai,0,1,1,0,1,1,0,0,3,0.375,0.425926,0
16094,,,kunoichi7733,0,3,3,0,3,3,0,0,3,0.423077,0.530303,0
16095,,,cherryrengoku,1,1,2,1,1,2,0,0.006687,0,0,0,0
16096,,,londo_lee,5,1,6,5,1,6,0.2,0.03693,0,0,0,0
16097,,,hoadai311,0,1,1,0,1,1,0,0,1,1,1,0
16098,,,phamthanhthao21,0,2,2,0,2,2,0,0,1,1,1,0
16099,,,SoftWhalien,0,1,1,0,1,1,0,0,1,1,1,0
16100,,,yetta48852635,0,1,1,0,1,1,0,0,1,1,1,0
16101,,,rapplerdotcom,5,1,6,5,1,6,0.2,0.033436,0,0,0,0
16102,,,telepathyygth,0,1,1,0,1,1,0,0,1,1,1,0
16103,,,yoonminimini18,0,1,1,0,1,1,0,0,1,1,1,0
16104,,,jschroder13,0,1,1,0,1,1,0,0,1,1,1,0
16105,,,LIONEL79021357,14,3,17,15,4,19,0.0625,0.097114,1,1,1,26
16106,,,lizalinwsj,3,1,4,3,1,4,0.333333,0.020061,0,0,0,0
16107,,,selenitapurpose,0,1,1,0,1,1,0,0,1,1,1,0
16108,,,sexymadcorn,0,1,1,0,1,1,0,0,1,1,1,0
16109,,,DaisyFan_1995,2,1,3,2,1,3,0.5,0.013374,0,0,0,0
16110,,,Buttered_Pecans,7,2,9,7,2,9,0.125,0.136569,1,1,1,43
16111,,,KingAllie_ru,0,1,1,0,1,1,0,0,2,0.666667,0.75,0
16112,,,lheartjungwon,0,1,1,0,1,1,0,0,2,0.666667,0.75,0
16113,,,sofwaves,0,1,1,0,1,1,0,0,2,0.666667,0.75,0
16114,,,bigfanjay,0,1,1,0,1,1,0,0,2,0.666667,0.75,0
16115,,,LauraJoJohns,0,1,1,0,1,1,0,0,2,0.666667,0.75,0
16116,,,lousogxlden,0,1,1,0,1,1,0,0,2,0.6,0.666667,0
16117,,,Elizabe83614491,0,1,1,0,1,1,0,0,2,0.6,0.666667,0
16118,,,taralipinski,0,1,1,0,1,1,0,0,2,0.6,0.666667,0
16119,,,sarahonorby,0,1,1,0,1,1,0,0,2,0.6,0.666667,0
16120,,,yangyang_xoxo,1,4,5,1,4,5,0.25,0.006687,2,0.636364,0.714286,0
16121,,,LiveL0ngNPrsper,0,1,1,0,1,1,0,0,2,0.666667,0.75,0
16122,,,kkotjk,0,1,1,0,1,1,0,0,2,0.666667,0.75,0
16123,,,stayitminsung,0,1,1,0,1,1,0,0,2,0.666667,0.75,0
16124,,,chemilife,0,1,1,0,1,1,0,0,2,0.666667,0.75,0
16125,,,hxlvii,0,1,1,0,1,1,0,0,2,0.666667,0.75,0
16126,,,PeachieMagni,5,1,6,5,1,6,0.2,0.033436,0,0,0,0
16127,,,minakolittle,0,1,1,0,1,1,0,0,1,1,1,0
16128,,,izewun,0,1,1,0,1,1,0,0,1,1,1,0
16129,,,kakusuko6daimao,0,1,1,0,1,1,0,0,1,1,1,0
16130,,,TheGreatCIA,0,1,1,0,1,1,0,0,1,1,1,0
16131,,,eslavita,1,1,2,1,1,2,0,0.006687,0,0,0,0
16132,,,cnc_tribunephl,1,1,2,1,1,2,0,0.006687,0,0,0,0
16133,,,pink___fish,4,1,5,4,1,5,0.25,0.076571,0,0,0,0
16134,,,Lupini08,0,1,1,0,1,1,0,0,1,1,1,0
16135,,,mama32303,0,1,1,0,1,1,0,0,1,1,1,0
16136,,,tribunephl,2,1,3,2,1,3,0.5,0.013374,0,0,0,0
16137,,,ncittty,0,1,1,0,1,1,0,0,1,1,1,0
16138,,,ihatevrythang,15,1,16,15,1,16,0.066667,0.100307,0,0,0,0
16139,,,mikewatsontoday,0,1,1,0,1,1,0,0,1,1,1,0
16140,,,Filosophy_ya,0,1,1,0,1,1,0,0,1,1,1,0
16141,,,uhhhmyeah,0,1,1,0,1,1,0,0,1,1,1,0
16142,,,heyyitsraena,0,1,1,0,1,1,0,0,1,1,1,0
16143,,,garychun,0,1,1,0,1,1,0,0,1,1,1,0
16144,,,ovxrdosew,0,1,1,0,1,1,0,0,1,1,1,0
16145,,,sailordiet,0,1,1,0,1,1,0,0,1,1,1,0
16146,,,starsdoyouliked,0,1,1,0,1,1,0,0,1,1,1,0
16147,,,agustdmentality,0,1,1,0,1,1,0,0,1,1,1,0
16148,,,hobie0318,0,1,1,0,1,1,0,0,1,1,1,0
16149,,,dea_armyOT7,0,1,1,0,1,1,0,0,1,1,1,0
16150,,,soloefie,0,2,2,0,2,2,0,0,2,0.666667,0.75,0
16151,,,roryandcabbage,0,1,1,0,1,1,0,0,2,0.6,0.666667,0
16152,,,Niquer20,0,1,1,0,1,1,0,0,2,0.6,0.666667,0
16153,,,zaralima,0,1,1,0,1,1,0,0,2,0.6,0.666667,0
16154,,,NoobBuddy3,0,1,1,0,1,1,0,0,2,0.6,0.666667,0
16155,,,itsjustrikki,0,3,3,0,3,3,0,0,2,0.714286,0.8,0
16156,,,xie_viola,0,1,1,0,1,1,0,0,2,0.6,0.666667,0
16157,,,binnsbritannyg1,0,1,1,0,1,1,0,0,2,0.6,0.666667,0
16158,,,sydneyleslie13,0,1,1,0,1,1,0,0,2,0.6,0.666667,0
16159,,,TinaHong19,0,1,1,0,1,1,0,0,2,0.6,0.666667,0
16160,,,DrMarianneEMay1,2,1,3,2,1,3,0.5,0.013374,0,0,0,0
16161,,,BeBraveMyLoves,0,1,1,0,1,1,0,0,1,1,1,0
16162,,,anyacrittenton,2,1,3,2,1,3,0.5,0.013374,0,0,0,0
16163,,,livelyoongi,0,1,1,0,1,1,0,0,1,1,1,0
16164,,,joadma3081,0,1,1,0,1,1,0,0,1,1,1,0
16165,,,mevoyezlatte,0,1,1,0,1,1,0,0,1,1,1,0
16166,,,lilmeowmeow2_,0,1,1,0,1,1,0,0,1,1,1,0
16167,,,anniewinehouse,4,1,5,4,1,5,0.25,0.026749,0,0,0,0
16168,,,quadtoe,0,1,1,0,1,1,0,0,1,1,1,0
16169,,,SiruiZou,0,1,1,0,1,1,0,0,1,1,1,0
16170,,,stillwaters44,0,1,1,0,1,1,0,0,1,1,1,0
16171,,,dshiz221,1,1,2,1,1,2,0,0.006687,0,0,0,0
16172,,,Scilloideae_J,0,1,1,0,1,1,0,0,1,1,1,0
16173,,,justagirlx10,0,1,1,0,1,1,0,0,1,1,1,0
16174,,,MitsuArmy,0,1,1,0,1,1,0,0,1,1,1,0
16175,,,miazanzucchi,0,2,2,0,2,2,0,0,1,1,1,0
16176,,,Sakuraev1__,0,1,1,0,1,1,0,0,1,1,1,0
16177,,,kana_hata,4,1,5,5,2,7,0.25,0.026749,0,0,0,0
16178,,,calipatis,11,1,12,11,1,12,0.090909,0.073559,0,0,0,0
16179,,,ShiloTsukasa,0,1,1,0,1,1,0,0,1,1,1,0
16180,,,janrobinjackson,0,1,1,0,1,1,0,0,1,1,1,0
16181,,,_M_a_m_u,0,1,1,0,1,1,0,0,1,1,1,0
16182,,,tamu26,0,1,1,0,1,1,0,0,1,1,1,0
16183,,,anaidh1,0,1,1,0,1,1,0,0,1,1,1,0
16184,,,kymxluv,0,1,1,0,1,1,0,0,1,1,1,0
16185,,,pyoryua,0,1,1,0,1,1,0,0,1,1,1,0
16186,,,kathip21,2,1,3,2,1,3,0.5,0.013374,0,0,0,0
16187,,,DKyleLM,0,1,1,0,1,1,0,0,1,1,1,0
16188,,,wulffg,1,1,2,1,1,2,0,0.006687,0,0,0,0
16189,,,lullabyforyou,8,1,9,8,1,9,0.125,0.053497,0,0,0,0
16190,,,oceansoups,0,1,1,0,1,1,0,0,1,1,1,0
16191,,,ARIANAPOSlTlONS,0,1,1,0,1,1,0,0,1,1,1,0
16192,,,Nongtiredkapee1,0,1,1,0,1,1,0,0,1,1,1,0
16193,,,clahanyushii,0,1,1,0,1,1,0,0,1,1,1,0
16194,,,RapplerSports,12,1,13,14,1,15,0.083333,0.126163,0,0,0,0
16195,,,lisagemeni,0,1,1,0,1,1,0,0,1,1,1,0
16196,,,That_DarnKat,0,1,1,0,2,2,0,0,1,1,1,0
16197,,,MarinAndTheMeme,0,1,1,0,1,1,0,0,1,1,1,0
16198,,,F45Roger,0,1,1,0,1,1,0,0,1,1,1,0
16199,,,USCGamecockBoy,0,3,3,0,4,4,0,0,1,1,1,0
16200,,,GraceAeryn,0,1,1,0,1,1,0,0,1,1,1,0
16201,,,kittyinasock,0,1,1,0,1,1,0,0,1,1,1,0
16202,,,bensul,4,1,5,4,1,5,0.25,0.026749,0,0,0,0
16203,,,bjyx00,0,1,1,0,1,1,0,0,1,1,1,0
16204,,,skate69yn,0,1,1,0,1,1,0,0,1,1,1,0
16205,,,hokaze_matomo,0,1,1,0,1,1,0,0,1,1,1,0
16206,,,Dengfenglai0764,0,1,1,0,1,1,0,0,1,1,1,0
16207,,,seokjinbde,0,1,1,0,1,1,0,0,1,1,1,0
16208,,,kapus329,0,1,1,0,1,1,0,0,1,1,1,0
16209,,,hnhmr7,0,1,1,0,1,1,0,0,1,1,1,0
16210,,,FUIndividual1,0,1,1,0,1,1,0,0,1,1,1,0
16211,,,rishabree,1,1,2,1,1,2,0,0.006687,0,0,0,0
16212,,,bathersens,4,1,5,4,1,5,0.25,0.026749,0,0,0,0
16213,,,ristaknight,0,1,1,0,1,1,0,0,1,1,1,0
16214,,,_min2402_,0,1,1,0,1,1,0,0,1,1,1,0
16215,,,canalas_maria,1,1,2,1,1,2,0,0.006687,0,0,0,0
16216,,,gi4yoon,1,1,2,1,1,2,0,0.006687,0,0,0,0
16217,,,nancypeggy,0,1,1,0,1,1,0,0,1,1,1,0
16218,,,KellyBCartwrig1,3,1,4,3,1,4,0.333333,0.041027,0,0,0,0
16219,,,RachelRoh,2,1,3,2,1,3,0.5,0.013374,0,0,0,0
16220,,,DamaDG,0,1,1,0,1,1,0,0,1,1,1,0
16221,,,_heiyang,8,1,9,8,1,9,0.125,0.053497,0,0,0,0
16222,,,davidabatchelor,0,1,1,0,1,1,0,0,1,1,1,0
16223,,,JCWY1998,0,1,1,0,1,1,0,0,1,1,1,0
16224,,,joetv87,0,1,1,0,1,1,0,0,1,1,1,0
16225,,,juyeoneus,0,1,1,0,1,1,0,0,1,1,1,0
16226,,,bangtaenerys,0,1,1,0,1,1,0,0,1,1,1,0
16227,,,VINTAGEJE0N,1,1,2,1,1,2,0,0.006687,0,0,0,0
16228,,,bamboolann,5,1,6,6,2,8,0.2,0.033436,0,0,0,0
16229,,,cottoncandykoo,0,1,1,0,1,1,0,0,1,1,1,0
16230,,,tortlduck,0,1,1,0,1,1,0,0,1,1,1,0
16231,,,crktpri,0,1,1,0,1,1,0,0,1,1,1,0
16232,,,sailuvz,4,1,5,6,3,9,0.25,0.026749,0,0,0,0
16233,,,hana_crown_mnk,0,1,1,0,1,1,0,0,1,1,1,0
16234,,,trishbarth,0,1,1,0,1,1,0,0,1,1,1,0
16235,,,ChrisMirig,9,1,10,9,1,10,0.111111,0.060184,0,0,0,0
16236,,,Mmmm_Smores,0,1,1,0,1,1,0,0,1,1,1,0
16237,,,babybunT__T,0,1,1,0,1,1,0,0,1,1,1,0
16238,,,chickwerner,0,1,1,0,1,1,0,0,1,1,1,0
16239,,,MrNoodalsPeanut,0,1,1,0,1,1,0,0,1,1,1,0
16240,,,kedundas,0,1,1,0,1,1,0,0,1,1,1,0
16241,,,itogyu,0,1,1,0,1,1,0,0,1,1,1,0
16242,,,iltanniesm,0,1,1,0,1,1,0,0,1,1,1,0
16243,,,theacedetektive,0,1,1,0,1,1,0,0,1,1,1,0
16244,,,SheikhFurqan98,0,1,1,0,1,1,0,0,1,1,1,0
16245,,,ukelailai,0,1,1,0,1,1,0,0,1,1,1,0
16246,,,cassiek9817,3,1,4,3,1,4,0.333333,0.020061,0,0,0,0
16247,,,Boom_pp,0,1,1,0,1,1,0,0,1,1,1,0
16248,,,arismendijob,5,1,6,5,1,6,0.2,0.033436,0,0,0,0
16249,,,_sunflowerhobi_,0,1,1,0,1,1,0,0,1,1,1,0
16250,,,VenicePandaMom,0,1,1,0,1,1,0,0,1,1,1,0
16251,,,TrojanMarch,3,1,4,3,1,4,0.333333,0.020061,0,0,0,0
16252,,,froglovee,0,1,1,0,1,1,0,0,1,1,1,0
16253,,,DemiNLawrence,1,1,2,1,1,2,0,0.006687,0,0,0,0
16254,,,Jessi_auto,2,1,3,2,1,3,0.5,0.02217,0,0,0,0
16255,,,4A_for_Yuzu,0,1,1,0,1,1,0,0,1,1,1,0
16256,,,DanTriDangFirpo,1,1,2,1,1,2,0,0.006687,0,0,0,0
16257,,,MsCrowSays,0,1,1,0,1,1,0,0,1,1,1,0
16258,,,Newsy,11,1,12,11,1,12,0.090909,0.090263,0,0,0,0
16259,,,avanluna,0,1,1,0,1,1,0,0,1,1,1,0
16260,,,Sea_of_love__,0,1,1,0,1,1,0,0,1,1,1,0
16261,,,Justinfilms2,0,1,1,0,1,1,0,0,1,1,1,0
16262,,,Hirobraves,0,1,1,0,1,1,0,0,1,1,1,0
16263,,,AtinyFavs,0,1,1,0,1,1,0,0,1,1,1,0
16264,,,brenda282123,0,1,1,0,1,1,0,0,1,1,1,0
16265,,,riBBonwonnie,2,1,3,2,1,3,0.5,0.013374,0,0,0,0
16266,,,slyxangel,0,1,1,0,1,1,0,0,1,1,1,0
16267,,,jossey_bareille,8,1,9,8,1,9,0.125,0.053497,0,0,0,0
16268,,,jhgurf,0,1,1,0,1,1,0,0,1,1,1,0
16269,,,ngzeonhou,0,1,1,0,1,1,0,0,1,1,1,0
16270,,,rebeccaalpert1,0,1,1,0,1,1,0,0,1,1,1,0
16271,,,ensorkb,0,1,1,0,1,1,0,0,1,1,1,0
16272,,,KellyJo77527008,0,1,1,0,1,1,0,0,1,1,1,0
16273,,,joonverdant,0,1,1,0,1,1,0,0,1,1,1,0
16274,,,yuzulegend,0,1,1,0,1,1,0,0,1,1,1,0
16275,,,MirHasAnOddName,1,2,3,1,2,3,0.5,0.006687,1,1,1,0
16276,,,kbiegel,4,1,5,5,1,6,0.25,0.026749,0,0,0,0
16277,,,4FEu3F,0,1,1,0,2,2,0,0,1,1,1,0
16278,,,rosamontagova,0,1,1,0,1,1,0,0,1,1,1,0
16279,,,mccormick1942,4,1,5,4,1,5,0.25,0.026749,0,0,0,0
16280,,,Jaizem,0,1,1,0,1,1,0,0,1,1,1,0
16281,,,thatvietbitch,0,1,1,0,1,1,0,0,1,1,1,0
16282,,,averym002,0,1,1,0,1,1,0,0,1,1,1,0
16283,,,jmtopkai,0,1,1,0,1,1,0,0,1,1,1,0
16284,,,jellis502,3,1,4,3,1,4,0.333333,0.020061,0,0,0,0
16285,,,jocelynmonge,0,1,1,0,1,1,0,0,1,1,1,0
16286,,,mel_alizabeth,8,1,9,8,1,9,0.125,0.053497,0,0,0,0
16287,,,salbux,0,1,1,0,1,1,0,0,1,1,1,0
16288,,,God_4A,0,1,1,0,1,1,0,0,1,1,1,0
16289,,,hoshicIub,0,1,1,0,1,1,0,0,1,1,1,0
16290,,,SylvieMercil,0,1,1,0,1,1,0,0,1,1,1,0
16291,,,LunarSkye_,0,1,1,0,1,1,0,0,1,1,1,0
16292,,,qingge_bf,0,1,1,0,1,1,0,0,1,1,1,0
16293,,,xingqiuT___T,0,1,1,0,1,1,0,0,1,1,1,0
16294,,,soulofashu,4,1,5,4,1,5,0.25,0.047714,0,0,0,0
16295,,,Stream_Pers0na,0,1,1,0,1,1,0,0,1,1,1,0
16296,,,melanienewport,5,1,6,5,1,6,0.2,0.033436,0,0,0,0
16297,,,moontay13,0,1,1,0,1,1,0,0,1,1,1,0
16298,,,ngasoruu,0,1,1,0,1,1,0,0,1,1,1,0
16299,,,ou_yuzulove,0,1,1,0,1,1,0,0,1,1,1,0
16300,,,bibispizzas,0,1,1,0,1,1,0,0,1,1,1,0
16301,,,abbeyszumloz,0,1,1,0,1,1,0,0,1,1,1,0
16302,,,SH0CEAN,0,1,1,0,1,1,0,0,1,1,1,0
16303,,,mime_820,0,1,1,0,1,1,0,0,1,1,1,0
16304,,,sang_dans_leau,0,1,1,0,1,1,0,0,1,1,1,0
16305,,,GrnEyedGatita,0,1,1,0,1,1,0,0,1,1,1,0
16306,,,albedotrustfund,0,3,3,0,3,3,0,0,1,1,1,0
16307,,,62WalterP,0,1,1,0,1,1,0,0,1,1,1,0
16308,,,_saltyaf,1,1,2,1,1,2,0,0.006687,0,0,0,0
16309,,,seojunfy,1,1,2,1,1,2,0,0.006687,0,0,0,0
16310,,,oldhippieros,2,1,3,2,1,3,0.5,0.03434,0,0,0,0
16311,,,VandyCane,4,1,5,4,1,5,0.25,0.026749,0,0,0,0
16312,,,zziggyzztar,0,1,1,0,1,1,0,0,1,1,1,0
16313,,,MerovingianEJ,0,1,1,0,1,1,0,0,1,1,1,0
16314,,,immaminiature,0,1,1,0,1,1,0,0,1,1,1,0
16315,,,ThatVDOVault,0,1,1,0,1,1,0,0,1,1,1,0
16316,,,lizmack313,2,1,3,2,1,3,0.5,0.013374,0,0,0,0
16317,,,mizzi_nator,0,1,1,0,1,1,0,0,1,1,1,0
16318,,,1YASSeo,1,1,2,1,1,2,0,0.006687,0,0,0,0
16319,,,makomahalo,0,1,1,0,1,1,0,0,1,1,1,0
16320,,,jschil,0,1,1,0,1,1,0,0,1,1,1,0
16321,,,youngtaefox,0,1,1,0,1,1,0,0,1,1,1,0
16322,,,22_h_y,0,1,1,0,1,1,0,0,1,1,1,0
16323,,,Holy_key1,11,1,12,11,1,12,0.090909,0.077053,0,0,0,0
16324,,,scarebearz,0,1,1,0,1,1,0,0,1,1,1,0
16325,,,Stinalina_,0,1,1,0,1,1,0,0,1,1,1,0
16326,,,MonicaRivpin,0,1,1,0,1,1,0,0,1,1,1,0
16327,,,mapspen,0,1,1,0,1,1,0,0,1,1,1,0
16328,,,jblosser13,0,1,1,0,1,1,0,0,1,1,1,0
16329,,,rcp_1964,0,1,1,0,1,1,0,0,1,1,1,0
16330,,,dowoouwus,0,1,1,0,1,1,0,0,1,1,1,0
16331,,,lmhfoIder,5,1,6,5,1,6,0.2,0.033436,0,0,0,0
16332,,,Anaan_02,0,1,1,0,1,1,0,0,1,1,1,0
16333,,,dirtydirtychaii,0,1,1,0,1,1,0,0,1,1,1,0
16334,,,Kumama71,0,1,1,0,1,1,0,0,1,1,1,0
16335,,,Harper_ztk,0,1,1,0,1,1,0,0,1,1,1,0
16336,,,CitiBE,2,1,3,2,1,3,0.5,0.013374,0,0,0,0
16337,,,taecuppig,0,1,1,0,1,1,0,0,1,1,1,0
16338,,,nautae52,2,1,3,2,1,3,0.5,0.013374,0,0,0,0
16339,,,TheMartiScott,0,1,1,0,1,1,0,0,1,1,1,0
16340,,,profbrofisting,2,1,3,2,1,3,0.5,0.013374,0,0,0,0
16341,,,starrykookk,2,1,3,2,1,3,0.5,0.013374,0,0,0,0
16342,,,breakingPDXnews,2,1,3,2,1,3,0.5,0.013374,0,0,0,0
16343,,,2023MOSailing,0,1,1,0,1,1,0,0,1,1,1,0
16344,,,imabuildurocket,0,1,1,0,1,1,0,0,1,1,1,0
16345,,,Runningnowhere0,0,1,1,0,1,1,0,0,1,1,1,0
16346,,,shaller983,0,1,1,0,1,1,0,0,1,1,1,0
16347,,,jansenkun,0,1,1,0,1,1,0,0,1,1,1,0
16348,,,Carpediem4989,0,1,1,0,1,1,0,0,1,1,1,0
16349,,,vechanm,0,1,1,0,1,1,0,0,2,0.666667,0.75,0
16350,,,andy4democracy,0,1,1,0,1,1,0,0,2,0.666667,0.75,0
16351,,,d24haRu,0,1,1,0,1,1,0,0,1,1,1,0
16352,,,rachvarg,0,1,1,0,1,1,0,0,1,1,1,0
16353,,,holaitskimberly,0,1,1,0,1,1,0,0,1,1,1,0
16354,,,chyuckd,0,1,1,0,1,1,0,0,1,1,1,0
16355,,,shortprose1,3,1,4,3,1,4,0.333333,0.020061,0,0,0,0
16356,,,NoSurrender200,0,1,1,0,1,1,0,0,1,1,1,0
16357,,,lovemyko0,0,1,1,0,1,1,0,0,1,1,1,0
16358,,,lordwhorfin,0,1,1,0,1,1,0,0,1,1,1,0
16359,,,writer_delaney,0,1,1,0,1,1,0,0,1,1,1,0
16360,,,berryjsung,0,1,1,0,1,1,0,0,1,1,1,0
16361,,,pilotchiaki,0,1,1,0,1,1,0,0,1,1,1,0
16362,,,junqskookie,0,1,1,0,1,1,0,0,1,1,1,0
16363,,,chenkitayism,2,1,3,2,1,3,0.5,0.013374,0,0,0,0
16364,,,lempika7,0,1,1,0,1,1,0,0,1,1,1,0
16365,,,l2RP0jHu7XFfgvq,0,1,1,0,1,1,0,0,1,1,1,0
16366,,,Tildys,0,1,1,0,1,1,0,0,1,1,1,0
16367,,,badlandsinhidin,0,1,1,0,1,1,0,0,1,1,1,0
16368,,,velvetsreve,0,1,1,0,1,1,0,0,1,1,1,0
16369,,,gcfnita,0,1,1,0,1,1,0,0,1,1,1,0
16370,,,transwariotime,0,1,1,0,1,1,0,0,1,1,1,0
16371,,,GyukGyul,0,1,1,0,1,1,0,0,1,1,1,0
16372,,,hugsforspidey,11,1,12,11,1,12,0.090909,0.093145,0,0,0,0
16373,,,lilynong7,0,1,1,0,1,1,0,0,1,1,1,0
16374,,,JacobRAdkins,0,1,1,0,1,1,0,0,1,1,1,0
16375,,,Leslieoo7,0,1,1,0,1,1,0,0,1,1,1,0
16376,,,Claragrob1,0,1,1,0,1,1,0,0,1,1,1,0
16377,,,RanEmmanuel,5,2,7,5,2,7,0.166667,0.042231,1,1,1,6
16378,,,flowlikemizu,0,1,1,0,1,1,0,0,1,1,1,0
16379,,,ninhtuu,0,1,1,0,1,1,0,0,1,1,1,0
16380,,,achounlamontree,0,1,1,0,1,1,0,0,1,1,1,0
16381,,,kelliebucj,3,1,4,3,1,4,0.333333,0.020061,0,0,0,0
16382,,,MxShaneTaylor,0,1,1,0,1,1,0,0,1,1,1,0
16383,,,_mag_pie,0,1,1,0,1,1,0,0,1,1,1,0
16384,,,jgarcha,0,1,1,0,1,1,0,0,1,1,1,0
16385,,,RogueM2020,0,1,1,0,1,1,0,0,1,1,1,0
16386,,,ThomasHalldor,9,1,10,9,1,10,0.111111,0.060184,0,0,0,0
16387,,,OhlsonMary,0,1,1,0,1,1,0,0,1,1,1,0
16388,,,carathan630,0,1,1,0,1,1,0,0,1,1,1,0
16389,,,LI4ZU,0,1,1,0,1,1,0,0,1,1,1,0
16390,,,racehorsereport,0,1,1,0,1,1,0,0,1,1,1,0
16391,,,6outof7,0,1,1,0,1,1,0,0,1,1,1,0
16392,,,mexicon1c,0,1,1,0,1,1,0,0,1,1,1,0
16393,,,ChenSuskind,3,1,4,3,1,4,0.333333,0.020061,0,0,0,0
16394,,,xielianleaf,0,1,1,0,1,1,0,0,1,1,1,0
16395,,,mollytrees_,1,1,2,1,1,2,0,0.006687,0,0,0,0
16396,,,nguyen_cj,10,1,11,11,1,12,0.1,0.066871,0,0,0,0
16397,,,bowtie_jonny,0,1,1,0,1,1,0,0,1,1,1,0
16398,,,AmberCarlance,0,1,1,0,1,1,0,0,1,1,1,0
16399,,,zoey_mattson,0,1,1,0,1,1,0,0,1,1,1,0
16400,,,Danettesoasis,0,1,1,0,1,1,0,0,1,1,1,0
16401,,,su_xuhong,0,1,1,0,2,2,0,0,1,1,1,0
16402,,,_GODMY_,0,1,1,0,1,1,0,0,1,1,1,0
16403,,,wWSPaE9YS11ggtE,0,1,1,0,1,1,0,0,1,1,1,0
16404,,,LBmathemagician,0,1,1,0,1,1,0,0,1,1,1,0
16405,,,nancyneff2,4,2,6,4,2,6,0.2,0.026749,1,1,1,3
16406,,,andrewakang,0,1,1,0,1,1,0,0,2,0.666667,0.75,0
16407,,,OneMoreTimeIn21,0,1,1,0,1,1,0,0,2,0.666667,0.75,0
16408,,,mtownjoe,0,1,1,0,1,1,0,0,1,1,1,0
16409,,,CHARLIExBTS,1,1,2,1,1,2,0,0.006687,0,0,0,0
16410,,,pridgeon1313,12,1,13,12,1,13,0.083333,0.126779,0,0,0,0
16411,,,DotUrada,0,1,1,0,1,1,0,0,1,1,1,0
16412,,,Keihasgone,0,1,1,0,1,1,0,0,1,1,1,0
16413,,,marianacchef,0,1,1,0,1,1,0,0,1,1,1,0
16414,,,nesstheotaku,0,1,1,0,1,1,0,0,1,1,1,0
16415,,,FD_Kwon,0,1,1,0,1,1,0,0,1,1,1,0
16416,,,C_Carey19,0,1,1,0,1,1,0,0,1,1,1,0
16417,,,sweetsputnik,0,1,1,0,1,1,0,0,1,1,1,0
16418,,,HeyMo517,0,1,1,0,1,1,0,0,1,1,1,0
16419,,,taigakgs,0,1,1,0,1,1,0,0,1,1,1,0
16420,,,Consider8Media,7,1,8,7,1,8,0.142857,0.04681,0,0,0,0
16421,,,brizanic,0,1,1,0,1,1,0,0,1,1,1,0
16422,,,kaylajanaejb,0,1,1,0,1,1,0,0,1,1,1,0
16423,,,SadieMaeTN,0,1,1,0,1,1,0,0,1,1,1,0
16424,,,GTF40307554,0,1,1,0,1,1,0,0,1,1,1,0
16425,,,connoree987,0,1,1,0,1,1,0,0,1,1,1,0
16426,,,JFantu,14,1,15,14,1,15,0.071429,0.097114,0,0,0,0
16427,,,AshleyC1232,0,1,1,0,1,1,0,0,1,1,1,0
16428,,,JordanM96678551,0,1,1,0,1,1,0,0,1,1,1,0
16429,,,casthebert6,0,1,1,0,1,1,0,0,1,1,1,0
16430,,,rhododaktulos,0,1,1,0,1,1,0,0,1,1,1,0
16431,,,lovelytaebeom,0,1,1,0,1,1,0,0,1,1,1,0
16432,,,SINnerKEN,0,1,1,0,1,1,0,0,1,1,1,0
16433,,,X1EL14N,0,1,1,0,1,1,0,0,1,1,1,0
16434,,,DholeB_,0,1,1,0,1,1,0,0,1,1,1,0
16435,,,minidipity,0,1,1,0,1,1,0,0,1,1,1,0
16436,,,onlytheskz,0,1,1,0,1,1,0,0,1,1,1,0
16437,,,seokjinniluvr,0,1,1,0,1,1,0,0,1,1,1,0
16438,,,DEADLINE,1,1,2,1,1,2,0,0.006687,0,0,0,0
16439,,,WillysTeam,0,1,1,0,1,1,0,0,2,0.666667,0.75,0
16440,,,torinspiration,0,1,1,0,1,1,0,0,2,0.666667,0.75,0
16441,,,llhawaii,0,1,1,0,1,1,0,0,2,0.666667,0.75,0
16442,,,Trinitya_7,0,1,1,0,1,1,0,0,1,1,1,0
16443,,,itsyahgirkiana,0,1,1,0,1,1,0,0,1,1,1,0
16444,,,aDarkBlossom,2,1,3,2,1,3,0.5,0.013374,0,0,0,0
16445,,,hanguangjunn,0,1,1,0,1,1,0,0,1,1,1,0
16446,,,wadenapj,3,1,4,3,1,4,0.333333,0.020061,0,0,0,0
16447,,,killvaas,0,1,1,0,1,1,0,0,1,1,1,0
16448,,,Tracyingod,0,1,1,0,1,1,0,0,1,1,1,0
16449,,,ap_mess,1,1,2,1,1,2,0,0.006687,0,0,0,0
16450,,,bunxiann,3,1,4,3,1,4,0.333333,0.020061,0,0,0,0
16451,,,Permission_TD_,0,1,1,0,1,1,0,0,1,1,1,0
16452,,,jjongcoball,0,1,1,0,1,1,0,0,1,1,1,0
16453,,,simplexcor,0,1,1,0,1,1,0,0,1,1,1,0
16454,,,kimmythepooh,0,3,3,0,3,3,0,0,1,1,1,0
16455,,,milsceo,5,1,6,5,1,6,0.2,0.033436,0,0,0,0
16456,,,taerrificcv,0,1,1,0,1,1,0,0,1,1,1,0
16457,,,eadams_adams,0,1,1,0,1,1,0,0,1,1,1,0
16458,,,Atobe_keigo0607,0,1,1,0,1,1,0,0,1,1,1,0
16459,,,chosta111,0,1,1,0,1,1,0,0,1,1,1,0
16460,,,reysoloben,0,1,1,0,1,1,0,0,1,1,1,0
16461,,,tori_102103,0,1,1,0,1,1,0,0,1,1,1,0
16462,,,mk_yh1,0,1,1,0,1,1,0,0,1,1,1,0
16463,,,Zoe_wyl,0,1,1,0,1,1,0,0,1,1,1,0
16464,,,NhNancie,0,1,1,0,1,1,0,0,1,1,1,0
16465,,,Lisa58073057,3,1,4,3,1,4,0.333333,0.020061,0,0,0,0
16466,,,yaetsumu,0,1,1,0,1,1,0,0,1,1,1,0
16467,,,RiverChang8,0,1,1,0,1,1,0,0,1,1,1,0
16468,,,forest_yoongi,2,1,3,2,1,3,0.5,0.013374,0,0,0,0
16469,,,16joons,0,1,1,0,1,1,0,0,1,1,1,0
16470,,,anb24net,0,1,1,0,1,1,0,0,1,1,1,0
16471,,,fruitieis,7,1,8,7,1,8,0.142857,0.050304,0,0,0,0
16472,,,jiminscereal,0,1,1,0,1,1,0,0,1,1,1,0
16473,,,etsuk1582,0,1,1,0,1,1,0,0,1,1,1,0
16474,,,elizabethkob,0,1,1,0,1,1,0,0,1,1,1,0
16475,,,wlwzuru,0,1,1,0,1,1,0,0,1,1,1,0
16476,,,phoenix66101281,0,1,1,0,1,1,0,0,1,1,1,0
16477,,,W00RE0,1,1,2,1,1,2,0,0.006687,0,0,0,0
16478,,,haleematthews,4,1,5,4,1,5,0.25,0.026749,0,0,0,0
16479,,,MauricioPinzonB,0,1,1,0,1,1,0,0,1,1,1,0
16480,,,teakooi,0,1,1,0,1,1,0,0,1,1,1,0
16481,,,purplemoonchiId,0,1,1,0,1,1,0,0,1,1,1,0
16482,,,saramoralesla,6,1,7,6,1,7,0.166667,0.040123,0,0,0,0
16483,,,jinnnnnnnmoon,0,1,1,0,1,1,0,0,1,1,1,0
16484,,,auroradesu,0,1,1,0,1,1,0,0,1,1,1,0
16485,,,Kaheru66,0,1,1,0,1,1,0,0,1,1,1,0
16486,,,dwtsterling,9,1,10,9,1,10,0.111111,0.085095,0,0,0,0
16487,,,bytaeil,7,1,8,7,1,8,0,0.046444,1,1,1,16
16488,,,07skzstays,0,1,1,0,1,1,0,0,1,1,1,0
16489,,,snown_4A,0,1,1,0,1,1,0,0,1,1,1,0
16490,,,Ainelen7,0,1,1,0,1,1,0,0,1,1,1,0
16491,,,BarbaraStans,1,1,2,1,1,2,0,0.006687,0,0,0,0
16492,,,CCenizaChoy,3,1,4,3,1,4,0.333333,0.020061,0,0,0,0
16493,,,MeKeyBah,0,1,1,0,1,1,0,0,1,1,1,0
16494,,,soiiboi_,2,1,3,2,1,3,0.5,0.013374,0,0,0,0
16495,,,PR_Enterprise1,3,1,4,3,1,4,0.333333,0.020061,0,0,0,0
16496,,,LinaGarub,0,1,1,0,1,1,0,0,1,1,1,0
16497,,,jozieozie,0,1,1,0,1,1,0,0,1,1,1,0
16498,,,PastorJimLyon,4,1,5,4,1,5,0.25,0.026749,0,0,0,0
16499,,,bokutos_tess,0,1,1,0,1,1,0,0,1,1,1,0
16500,,,Allan_Straarup,0,1,1,0,1,1,0,0,1,1,1,0
16501,,,MALNIXENT,0,1,1,0,1,1,0,0,1,1,1,0
16502,,,badsevens,0,1,1,0,1,1,0,0,2,0.666667,0.75,0
16503,,,slomo_livia,3,1,4,3,1,4,0.333333,0.020061,0,0,0,0
16504,,,taestypurple,0,1,1,0,1,1,0,0,1,1,1,0
16505,,,cha8ahc,0,1,1,0,1,1,0,0,1,1,1,0
16506,,,nyavoid,0,1,1,0,1,1,0,0,1,1,1,0
16507,,,lzkrenha,1,1,2,1,1,2,0,0.006687,0,0,0,0
16508,,,abarbalich,10,1,11,10,1,11,0.1,0.087837,0,0,0,0
16509,,,ryuryu090310,0,1,1,0,1,1,0,0,1,1,1,0
16510,,,hanyumilf,0,1,1,0,1,1,0,0,1,1,1,0
16511,,,xzdwhxfy,0,1,1,0,1,1,0,0,1,1,1,0
16512,,,Georginawiggi44,0,1,1,0,1,1,0,0,1,1,1,0
16513,,,marcusmoore,0,1,1,0,1,1,0,0,1,1,1,0
16514,,,kayyakk,0,1,1,0,1,1,0,0,1,1,1,0
16515,,,xosaintroses,0,1,1,0,1,1,0,0,1,1,1,0
16516,,,MSBYMlYAS,13,1,14,13,1,14,0.076923,0.086933,0,0,0,0
16517,,,ChelseaAMusic,0,1,1,0,1,1,0,0,1,1,1,0
16518,,,hobisheart_,0,1,1,0,1,1,0,0,1,1,1,0
16519,,,lovesong1989,0,1,1,0,1,1,0,0,1,1,1,0
16520,,,lazybird_love22,0,1,1,0,1,1,0,0,1,1,1,0
16521,,,seedazuka,0,1,1,0,1,1,0,0,1,1,1,0
16522,,,t1gr4n9r190ry4n,0,1,1,0,1,1,0,0,1,1,1,0
16523,,,sos112110,0,1,1,0,1,1,0,0,1,1,1,0
16524,,,BarbaraMain07,0,1,1,0,1,1,0,0,1,1,1,0
16525,,,svmsoon,0,1,1,0,1,1,0,0,1,1,1,0
16526,,,Trash_Binnie_,0,1,1,0,1,1,0,0,1,1,1,0
16527,,,shahiraanadia,0,1,1,0,1,1,0,0,1,1,1,0
16528,,,claireluvsbearz,0,1,1,0,1,1,0,0,1,1,1,0
16529,,,tokkifltr,0,1,1,0,1,1,0,0,1,1,1,0
16530,,,minisobear,0,1,1,0,1,1,0,0,1,1,1,0
16531,,,KuroMizu11,2,7,9,2,8,10,0.125,0.013374,1,1,1,6
16532,,,Le_patinage,0,1,1,0,1,1,0,0,1,1,1,0
16533,,,CharCrnll,0,1,1,0,1,1,0,0,1,1,1,0
16534,,,HUA1SHA,1,1,2,1,1,2,0,0.006687,0,0,0,0
16535,,,inluviewithyou,4,1,5,4,1,5,0.25,0.026749,0,0,0,0
16536,,,Meidas_Jules,0,1,1,0,1,1,0,0,1,1,1,0
16537,,,kristenlwatts,0,1,1,0,1,1,0,0,1,1,1,0
16538,,,toybox_on,0,1,1,0,1,1,0,0,1,1,1,0
16539,,,MarieMyungOkLee,2,1,3,2,1,3,0.5,0.013374,0,0,0,0
16540,,,tmrowing,0,1,1,0,1,1,0,0,1,1,1,0
16541,,,kenziepharaoh,1,1,2,1,1,2,0,0.006687,0,0,0,0
16542,,,gbrodermann,3,1,4,3,1,4,0.333333,0.020061,0,0,0,0
16543,,,weebkoo,0,1,1,0,1,1,0,0,1,1,1,0
16544,,,hyunyuca,0,1,1,0,1,1,0,0,1,1,1,0
16545,,,aizawskz,0,1,1,0,1,1,0,0,2,0.666667,0.75,0
16546,,,avocado_prince_,0,1,1,0,1,1,0,0,1,1,1,0
16547,,,kierstinb2,0,1,1,0,1,1,0,0,1,1,1,0
16548,,,kasserolling,0,1,1,0,1,1,0,0,1,1,1,0
16549,,,CCGevirtz,0,1,1,0,1,1,0,0,2,0.666667,0.75,0
16550,,,hwaismyaurora,0,1,1,0,1,1,0,0,2,0.666667,0.75,0
16551,,,dans_solo,0,2,2,0,2,2,0,0,2,0.75,0.833333,0
16552,,,argonlights,0,1,1,0,1,1,0,0,2,0.666667,0.75,0
16553,,,ksjnymph,0,1,1,0,1,1,0,0,2,0.666667,0.75,0
16554,,,marciarowe6,0,1,1,0,1,1,0,0,2,0.666667,0.75,0
16555,,,rtjongho,0,1,1,0,1,1,0,0,2,0.666667,0.75,0
16556,,,yminworld,0,1,1,0,1,1,0,0,2,0.666667,0.75,0
16557,,,RealFThornton,0,1,1,0,1,1,0,0,2,0.666667,0.75,0
16558,,,angarosFrauweti,0,1,1,0,1,1,0,0,2,0.666667,0.75,0
16559,,,BryanUF,2,1,3,2,1,3,0.5,0.013374,0,0,0,0
16560,,,Army_Asian,0,1,1,0,1,1,0,0,1,1,1,0
16561,,,ErikEitel327,2,1,3,2,1,3,0.5,0.013374,0,0,0,0
16562,,,RonBorsh,0,1,1,0,1,1,0,0,1,1,1,0
16563,,,yukinkopop,0,1,1,0,1,1,0,0,1,1,1,0
16564,,,MaxJGao,0,1,1,0,1,1,0,0,1,1,1,0
16565,,,LUV4BAHIYYIH,0,1,1,0,1,1,0,0,1,1,1,0
16566,,,yoncadreamz,0,1,1,0,1,1,0,0,1,1,1,0
16567,,,pinkufuroido,0,1,1,0,1,1,0,0,1,1,1,0
16568,,,mikrojoonies,0,1,1,0,1,1,0,0,1,1,1,0
16569,,,exodisseia,0,1,1,0,1,1,0,0,1,1,1,0
16570,,,londonboy1313,0,2,2,0,2,2,0,0,3,0.52381,0.575758,0
16571,,,kaidicktion,0,1,1,0,1,1,0,0,3,0.5,0.537037,0
16572,,,weeeklynation,0,1,1,0,1,1,0,0,3,0.5,0.537037,0
16573,,,kyulynie,0,1,1,0,1,1,0,0,3,0.5,0.537037,0
16574,,,sbpayne325,1,1,2,1,1,2,0,0.006687,0,0,0,0
16575,,,LizzyCanarie,2,1,3,2,1,3,0.5,0.013374,0,0,0,0
16576,,,e08090929,0,1,1,0,1,1,0,0,1,1,1,0
16577,,,EdenBug,0,1,1,0,1,1,0,0,1,1,1,0
16578,,,bighimbojoon,0,1,1,0,1,1,0,0,1,1,1,0
16579,,,GatitoMeowMeow,0,1,1,0,1,1,0,0,1,1,1,0
16580,,,Lee63250991,0,1,1,0,1,1,0,0,1,1,1,0
16581,,,kisamorr,9,1,10,9,1,10,0.111111,0.060184,0,0,0,0
16582,,,Crystal14510,0,1,1,0,1,1,0,0,1,1,1,0
16583,,,kaysbinnie,0,1,1,0,1,1,0,0,1,1,1,0
16584,,,myohmy_mila,0,1,1,0,1,1,0,0,1,1,1,0
16585,,,MirandaMervyn2,0,1,1,0,1,1,0,0,1,1,1,0
16586,,,yeetinpatriarch,0,1,1,0,1,1,0,0,1,1,1,0
16587,,,LauraFontecha02,0,1,1,0,1,1,0,0,1,1,1,0
16588,,,Erik_Eitel,12,1,13,12,1,13,0.083333,0.099832,0,0,0,0
16589,,,bbkaaaye,0,1,1,0,1,1,0,0,1,1,1,0
16590,,,TracyNe97627400,0,2,2,0,2,2,0,0,1,1,1,0
16591,,,Cutekarma1,0,1,1,0,1,1,0,0,1,1,1,0
16592,,,wonwuuji,0,1,1,0,1,1,0,0,1,1,1,0
16593,,,js79,0,1,1,0,1,1,0,0,1,1,1,0
16594,,,flaming_icarus,0,1,1,0,1,1,0,0,1,1,1,0
16595,,,LiliBManoban,0,1,1,0,1,1,0,0,1,1,1,0
16596,,,icebrwx,0,1,1,0,1,1,0,0,1,1,1,0
16597,,,cats4will,0,1,1,0,1,1,0,0,1,1,1,0
16598,,,korejinnie,1,1,2,1,1,2,0,0.006687,0,0,0,0
16599,,,IIcycoolz,0,1,1,0,1,1,0,0,1,1,1,0
16600,,,LocustAutoX,3,1,4,3,1,4,0.333333,0.020061,0,0,0,0
16601,,,chanaluvr,14,1,15,14,1,15,0.071429,0.09362,0,0,0,0
16602,,,Rox_annah,0,1,1,0,1,1,0,0,1,1,1,0
16603,,,plastic9irls,0,1,1,0,1,1,0,0,1,1,1,0
16604,,,gaslitbyhopkins,0,1,1,0,1,1,0,0,1,1,1,0
16605,,,jiaranxjdg,0,1,1,0,1,1,0,0,1,1,1,0
16606,,,99tkmf,0,2,2,0,2,2,0,0,1,1,1,0
16607,,,bIuesundae,0,1,1,0,1,1,0,0,1,1,1,0
16608,,,needsalife1998,0,1,1,0,1,1,0,0,1,1,1,0
16609,,,justinenlawson,0,1,1,0,1,1,0,0,1,1,1,0
16610,,,KariGuzman1234,0,2,2,0,2,2,0,0,1,1,1,0
16611,,,gwinibee,4,1,5,4,1,5,0.25,0.040725,0,0,0,0
16612,,,kiki20050303,0,1,1,0,1,1,0,0,1,1,1,0
16613,,,pyrusha,0,1,1,0,1,1,0,0,1,1,1,0
16614,,,JennaMacnut,3,1,4,3,1,4,0.333333,0.020061,0,0,0,0
16615,,,cjnavinjr,0,1,1,0,1,1,0,0,1,1,1,0
16616,,,pOXaRNoXDUktqkR,0,1,1,0,1,1,0,0,1,1,1,0
16617,,,multimadnessme,1,1,2,1,1,2,0,0.006687,0,0,0,0
16618,,,le_super_vilain,1,1,2,1,1,2,0,0.006687,0,0,0,0
16619,,,graciepalms,1,1,2,1,1,2,0,0.006687,0,0,0,0
16620,,,Vibrant__Amber,0,1,1,0,1,1,0,0,1,1,1,0
16621,,,urvashiuberoy,0,1,1,0,1,1,0,0,1,1,1,0
16622,,,_alimetal,0,1,1,0,1,1,0,0,1,1,1,0
16623,,,MWskatecast,0,1,1,0,1,1,0,0,1,1,1,0
16624,,,bright8694,0,1,1,0,2,2,0,0,1,1,1,0
16625,,,geortyrius,0,1,1,0,1,1,0,0,1,1,1,0
16626,,,Dazy_Daze,1,1,2,1,1,2,0,0.006687,0,0,0,0
16627,,,RYUHYUNJlN,5,1,6,5,1,6,0.2,0.033436,0,0,0,0
16628,,,yukika20469,0,1,1,0,1,1,0,0,1,1,1,0
16629,,,iL0VMINS,0,1,1,0,1,1,0,0,1,1,1,0
16630,,,latina_cinefila,0,1,1,0,1,1,0,0,1,1,1,0
16631,,,RedScareToby,1,1,2,1,1,2,0,0.006687,0,0,0,0
16632,,,allegoriest,4,1,5,4,1,5,0.25,0.026749,0,0,0,0
16633,,,edenjayne31,0,1,1,0,1,1,0,0,1,1,1,0
16634,,,ptgwannabe,0,1,1,0,1,1,0,0,1,1,1,0
16635,,,HauntedCoffee_,2,1,3,2,1,3,0.5,0.013374,0,0,0,0
16636,,,plindec,0,1,1,0,1,1,0,0,1,1,1,0
16637,,,m__lizmy,0,1,1,0,1,1,0,0,1,1,1,0
16638,,,zaki12071994,0,1,1,0,1,1,0,0,1,1,1,0
16639,,,bridge1013,0,2,2,0,2,2,0,0,1,1,1,0
16640,,,texazucena11,0,1,1,0,1,1,0,0,1,1,1,0
16641,,,comicsdaughter,9,1,10,9,1,10,0.111111,0.143381,0,0,0,0
16642,,,elisachavezz,0,1,1,0,1,1,0,0,1,1,1,0
16643,,,HeatherKane19,0,1,1,0,1,1,0,0,1,1,1,0
16644,,,tylerzonia,0,1,1,0,1,1,0,0,1,1,1,0
16645,,,taelefante,0,1,1,0,1,1,0,0,1,1,1,0
16646,,,goIdenmidnight,0,1,1,0,1,1,0,0,1,1,1,0
16647,,,rachel_mccarson,3,1,4,3,1,4,0.333333,0.113741,0,0,0,0
16648,,,GMD25691,12,1,13,12,1,13,0.083333,0.082973,0,0,0,0
16649,,,sommerstar,0,1,1,0,1,1,0,0,1,1,1,0
16650,,,msphantasy,0,1,1,0,1,1,0,0,1,1,1,0
16651,,,moon_bibiscami,0,1,1,0,1,1,0,0,1,1,1,0
16652,,,mhrwmhrw,0,1,1,0,1,1,0,0,1,1,1,0
16653,,,taelittledeath,1,1,2,1,1,2,0,0.00396,1,1,1,1
16654,,,heoneypot,0,1,1,0,1,1,0,0,1,1,1,0
16655,,,9197BOY,0,1,1,0,1,1,0,0,1,1,1,0
16656,,,myoppimlttus,0,1,1,0,1,1,0,0,1,1,1,0
16657,,,delicatejimi,1,1,2,1,1,2,0,0.006687,0,0,0,0
16658,,,BradWaskewich,9,1,10,9,1,10,0.111111,0.067173,0,0,0,0
16659,,,maolove725,0,1,1,0,1,1,0,0,1,1,1,0
16660,,,jennvanni,0,1,1,0,1,1,0,0,1,1,1,0
16661,,,salutsalue,0,1,1,0,1,1,0,0,1,1,1,0
16662,,,kay_siderov,0,1,1,0,1,1,0,0,1,1,1,0
16663,,,denizseden_,0,1,1,0,1,1,0,0,1,1,1,0
16664,,,lvoewy,0,1,1,0,1,1,0,0,1,1,1,0
16665,,,nates_twt,0,1,1,0,1,1,0,0,1,1,1,0
16666,,,_jungul,0,1,1,0,1,1,0,0,1,1,1,0
16667,,,orangecrushable,0,1,1,0,1,1,0,0,1,1,1,0
16668,,,inforum,3,1,4,3,1,4,0.333333,0.020061,0,0,0,0
16669,,,lahaschanged,0,1,1,0,1,1,0,0,1,1,1,0
16670,,,SennottDeirdre,0,1,1,0,1,1,0,0,1,1,1,0
16671,,,BethDenBoots,5,1,6,5,1,6,0.2,0.033436,0,0,0,0
16672,,,ioisloona,0,1,1,0,1,1,0,0,1,1,1,0
16673,,,Amy_Boughton,0,1,1,0,1,1,0,0,1,1,1,0
16674,,,vagabond_,0,1,1,0,1,1,0,0,1,1,1,0
16675,,,Doogievet,0,1,1,0,1,1,0,0,1,1,1,0
16676,,,xmitteex,0,1,1,0,1,1,0,0,1,1,1,0
16677,,,bhang_nana,0,2,2,0,2,2,0,0,1,1,1,0
16678,,,Laura_E_Jahn,0,1,1,0,1,1,0,0,1,1,1,0
16679,,,somdnavywife,0,1,1,0,1,1,0,0,1,1,1,0
16680,,,JillianRoslyn,2,1,3,2,1,3,0.5,0.013374,0,0,0,0
16681,,,dreamy_minseul,0,1,1,0,1,1,0,0,2,0.666667,0.75,0
16682,,,KevinAndTravis5,0,1,1,0,1,1,0,0,2,0.666667,0.75,0
16683,,,M_Parthum_Sr,0,1,1,0,1,1,0,0,2,0.666667,0.75,0
16684,,,ka___skate,0,1,1,0,1,1,0,0,2,0.666667,0.75,0
16685,,,jamjamalien,0,1,1,0,1,1,0,0,2,0.666667,0.75,0
16686,,,wntrdays,0,1,1,0,1,1,0,0,2,0.666667,0.75,0
16687,,,rissaroo_1997,3,2,5,3,2,5,0.25,0.020061,2,0.666667,0.75,4
16688,,,JasmineMilehi,6,1,7,6,1,7,0.166667,0.040123,0,0,0,0
16689,,,nayeoniist,0,1,1,0,1,1,0,0,1,1,1,0
16690,,,aleshner,0,1,1,0,1,1,0,0,1,1,1,0
16691,,,DaniDaniwis,0,1,1,0,1,1,0,0,1,1,1,0
16692,,,cyndeewillow,2,1,3,2,1,3,0.5,0.013374,0,0,0,0
16693,,,__fsk_yk1203,0,1,1,0,1,1,0,0,1,1,1,0
16694,,,Iuvjaa,4,2,6,4,2,6,0.2,0.026749,1,1,1,3
16695,,,Mardell76694157,0,2,2,0,2,2,0,0,2,0.75,0.833333,0
16696,,,melodymuses,0,1,1,0,1,1,0,0,2,0.666667,0.75,0
16697,,,svtdking,0,1,1,0,1,1,0,0,2,0.666667,0.75,0
16698,,,Naestopaz,2,1,3,2,1,3,0.5,0.013374,0,0,0,0
16699,,,ipusamu211,0,1,1,0,1,1,0,0,1,1,1,0
16700,,,kpoptrash2011,0,1,1,0,1,1,0,0,1,1,1,0
16701,,,dddnasss,0,1,1,0,1,1,0,0,1,1,1,0
16702,,,DocsPSCbasics,1,1,2,1,1,2,0,0.006687,0,0,0,0
16703,,,drpersuasion,4,1,5,4,1,5,0.25,0.026749,0,0,0,0
16704,,,7_soty,0,1,1,0,1,1,0,0,1,1,1,0
16705,,,joonieandyoonie,0,1,1,0,1,1,0,0,1,1,1,0
16706,,,AnnaKateArnold,2,1,3,2,1,3,0.5,0.013374,0,0,0,0
16707,,,DanaKennedyLive,4,1,5,4,1,5,0.25,0.026749,0,0,0,0
16708,,,nancybrumfiel12,0,1,1,0,1,1,0,0,1,1,1,0
16709,,,Isitvalid,0,2,2,0,2,2,0,0,1,1,1,0
16710,,,Andrea_Arn_,9,1,10,9,1,10,0.111111,0.060184,0,0,0,0
16711,,,piscesxire,0,1,1,0,1,1,0,0,1,1,1,0
16712,,,nuest150312,0,1,1,0,1,1,0,0,1,1,1,0
16713,,,LaurenDownSouth,0,1,1,0,1,1,0,0,1,1,1,0
16714,,,CNj65,0,1,1,0,1,1,0,0,1,1,1,0
16715,,,lil_pio_pio,0,1,1,0,1,1,0,0,1,1,1,0
16716,,,old_osc,0,1,1,0,1,1,0,0,1,1,1,0
16717,,,xylgbt,8,1,9,8,1,9,0.125,0.053497,0,0,0,0
16718,,,sapphicwon,0,1,1,0,1,1,0,0,1,1,1,0
16719,,,universcas,0,1,1,0,1,1,0,0,1,1,1,0
16720,,,ContestThursday,0,1,1,0,1,1,0,0,1,1,1,0
16721,,,Auroranced,0,1,1,0,1,1,0,0,1,1,1,0
16722,,,LOVEJP72801213,0,1,1,0,1,1,0,0,1,1,1,0
16723,,,AnnieOPopoAgie,0,1,1,0,1,1,0,0,1,1,1,0
16724,,,SusinBailey59,0,1,1,0,1,1,0,0,1,1,1,0
16725,,,punkdmyg,16,1,17,17,1,18,0.0625,0.19718,0,0,0,0
16726,,,bnava_mx,0,1,1,0,1,1,0,0,1,1,1,0
16727,,,bb0unluvr,0,1,1,0,1,1,0,0,1,1,1,0
16728,,,sincerely_steff,0,1,1,0,1,1,0,0,1,1,1,0
16729,,,leo_dias_17,0,1,1,0,1,1,0,0,1,1,1,0
16730,,,CadenHall48,0,1,1,0,1,1,0,0,1,1,1,0
16731,,,EmpathDemocracy,0,1,1,0,1,1,0,0,1,1,1,0
16732,,,giannina2021,0,1,1,0,1,1,0,0,1,1,1,0
16733,,,_quarterbaek,0,1,1,0,1,1,0,0,1,1,1,0
16734,,,IPhone_mbmx,0,1,1,0,1,1,0,0,1,1,1,0
16735,,,soobingbingbing,0,1,1,0,1,1,0,0,1,1,1,0
16736,,,_kbabyyyyyy,0,1,1,0,1,1,0,0,1,1,1,0
16737,,,PumaBaker,0,1,1,0,1,1,0,0,1,1,1,0
16738,,,SadieMercedez,0,1,1,0,1,1,0,0,1,1,1,0
16739,,,wells_bonita,0,1,1,0,1,1,0,0,1,1,1,0
16740,,,Rio_DeRiver,0,1,1,0,1,1,0,0,1,1,1,0
16741,,,tepungpelitas,0,1,1,0,1,1,0,0,1,1,1,0
16742,,,jim_sonaglia,0,2,2,0,2,2,0,0,1,1,1,0
16743,,,ElinaWite,0,1,1,0,1,1,0,0,1,1,1,0
16744,,,kitamako1,2,1,3,2,1,3,0.5,0.013374,0,0,0,0
16745,,,juicijeon,0,1,1,0,1,1,0,0,1,1,1,0
16746,,,TonyNam3,3,1,4,3,1,4,0.333333,0.020061,0,0,0,0
16747,,,yourhighnessx_,0,1,1,0,1,1,0,0,1,1,1,0
16748,,,KDollaske,0,1,1,0,1,1,0,0,1,1,1,0
16749,,,namjoonsais,2,1,3,2,1,3,0.5,0.013374,0,0,0,0
16750,,,dazaipeach,0,1,1,0,1,1,0,0,1,1,1,0
16751,,,intakxjiung,4,1,5,4,1,5,0.25,0.033737,0,0,0,0
16752,,,pettitbunny,0,1,1,0,1,1,0,0,1,1,1,0
16753,,,R1FigureSkating,3,1,4,3,1,4,0.333333,0.020061,0,0,0,0
16754,,,Kk11Zh,0,1,1,0,1,1,0,0,1,1,1,0
16755,,,EnComedy_,0,1,1,0,1,1,0,0,1,1,1,0
16756,,,yakan__hiko,0,1,1,0,1,1,0,0,1,1,1,0
16757,,,AyaHitaisyou,0,1,1,0,1,1,0,0,1,1,1,0
16758,,,aswaggerprince,0,1,1,0,1,1,0,0,1,1,1,0
16759,,,ZXXKYN,0,1,1,0,1,1,0,0,1,1,1,0
16760,,,5315Yoonji,0,1,1,0,1,1,0,0,1,1,1,0
16761,,,hanyu_yzru,0,2,2,0,2,2,0,0,2,0.75,0.833333,0
16762,,,steffyHurkos,0,1,1,0,1,1,0,0,1,1,1,0
16763,,,jiminkissable,0,1,1,0,1,1,0,0,1,1,1,0
16764,,,dino_dinamo,0,1,1,0,1,1,0,0,1,1,1,0
16765,,,sumitba16854935,0,1,1,0,1,1,0,0,1,1,1,0
16766,,,rickflies,0,1,1,0,1,1,0,0,1,1,1,0
16767,,,wilso103,0,1,1,0,1,1,0,0,1,1,1,0
16768,,,Fruityy_Taee,0,1,1,0,1,1,0,0,1,1,1,0
16769,,,sellingittrue,0,1,1,0,1,1,0,0,1,1,1,0
16770,,,Omiko_skates,0,1,1,0,1,1,0,0,1,1,1,0
16771,,,skjn_loml,0,1,1,0,1,1,0,0,1,1,1,0
16772,,,narikoongkoong,3,1,4,3,1,4,0.333333,0.020061,0,0,0,0
16773,,,titiktitikblank,0,1,1,0,1,1,0,0,1,1,1,0
16774,,,ima_zanato,0,1,1,0,1,1,0,0,1,1,1,0
16775,,,kyle_fb,3,1,4,3,1,4,0.333333,0.020061,0,0,0,0
16776,,,howls__calcifer,0,1,1,0,1,1,0,0,1,1,1,0
16777,,,roziumu,0,1,1,0,1,1,0,0,1,1,1,0
16778,,,mirbrandnew,2,1,3,2,1,3,0.5,0.013374,0,0,0,0
16779,,,ABSFSU1,0,2,2,0,2,2,0,0,1,1,1,0
16780,,,ebyrdstarr,6,1,7,6,1,7,0.166667,0.040123,0,0,0,0
16781,,,True23B,0,1,1,0,1,1,0,0,1,1,1,0
16782,,,RosieDLawler,0,1,1,0,1,1,0,0,1,1,1,0
16783,,,zoeeee1669,0,1,1,0,1,1,0,0,1,1,1,0
16784,,,0802yg,0,1,1,0,1,1,0,0,1,1,1,0
16785,,,TheSliceTweets,11,1,12,11,1,12,0.090909,0.073559,0,0,0,0
16786,,,madroe,0,1,1,0,1,1,0,0,1,1,1,0
16787,,,Fartmir,0,1,1,0,1,1,0,0,1,1,1,0
16788,,,reneeg1147,0,1,1,0,1,1,0,0,1,1,1,0
16789,,,jenoglow,0,1,1,0,1,1,0,0,1,1,1,0
16790,,,essayareayaitch,0,1,1,0,1,1,0,0,1,1,1,0
16791,,,The_Earl_of_Ram,0,1,1,0,1,1,0,0,1,1,1,0
16792,,,hazelcabanana,4,1,5,4,1,5,0.25,0.026749,0,0,0,0
16793,,,JessCristobalx,0,1,1,0,1,1,0,0,1,1,1,0
16794,,,shihofluffy,0,1,1,0,1,1,0,0,1,1,1,0
16795,,,astrajuno,0,1,1,0,1,1,0,0,3,0.5,0.525641,0
16796,,,HollyGoLight23,0,1,1,0,1,1,0,0,3,0.5,0.525641,0
16797,,,2JoWwi8HYUOEakU,0,1,1,0,1,1,0,0,3,0.5,0.525641,0
16798,,,eluddo,0,1,1,0,1,1,0,0,3,0.5,0.525641,0
16799,,,Frances06068426,5,1,6,5,1,6,0.2,0.033436,0,0,0,0
16800,,,N0B4R4,0,1,1,0,1,1,0,0,1,1,1,0
16801,,,jackieann529,0,1,1,0,1,1,0,0,1,1,1,0
16802,,,hopewerse,0,1,1,0,1,1,0,0,1,1,1,0
16803,,,meshell_ritchie,0,1,1,0,1,1,0,0,1,1,1,0
16804,,,jofum,2,1,3,2,1,3,0.5,0.013374,0,0,0,0
16805,,,yuzuru_666,0,1,1,0,1,1,0,0,1,1,1,0
16806,,,j1007J2,2,1,3,2,1,3,0.5,0.013374,0,0,0,0
16807,,,bmaya8,0,1,1,0,1,1,0,0,1,1,1,0
16808,,,Oline_Marie,3,1,4,3,1,4,0.333333,0.020061,0,0,0,0
16809,,,jjkpisces,0,1,1,0,1,1,0,0,1,1,1,0
16810,,,anxzai,2,1,3,2,1,3,0.5,0.013374,0,0,0,0
16811,,,KSJ_addict,0,1,1,0,1,1,0,0,1,1,1,0
16812,,,poormeowmeow,1,1,2,1,1,2,0,0.006687,0,0,0,0
16813,,,papayaskins,1,1,2,1,1,2,0,0.006687,0,0,0,0
16814,,,mcrn00,0,1,1,0,1,1,0,0,1,1,1,0
16815,,,meliprivt,0,1,1,0,1,1,0,0,1,1,1,0
16816,,,MikaMSwanson,0,1,1,0,1,1,0,0,1,1,1,0
16817,,,paprika_nutmeg,0,1,1,0,1,1,0,0,2,0.666667,0.75,0
16818,,,Whalien52Wings_,0,1,1,0,1,1,0,0,2,0.666667,0.75,0
16819,,,WyattmcmanusAL,0,1,1,0,1,1,0,0,2,0.666667,0.75,0
16820,,,unico_pukika,0,1,1,0,1,1,0,0,1,1,1,0
16821,,,mslindasim,0,1,1,0,1,1,0,0,1,1,1,0
16822,,,susanh121,4,1,5,4,1,5,0.25,0.026749,0,0,0,0
16823,,,KBracamonte00,0,1,1,0,1,1,0,0,1,1,1,0
16824,,,jamesostis,0,1,1,0,1,1,0,0,1,1,1,0
16825,,,BlackJackDeuce1,0,1,1,0,1,1,0,0,1,1,1,0
16826,,,robin_howe,3,1,4,3,1,4,0.333333,0.020061,0,0,0,0
16827,,,cjcaruso2,0,1,1,0,1,1,0,0,1,1,1,0
16828,,,nigeta9,0,1,1,0,1,1,0,0,1,1,1,0
16829,,,Tbirdflieshigh,3,1,4,3,1,4,0.333333,0.020061,0,0,0,0
16830,,,WaterPrincess95,0,1,1,0,1,1,0,0,1,1,1,0
16831,,,ItsmeEddieC,2,1,3,2,1,3,0.5,0.013374,0,0,0,0
16832,,,followcindy,0,1,1,0,1,1,0,0,1,1,1,0
16833,,,em_buerger,0,1,1,0,1,1,0,0,1,1,1,0
16834,,,hyyhqueer,0,1,1,0,1,1,0,0,1,1,1,0
16835,,,TRBL_MANOBAL,6,1,7,6,1,7,0.166667,0.040123,0,0,0,0
16836,,,LAYouthElite,0,1,1,0,1,1,0,0,1,1,1,0
16837,,,dhershiser,0,1,1,0,1,1,0,0,1,1,1,0
16838,,,TSSPhotos,0,1,1,0,1,1,0,0,1,1,1,0
16839,,,SusanWDavis3,0,1,1,0,1,1,0,0,1,1,1,0
16840,,,b0z0milo,0,1,1,0,1,1,0,0,1,1,1,0
16841,,,juliemooliemoo,1,1,2,1,1,2,0,0.006687,0,0,0,0
16842,,,arbiteroftaste,2,1,3,2,1,3,0.5,0.013374,0,0,0,0
16843,,,127hotgirls,0,1,1,0,1,1,0,0,1,1,1,0
16844,,,JasonHuckLewis,4,1,5,4,1,5,0.25,0.026749,0,0,0,0
16845,,,galsaeg_piano,0,1,1,0,1,1,0,0,1,1,1,0
16846,,,namulver,0,1,1,0,1,1,0,0,1,1,1,0
16847,,,33simaenaga,0,1,1,0,1,1,0,0,1,1,1,0
16848,,,13teroktober,0,1,1,0,1,1,0,0,1,1,1,0
16849,,,eeileenn8,0,1,1,0,1,1,0,0,1,1,1,0
16850,,,favsaturday,0,1,1,0,1,1,0,0,2,0.666667,0.75,0
16851,,,incieI,0,1,1,0,1,1,0,0,2,0.666667,0.75,0
16852,,,CH4NGZHU,0,1,1,0,1,1,0,0,2,0.666667,0.75,0
16853,,,VKing3000,3,1,4,3,1,4,0.333333,0.020061,0,0,0,0
16854,,,12345zhou1,0,1,1,0,1,1,0,0,1,1,1,0
16855,,,gayjkkers,0,1,1,0,1,1,0,0,1,1,1,0
16856,,,VKing3005,4,1,5,4,1,5,0.25,0.026749,0,0,0,0
16857,,,jaydeedublew,0,1,1,0,1,1,0,0,1,1,1,0
16858,,,EugeneSFu,0,1,1,0,1,1,0,0,1,1,1,0
16859,,,suguruT__T,0,1,1,0,1,1,0,0,1,1,1,0
16860,,,38chi___,0,1,1,0,1,1,0,0,1,1,1,0
16861,,,howlshstar,0,1,1,0,1,1,0,0,1,1,1,0
16862,,,ShijeSings,0,1,1,0,1,1,0,0,1,1,1,0
16863,,,CentristRn,0,1,1,0,1,1,0,0,1,1,1,0
16864,,,thepadawanlives,0,1,1,0,1,1,0,0,1,1,1,0
16865,,,prodbykbk,0,1,1,0,1,1,0,0,1,1,1,0
16866,,,TheNewtster,3,1,4,3,1,4,0.333333,0.020061,0,0,0,0
16867,,,KathyReynolds11,0,1,1,0,1,1,0,0,1,1,1,0
16868,,,Roiyaru_diamond,0,1,1,0,1,1,0,0,1,1,1,0
16869,,,SMentemployee,14,1,15,15,1,16,0.071429,0.09362,0,0,0,0
16870,,,BeckyBeSoLoved,0,1,1,0,1,1,0,0,1,1,1,0
16871,,,OeilVert_Lucina,0,1,1,0,1,1,0,0,1,1,1,0
16872,,,Chara24000,0,1,1,0,1,1,0,0,1,1,1,0
16873,,,PARKCHANWCCK,0,1,1,0,1,1,0,0,1,1,1,0
16874,,,tracy_coffey,0,1,1,0,1,1,0,0,1,1,1,0
16875,,,unoooome,0,1,1,0,1,1,0,0,1,1,1,0
16876,,,Luccchen,0,1,1,0,1,1,0,0,1,1,1,0
16877,,,NewsUMissed2021,0,1,1,0,1,1,0,0,1,1,1,0
16878,,,springdayNSFW,0,1,1,0,1,1,0,0,1,1,1,0
16879,,,krysxkai,0,1,1,0,1,1,0,0,1,1,1,0
16880,,,gfherald,2,1,3,2,1,3,0.5,0.013374,0,0,0,0
16881,,,zizomeimei,0,1,1,0,1,1,0,0,1,1,1,0
16882,,,WStachelberg,9,1,10,9,1,10,0.111111,0.060184,0,0,0,0
16883,,,11k00ks,0,1,1,0,1,1,0,0,1,1,1,0
16884,,,DarkTao1,0,1,1,0,1,1,0,0,1,1,1,0
16885,,,rampotea,0,1,1,0,1,1,0,0,1,1,1,0
16886,,,noturprettygal,0,1,1,0,1,1,0,0,1,1,1,0
16887,,,_BubsBunny_,0,1,1,0,1,1,0,0,1,1,1,0
16888,,,SAILORMOONDIOR,0,1,1,0,1,1,0,0,1,1,1,0
16889,,,CarolLimburg,1,1,2,1,1,2,0,0.006687,0,0,0,0
16890,,,Ythrift,3,1,4,3,1,4,0.333333,0.020061,0,0,0,0
16891,,,venatswife,0,5,5,0,5,5,0,0,1,1,1,0
16892,,,JinXunGoh,0,1,1,0,1,1,0,0,1,1,1,0
16893,,,derangous,0,1,1,0,1,1,0,0,1,1,1,0
16894,,,neoteeztangx,0,1,1,0,1,1,0,0,1,1,1,0
16895,,,pattys0033,0,1,1,0,1,1,0,0,1,1,1,0
16896,,,shegotnoass,0,1,1,0,1,1,0,0,1,1,1,0
16897,,,LisieFfxiv,0,1,1,0,1,1,0,0,1,1,1,0
16898,,,eringreeson,4,1,5,4,1,5,0.25,0.026749,0,0,0,0
16899,,,rdjSiacj1,0,1,1,0,1,1,0,0,1,1,1,0
16900,,,hobiguang,0,1,1,0,1,1,0,0,1,1,1,0
16901,,,leftypatriot,0,1,1,0,1,1,0,0,2,0.666667,0.75,0
16902,,,esquilina,0,1,1,0,1,1,0,0,2,0.666667,0.75,0
16903,,,tg14926,0,1,1,0,1,1,0,0,2,0.666667,0.75,0
16904,,,dannophofanno,0,1,1,0,1,1,0,0,2,0.666667,0.75,0
16905,,,MyTake48,0,1,1,0,1,1,0,0,2,0.666667,0.75,0
16906,,,rouyindraws,0,1,1,0,1,1,0,0,2,0.666667,0.75,0
16907,,,vivavo511,0,1,1,0,1,1,0,0,2,0.666667,0.75,0
16908,,,ye_ziling,0,1,1,0,1,1,0,0,2,0.666667,0.75,0
16909,,,amanda522,0,1,1,0,1,1,0,0,2,0.666667,0.75,0
16910,,,guerinsmaness,0,1,1,0,1,1,0,0,2,0.666667,0.75,0
16911,,,cschultzde,0,4,4,0,4,4,0,0,2,0.833333,0.9,0
16912,,,KgrDUmEhViMgpyu,0,1,1,0,1,1,0,0,2,0.666667,0.75,0
16913,,,bunxianying,0,1,1,0,1,1,0,0,1,1,1,0
16914,,,__bddaeng,8,1,9,8,1,9,0.125,0.053497,0,0,0,0
16915,,,shanshanshanlei,0,1,1,0,1,1,0,0,1,1,1,0
16916,,,Bhairav97073039,0,1,1,0,1,1,0,0,1,1,1,0
16917,,,sweetmomb,0,1,1,0,1,1,0,0,1,1,1,0
16918,,,SCVIndy,0,1,1,0,1,1,0,0,1,1,1,0
16919,,,riasangelina,0,1,1,0,1,1,0,0,1,1,1,0
16920,,,compulsivewritr,2,1,3,2,1,3,0.5,0.013374,0,0,0,0
16921,,,koresflowerpath,0,1,1,0,1,1,0,0,1,1,1,0
16922,,,genXatwork,1,1,2,1,1,2,0,0.006687,0,0,0,0
16923,,,cornelialmurray,2,1,3,2,1,3,0.5,0.013374,0,0,0,0
16924,,,carmomonteiro10,0,1,1,0,1,1,0,0,1,1,1,0
16925,,,djtomhanks,1,1,2,1,1,2,0,0.006687,0,0,0,0
16926,,,RICKSAUTOSALES,1,1,2,1,1,2,0,0.006687,0,0,0,0
16927,,,oatlovr,8,1,9,8,1,9,0.125,0.053497,0,0,0,0
16928,,,shop_komomo,0,1,1,0,1,1,0,0,1,1,1,0
16929,,,Garzeeee,0,1,1,0,1,1,0,0,1,1,1,0
16930,,,patriciacsym,0,1,1,0,1,1,0,0,1,1,1,0
16931,,,A_lex_alex,0,1,1,0,1,1,0,0,1,1,1,0
16932,,,pizzayeols,0,1,1,0,1,1,0,0,1,1,1,0
16933,,,RuffStarnes,0,1,1,0,1,1,0,0,1,1,1,0
16934,,,shownuakgae,22,1,23,23,2,25,0.045455,0.163209,0,0,0,0
16935,,,ProudAFAmerican,0,1,1,0,1,1,0,0,1,1,1,0
16936,,,Acotan58,0,1,1,0,1,1,0,0,1,1,1,0
16937,,,hampdrh,0,1,1,0,1,1,0,0,1,1,1,0
16938,,,oeuf_de_shoma,0,1,1,0,1,1,0,0,1,1,1,0
16939,,,resistnow116,0,1,1,0,1,1,0,0,1,1,1,0
16940,,,VodkaSrups,0,1,1,0,1,1,0,0,1,1,1,0
16941,,,connachtpa,0,1,1,0,1,1,0,0,1,1,1,0
16942,,,ReesaRocco,0,1,1,0,1,1,0,0,1,1,1,0
16943,,,Kissing_Noir,0,1,1,0,1,1,0,0,1,1,1,0
16944,,,Challnge2Xtians,0,1,1,0,1,1,0,0,1,1,1,0
16945,,,SabroSenpai,0,1,1,0,1,1,0,0,1,1,1,0
16946,,,Sarcher,0,1,1,0,1,1,0,0,1,1,1,0
16947,,,jaeminjojowain,0,1,1,0,1,1,0,0,1,1,1,0
16948,,,voiceoftear,0,1,1,0,1,1,0,0,1,1,1,0
16949,,,uwustarry,0,1,1,0,1,1,0,0,1,1,1,0
16950,,,tarruuuh,0,1,1,0,1,1,0,0,1,1,1,0
16951,,,MDemalteris,0,1,1,0,1,1,0,0,1,1,1,0
16952,,,CoachJeffMonken,0,1,1,0,1,1,0,0,1,1,1,0
16953,,,trzrfilter,0,1,1,0,1,1,0,0,1,1,1,0
16954,,,rpaigebooks,2,1,3,2,1,3,0.5,0.013374,0,0,0,0
16955,,,Lycenia,1,1,2,1,1,2,0,0.006687,0,0,0,0
16956,,,PeacePhilosophy,1,1,2,1,1,2,0,0.006687,0,0,0,0
16957,,,NotSoProudYank,4,1,5,4,1,5,0.25,0.026749,0,0,0,0
16958,,,fishingirls,0,1,1,0,1,1,0,0,1,1,1,0
16959,,,oshtuntun,0,1,1,0,1,1,0,0,1,1,1,0
16960,,,IntheAyer14,0,1,1,0,1,1,0,0,1,1,1,0
16961,,,caseys_tweets,7,1,8,7,1,8,0.142857,0.04681,0,0,0,0
16962,,,PrunedaLiz,0,1,1,0,1,1,0,0,1,1,1,0
16963,,,seeehem,0,1,1,0,1,1,0,0,1,1,1,0
16964,,,GrSuzie,0,1,1,0,1,1,0,0,1,1,1,0
16965,,,gumivku,0,1,1,0,1,1,0,0,1,1,1,0
16966,,,GaileHolly,15,1,16,15,1,16,0.066667,0.100307,0,0,0,0
16967,,,silveraloe,0,1,1,0,1,1,0,0,1,1,1,0
16968,,,minyumki,0,1,1,0,1,1,0,0,1,1,1,0
16969,,,lesbohope,0,1,1,0,1,1,0,0,1,1,1,0
16970,,,taeIindo,0,1,1,0,1,1,0,0,1,1,1,0
16971,,,dahlianekoforov,0,1,1,0,1,1,0,0,1,1,1,0
16972,,,sarahlarue81,0,1,1,0,1,1,0,0,1,1,1,0
16973,,,41BaB,0,1,1,0,1,1,0,0,1,1,1,0
16974,,,soonimooni,0,1,1,0,1,1,0,0,1,1,1,0
16975,,,chadmoussignac,0,1,1,0,1,1,0,0,1,1,1,0
16976,,,harmonycalathea,0,1,1,0,1,1,0,0,1,1,1,0
16977,,,PiperGT,0,1,1,0,1,1,0,0,1,1,1,0
16978,,,Gmhernandez09,0,1,1,0,1,1,0,0,1,1,1,0
16979,,,baegu1,2,1,3,2,1,3,0.5,0.013374,0,0,0,0
16980,,,Spruce_ville,0,1,1,0,1,1,0,0,1,1,1,0
16981,,,kaydel13,1,1,2,1,1,2,0,0.006687,0,0,0,0
16982,,,maitake127,0,1,1,0,1,1,0,0,1,1,1,0
16983,,,shartur_,0,1,1,0,1,1,0,0,1,1,1,0
16984,,,intelligentYuzu,0,1,1,0,1,1,0,0,1,1,1,0
16985,,,pissukuna,0,2,2,0,2,2,0,0,1,1,1,0
16986,,,MsJenJWalker,0,1,1,0,1,1,0,0,1,1,1,0
16987,,,Missboojee,0,1,1,0,1,1,0,0,1,1,1,0
16988,,,KtYLaw1,0,1,1,0,1,1,0,0,1,1,1,0
16989,,,it4bito,0,1,1,0,1,1,0,0,1,1,1,0
16990,,,dgleick,5,1,6,5,1,6,0.2,0.033436,0,0,0,0
16991,,,cancergirl1969,0,1,1,0,1,1,0,0,1,1,1,0
16992,,,Mayawatii2,0,1,1,0,1,1,0,0,1,1,1,0
16993,,,HANAKCORE,3,1,4,3,1,4,0.333333,0.020061,0,0,0,0
16994,,,snacksoobin,0,1,1,0,1,1,0,0,1,1,1,0
16995,,,pcattry,2,1,3,2,1,3,0.5,0.071327,0,0,0,0
16996,,,feannem,3,1,4,3,1,4,0.333333,0.020061,0,0,0,0
16997,,,0613_tear,0,1,1,0,1,1,0,0,1,1,1,0
16998,,,cruelkth,4,1,5,5,2,7,0.25,0.055606,0,0,0,0
16999,,,MoondogRick2,3,1,4,3,1,4,0.333333,0.020061,0,0,0,0
17000,,,ODedOnRealityTV,0,1,1,0,1,1,0,0,1,1,1,0
17001,,,LeslyeColvin,7,1,8,7,1,8,0.142857,0.04681,0,0,0,0
17002,,,Tripmunk_,0,1,1,0,1,1,0,0,1,1,1,0
17003,,,sskones55,0,1,1,0,1,1,0,0,1,1,1,0
17004,,,jav_slepper,0,1,1,0,1,1,0,0,1,1,1,0
17005,,,ohtanisbetch,0,1,1,0,1,1,0,0,1,1,1,0
17006,,,SaveMeRealM3,0,1,1,0,1,1,0,0,1,1,1,0
17007,,,sohnricluv,9,1,10,10,2,12,0.111111,0.067173,0,0,0,0
17008,,,Stargazingpingu,0,1,1,0,1,1,0,0,1,1,1,0
17009,,,glossvinyls,0,1,1,0,1,1,0,0,1,1,1,0
17010,,,lysdanilys,0,1,1,0,1,1,0,0,1,1,1,0
17011,,,annehayhay,1,1,2,1,1,2,0,0.006687,0,0,0,0
17012,,,mcdonuough,0,1,1,0,1,1,0,0,2,0.666667,0.75,0
17013,,,ScottCottos,1,1,2,1,1,2,0,0.006687,0,0,0,0
17014,,,gravitypegasus_,0,1,1,0,1,1,0,0,1,1,1,0
17015,,,mojac_,0,1,1,0,1,1,0,0,1,1,1,0
17016,,,DGComedy,1,1,2,1,1,2,0,0.006687,0,0,0,0
17017,,,jiunist,9,1,10,9,1,10,0.111111,0.060184,0,0,0,0
17018,,,iirrationaI,0,1,1,0,1,1,0,0,1,1,1,0
17019,,,jhteardior,0,1,1,0,1,1,0,0,1,1,1,0
17020,,,AlecAHernandez,0,1,1,0,1,1,0,0,1,1,1,0
17021,,,shresrz,0,1,1,0,1,1,0,0,1,1,1,0
17022,,,kemilyv,0,1,1,0,1,1,0,0,1,1,1,0
17023,,,reytaemin,0,1,1,0,1,1,0,0,1,1,1,0
17024,,,sugareverie,0,1,1,0,1,1,0,0,1,1,1,0
17025,,,pupchannie,0,1,1,0,1,1,0,0,1,1,1,0
17026,,,rtheinley,8,11,19,8,11,19,0.055556,0.056991,2,0.857143,0.916667,84
17027,,,RFStaats,0,1,1,0,1,1,0,0,1,1,1,0
17028,,,VladBering,0,1,1,0,1,1,0,0,1,1,1,0
17029,,,TeddyNews1,0,1,1,0,1,1,0,0,1,1,1,0
17030,,,gluv488,0,1,1,0,1,1,0,0,1,1,1,0
17031,,,SimplyBeckyyy,0,1,1,0,1,1,0,0,1,1,1,0
17032,,,CardGuide_,1,1,2,1,1,2,0,0.006687,0,0,0,0
17033,,,schrekerman,8,1,9,8,1,9,0.125,0.060486,0,0,0,0
17034,,,AORainmaker,0,1,1,0,1,1,0,0,1,1,1,0
17035,,,TheSwaynesWorld,0,1,1,0,1,1,0,0,1,1,1,0
17036,,,theechriswhite,0,1,1,0,1,1,0,0,1,1,1,0
17037,,,KevMakesThings,0,1,1,0,1,1,0,0,1,1,1,0
17038,,,sydneymoore106,0,1,1,0,1,1,0,0,1,1,1,0
17039,,,ASAPedro831,4,1,5,4,1,5,0.25,0.055606,0,0,0,0
17040,,,DT042674,2,1,3,2,1,3,0.5,0.013374,0,0,0,0
17041,,,yangtimes2,2,1,3,2,1,3,0.5,0.020363,0,0,0,0
17042,,,JCBua,4,1,5,4,1,5,0.25,0.026749,0,0,0,0
17043,,,ktlnmrgt,0,1,1,0,1,1,0,0,1,1,1,0
17044,,,raukon,9,1,10,9,1,10,0.111111,0.060184,0,0,0,0
17045,,,talkative__f,0,1,1,0,1,1,0,0,1,1,1,0
17046,,,JFein13,0,1,1,0,1,1,0,0,1,1,1,0
17047,,,kmishiiro,0,2,2,0,2,2,0,0,1,1,1,0
17048,,,hanratta_cho,0,1,1,0,1,1,0,0,1,1,1,0
17049,,,n2movies,0,1,1,0,1,1,0,0,1,1,1,0
17050,,,koski_cheryl,2,1,3,2,1,3,0.5,0.013374,0,0,0,0
17051,,,nofunnywomen,0,2,2,0,2,2,0,0,1,1,1,0
17052,,,hwhjluvr,2,1,3,2,1,3,0.5,0.013374,0,0,0,0
17053,,,TanyaStowe1,0,1,1,0,1,1,0,0,1,1,1,0
17054,,,hikaphelion,3,1,4,3,1,4,0.333333,0.020061,0,0,0,0
17055,,,rcmariko,0,1,1,0,1,1,0,0,1,1,1,0
17056,,,AnnaCCallahan,0,2,2,0,2,2,0,0,1,1,1,0
17057,,,Amarillo_Mae,0,1,1,0,1,1,0,0,1,1,1,0
17058,,,shadowpupetz,4,1,5,4,1,5,0.25,0.026749,0,0,0,0
17059,,,adelyaklmcll,0,1,1,0,1,1,0,0,1,1,1,0
17060,,,taekvss,3,1,4,3,1,4,0.333333,0.020061,0,0,0,0
17061,,,GoodHealthIdea1,0,1,1,0,1,1,0,0,1,1,1,0
17062,,,drew24u,3,1,4,3,1,4,0.333333,0.020061,0,0,0,0
17063,,,InsideOutDG,0,1,1,0,1,1,0,0,1,1,1,0
17064,,,thptpth,3,1,4,3,1,4,0.333333,0.020061,0,0,0,0
17065,,,yuzushohei,0,1,1,0,1,1,0,0,1,1,1,0
17066,,,patchworkpyro,0,2,2,0,2,2,0,0,1,1,1,0
17067,,,KellyOGrady2,4,1,5,4,1,5,0.25,0.026749,0,0,0,0
17068,,,yunzut_t,0,1,1,0,1,1,0,0,1,1,1,0
17069,,,piscesbitch123,0,1,1,0,1,1,0,0,1,1,1,0
17070,,,flopgumi,4,1,5,4,1,5,0.25,0.026749,0,0,0,0
17071,,,albythere_,0,1,1,0,1,1,0,0,1,1,1,0
17072,,,MurielVieux,0,1,1,0,1,1,0,0,1,1,1,0
17073,,,daffodil139,2,1,3,2,1,3,0.5,0.013374,0,0,0,0
17074,,,SoniCubed,0,1,1,0,1,1,0,0,1,1,1,0
17075,,,VentusFowl,0,1,1,0,1,1,0,0,1,1,1,0
17076,,,ourroseylife,0,1,1,0,1,1,0,0,1,1,1,0
17077,,,bright1950start,0,1,1,0,1,1,0,0,1,1,1,0
17078,,,DrPickle13,7,1,8,7,1,8,0.142857,0.054992,0,0,0,0
17079,,,Kattica7100,0,1,1,0,1,1,0,0,1,1,1,0
17080,,,CaseyJoseph22,0,1,1,0,1,1,0,0,1,1,1,0
17081,,,TreeHugger_77,0,1,1,0,1,1,0,0,1,1,1,0
17082,,,majisukamican,0,1,1,0,1,1,0,0,1,1,1,0
17083,,,marcambinder,2,1,3,2,1,3,0.5,0.013374,0,0,0,0
17084,,,needypetal,0,1,1,0,1,1,0,0,1,1,1,0
17085,,,zachevanstweets,1,1,2,1,1,2,0,0.006687,0,0,0,0
17086,,,TaraKMarron,1,1,2,1,1,2,0,0.006687,0,0,0,0
17087,,,natasharomanox,9,1,10,9,1,10,0.111111,0.089041,0,0,0,0
17088,,,JohanFelipe94,0,1,1,0,1,1,0,0,1,1,1,0
17089,,,shc902,0,1,1,0,1,1,0,0,1,1,1,0
17090,,,VELO_2000M,0,1,1,0,1,1,0,0,1,1,1,0
17091,,,ingrid_wander,0,2,2,0,2,2,0,0,1,1,1,0
17092,,,Blue2Being,1,1,2,1,1,2,0,0.006687,0,0,0,0
17093,,,Shannizle6,4,1,5,4,1,5,0.25,0.026749,0,0,0,0
17094,,,kamisato_trash,0,1,1,0,1,1,0,0,1,1,1,0
17095,,,JavItAll,0,1,1,0,1,1,0,0,1,1,1,0
17096,,,LindaSurovich,3,1,4,3,1,4,0.333333,0.020061,0,0,0,0
17097,,,jjkmakeitright,0,1,1,0,1,1,0,0,1,1,1,0
17098,,,intheboob,0,1,1,0,1,1,0,0,1,1,1,0
17099,,,JungleJuiceJoel,1,1,2,1,1,2,0,0.006687,0,0,0,0
17100,,,seeyougaycowboy,3,1,4,3,1,4,0.333333,0.020061,0,0,0,0
17101,,,noeldecan2,2,1,3,2,1,3,0.5,0.013374,0,0,0,0
17102,,,NYCiLOVEu,0,1,1,0,1,1,0,0,1,1,1,0
17103,,,nbrooks17,2,1,3,2,1,3,0.5,0.013374,0,0,0,0
17104,,,muchavocado,1,1,2,1,1,2,0,0.006687,0,0,0,0
17105,,,toastandtaylor,2,1,3,2,1,3,0.5,0.013374,0,0,0,0
17106,,,jennycook266,0,1,1,0,1,1,0,0,1,1,1,0
17107,,,Brandi_Gadson,1,1,2,1,1,2,0,0.006687,0,0,0,0
17108,,,EdwinLockridge,1,1,2,1,1,2,0,0.006687,0,0,0,0
17109,,,stephanie_rita,1,1,2,1,1,2,0,0.006687,0,0,0,0
17110,,,Dadatts,2,1,3,2,1,3,0.5,0.013374,0,0,0,0
17111,,,minimerc4,0,1,1,0,1,1,0,0,1,1,1,0
17112,,,erin_oppy,2,1,3,2,1,3,0.5,0.013374,0,0,0,0
17113,,,signoradee,0,1,1,0,1,1,0,0,1,1,1,0
17114,,,Benjamin_sdw05,1,1,2,1,1,2,0,0.006687,0,0,0,0
17115,,,mics_travels,0,1,1,0,1,1,0,0,3,0.5,0.611111,0
17116,,,MrsMcGee_Health,4,1,5,4,1,5,0.25,0.026749,0,0,0,0
17117,,,MaaferMoraless,0,1,1,0,1,1,0,0,1,1,1,0
17118,,,AuntSophie1,0,1,1,0,1,1,0,0,1,1,1,0
17119,,,supalonelygorl,2,1,3,2,1,3,0.5,0.013374,0,0,0,0
17120,,,1047wonkfm,1,1,2,1,1,2,0,0.006687,0,0,0,0
17121,,,churdle76,6,1,7,6,1,7,0.166667,0.06898,0,0,0,0
17122,,,Sui9001,0,1,1,0,1,1,0,0,1,1,1,0
17123,,,artist_texas,0,1,1,0,1,1,0,0,1,1,1,0
17124,,,bangtanreasons,0,1,1,0,1,1,0,0,1,1,1,0
17125,,,savisstrange,1,1,2,1,1,2,0,0.006687,0,0,0,0
17126,,,KathrynSinde,1,1,2,1,1,2,0,0.006687,0,0,0,0
17127,,,Charlievannjr,3,1,4,3,1,4,0.333333,0.020061,0,0,0,0
17128,,,ouatlover468,0,1,1,0,1,1,0,0,1,1,1,0
17129,,,gracenegron,4,1,5,4,1,5,0.25,0.026749,0,0,0,0
17130,,,ChiefofECT,0,1,1,0,1,1,0,0,1,1,1,0
17131,,,scoupsnation,0,3,3,0,3,3,0,0,1,1,1,0
17132,,,Rabble29,0,1,1,0,1,1,0,0,1,1,1,0
17133,,,NewHampshireGrl,2,1,3,2,1,3,0.5,0.013374,0,0,0,0
17134,,,sylvain_pharand,0,1,1,0,1,1,0,0,1,1,1,0
17135,,,Mahoney,1,1,2,1,1,2,0,0.006687,0,0,0,0
17136,,,ShyShyRo,0,1,1,0,1,1,0,0,1,1,1,0
17137,,,miguelf0618,2,1,3,2,1,3,0.5,0.013374,0,0,0,0
17138,,,mopetting,1,1,2,1,1,2,0,0.006687,0,0,0,0
17139,,,AutowriterDan,2,1,3,2,1,3,0.5,0.013374,0,0,0,0
17140,,,noawest,0,1,1,0,1,1,0,0,1,1,1,0
17141,,,jiggieboii,1,1,2,1,1,2,0,0.006687,0,0,0,0
17142,,,philkight1,1,1,2,1,1,2,0,0.006687,0,0,0,0
17143,,,JimmyP215,1,1,2,1,1,2,0,0.006687,0,0,0,0
17144,,,SpiritsTraveler,2,1,3,2,1,3,0.5,0.013374,0,0,0,0
17145,,,actedebmoore,0,1,1,0,1,1,0,0,1,1,1,0
17146,,,allisonk1130,4,1,5,4,1,5,0.25,0.026749,0,0,0,0
17147,,,M00nChildAna,0,1,1,0,1,1,0,0,1,1,1,0
17148,,,ThaniaVegaP,0,1,1,0,1,1,0,0,1,1,1,0
17149,,,ktbridy,2,1,3,2,1,3,0.5,0.013374,0,0,0,0
17150,,,voidmelancholy_,0,1,1,0,1,1,0,0,4,0.37931,0.44697,0
17151,,,Rose02639741,0,1,1,0,1,1,0,0,4,0.37931,0.44697,0
17152,,,david_darmofal,1,1,2,1,1,2,0,0.006687,0,0,0,0
17153,,,Tyann98,2,1,3,2,1,3,0.5,0.020363,0,0,0,0
17154,,,Taurusgirl1980,2,2,4,2,2,4,0.333333,0.013374,1,1,1,1
17155,,,CathyOConnell12,1,1,2,1,1,2,0,0.006687,0,0,0,0
17156,,,hannahebrooks1,2,1,3,2,1,3,0.5,0.013374,0,0,0,0
17157,,,DonnaCrawford33,0,1,1,0,1,1,0,0,1,1,1,0
17158,,,sam_reeve13,1,1,2,1,1,2,0,0.006687,0,0,0,0
17159,,,gay_seniors,1,1,2,1,1,2,0,0.006687,0,0,0,0
17160,,,edatrix,1,1,2,1,1,2,0,0.006687,0,0,0,0
17161,,,pilartimpane,3,1,4,3,1,4,0.333333,0.020061,0,0,0,0
17162,,,flowerlady610,1,1,2,1,1,2,0,0.006687,0,0,0,0
17163,,,Haley1313,1,1,2,1,1,2,0,0.006687,0,0,0,0
17164,,,NaderDahdaleh,5,1,6,5,1,6,0.2,0.033436,0,0,0,0
17165,,,illPRiL,0,1,1,0,1,1,0,0,1,1,1,0
17166,,,Filternscaa,0,2,2,0,2,2,0,0,1,1,1,0
17167,,,BradBeauregardJ,0,1,1,0,1,1,0,0,1,1,1,0
17168,,,lankrc,3,1,4,3,1,4,0.333333,0.020061,0,0,0,0
17169,,,ieatwindows,1,1,2,1,1,2,0,0.006687,0,0,0,0
17170,,,Dmehrt,1,1,2,1,1,2,0,0.006687,0,0,0,0
17171,,,catboyminyoongi,0,1,1,0,1,1,0,0,1,1,1,0
17172,,,sugarcxlt,1,1,2,1,1,2,0,0.006687,0,0,0,0
17173,,,EyeHateHeels,1,1,2,1,1,2,0,0.006687,0,0,0,0
17174,,,Laura_Lamming,1,1,2,1,1,2,0,0.006687,0,0,0,0
17175,,,katelynjewel28,3,1,4,3,1,4,0.333333,0.020061,0,0,0,0
17176,,,luvrseiko,0,1,1,0,1,1,0,0,1,1,1,0
17177,,,_moonchild_JK_,0,1,1,0,1,1,0,0,1,1,1,0
17178,,,JerrianaKaitlyn,1,1,2,1,1,2,0,0.006687,0,0,0,0
17179,,,cooper_megs,1,1,2,1,1,2,0,0.006687,0,0,0,0
17180,,,kscincotta,4,1,5,4,1,5,0.25,0.026749,0,0,0,0
17181,,,madrid_M77,0,1,1,0,1,1,0,0,1,1,1,0
17182,,,newswest9,2,1,3,2,1,3,0.5,0.013374,0,0,0,0
17183,,,somebtsfan,0,1,1,0,1,1,0,0,1,1,1,0
17184,,,swethamaresan,1,1,2,1,1,2,0,0.006687,0,0,0,0
17185,,,JasonStump4,1,1,2,1,1,2,0,0.006687,0,0,0,0
17186,,,Carolyn68825925,1,1,2,1,1,2,0,0.006687,0,0,0,0
17187,,,jeppiesunbuns,1,1,2,1,1,2,0,0.006687,0,0,0,0
17188,,,MikeC22453774,1,1,2,1,1,2,0,0.006687,0,0,0,0
17189,,,kbaxadams,2,1,3,2,1,3,0.5,0.013374,0,0,0,0
17190,,,argovox,0,1,1,0,1,1,0,0,1,1,1,0
17191,,,lilfruitsz,1,1,2,1,1,2,0,0.006687,0,0,0,0
17192,,,_GatorGal,2,1,3,2,1,3,0.5,0.027351,0,0,0,0
17193,,,JVATaxnLaw,1,1,2,1,1,2,0,0.006687,0,0,0,0
17194,,,snyder_jennifer,8,1,9,8,1,9,0.125,0.053497,0,0,0,0
17195,,,taurusz_89,0,1,1,0,1,1,0,0,1,1,1,0
17196,,,MJBangtann,0,1,1,0,1,1,0,0,1,1,1,0
17197,,,charbutterfly,0,1,1,0,1,1,0,0,1,1,1,0
17198,,,yuzu120733,0,1,1,0,1,1,0,0,1,1,1,0
17199,,,qinghuii,0,1,1,0,1,1,0,0,1,1,1,0
17200,,,limitlesshc,0,1,1,0,1,1,0,0,1,1,1,0
17201,,,ClemsTiger828,1,1,2,1,1,2,0,0.006687,0,0,0,0
17202,,,weatuu,1,1,2,1,1,2,0,0.006687,0,0,0,0
17203,,,swimmingphan,1,1,2,1,1,2,0,0.006687,0,0,0,0
17204,,,kaitguad,2,1,3,2,1,3,0.5,0.013374,0,0,0,0
17205,,,Mvrcus_VD,0,1,1,0,1,1,0,0,1,1,1,0
17206,,,cbomb12,1,1,2,1,1,2,0,0.006687,0,0,0,0
17207,,,tyunsarangs,2,1,3,2,1,3,0.5,0.013374,0,0,0,0
17208,,,eliredman,0,1,1,0,1,1,0,0,1,1,1,0
17209,,,KristenCurrieTV,2,1,3,2,1,3,0.5,0.013374,0,0,0,0
17210,,,sasscatalog,0,2,2,0,2,2,0,0,1,1,1,0
17211,,,whatdaKEL,2,1,3,2,1,3,0.5,0.013374,0,0,0,0
17212,,,Jacob_J_Nelson,3,1,4,3,1,4,0.333333,0.020061,0,0,0,0
17213,,,NeoDrosia,0,1,1,0,1,1,0,0,1,1,1,0
17214,,,pinkytrash,0,1,1,0,1,1,0,0,1,1,1,0
17215,,,kjb27,1,1,2,1,1,2,0,0.006687,0,0,0,0
17216,,,JodiSwan928,1,1,2,1,1,2,0,0.006687,0,0,0,0
17217,,,smokobythechats,1,1,2,1,1,2,0,0.006687,0,0,0,0
17218,,,gamecockwm,4,1,5,4,1,5,0.25,0.026749,0,0,0,0
17219,,,goldminie,0,1,1,0,1,1,0,0,1,1,1,0
17220,,,ChelseakMcGuire,1,1,2,1,1,2,0,0.006687,0,0,0,0
17221,,,theNaseemMalik,1,1,2,1,1,2,0,0.006687,0,0,0,0
17222,,,_RobYo,1,1,2,1,1,2,0,0.006687,0,0,0,0
17223,,,kdnavis,1,1,2,1,1,2,0,0.006687,0,0,0,0
17224,,,omgitsemilyward,1,1,2,1,1,2,0,0.006687,0,0,0,0
17225,,,RaginHomunculus,1,1,2,1,1,2,0,0.006687,0,0,0,0
17226,,,MeaghanGallagh1,1,1,2,1,1,2,0,0.006687,0,0,0,0
17227,,,TheReggieParks,1,1,2,1,1,2,0,0.006687,0,0,0,0
17228,,,iam_barbaraann,1,1,2,1,1,2,0,0.006687,0,0,0,0
17229,,,andrevvdef,1,1,2,1,1,2,0,0.006687,0,0,0,0
17230,,,ayyyitslyss,2,1,3,2,1,3,0.5,0.013374,0,0,0,0
17231,,,_jmele,0,1,1,0,1,1,0,0,1,1,1,0
17232,,,marrobison,1,1,2,1,1,2,0,0.006687,0,0,0,0
17233,,,NedShneebIy,3,1,4,3,1,4,0.333333,0.020061,0,0,0,0
17234,,,jooniecosmic,0,1,1,0,1,1,0,0,1,1,1,0
17235,,,AokanoLovebird,0,1,1,0,1,1,0,0,1,1,1,0
17236,,,michelleerin,1,1,2,1,1,2,0,0.006687,0,0,0,0
17237,,,izzypost,3,1,4,3,1,4,0.333333,0.020061,0,0,0,0
17238,,,cIoversana,0,4,4,0,4,4,0,0,1,1,1,0
17239,,,hearts4hisu,0,1,1,0,1,1,0,0,1,1,1,0
17240,,,bridgettheoreo,1,1,2,1,1,2,0,0.006687,0,0,0,0
17241,,,jaeheehours,2,1,3,2,1,3,0.5,0.013374,0,0,0,0
17242,,,bryantwing,0,1,1,0,1,1,0,0,1,1,1,0
17243,,,EmilyM_Little,2,1,3,2,1,3,0.5,0.013374,0,0,0,0
17244,,,quirky_chrissy,1,1,2,1,1,2,0,0.006687,0,0,0,0
17245,,,carlys987,1,1,2,1,1,2,0,0.006687,0,0,0,0
17246,,,DaliDimovski,3,1,4,3,1,4,0.333333,0.034038,0,0,0,0
17247,,,IoneIyvapor,2,1,3,2,1,3,0.5,0.013374,0,0,0,0
17248,,,bayls27,0,2,2,0,2,2,0,0,1,1,1,0
17249,,,ChristineSimna1,0,1,1,0,1,1,0,0,1,1,1,0
17250,,,ProfeSmithLA,1,1,2,1,1,2,0,0.006687,0,0,0,0
17251,,,queerogre,2,1,3,2,1,3,0.5,0.013374,0,0,0,0
17252,,,misslizzz_,1,1,2,1,1,2,0,0.006687,0,0,0,0
17253,,,MeredithJJacobs,2,1,3,2,1,3,0.5,0.013374,0,0,0,0
17254,,,ElDuffey,2,1,3,2,1,3,0.5,0.069282,0,0,0,0
17255,,,buttdick69,2,1,3,2,1,3,0.5,0.013374,0,0,0,0
17256,,,muffette2,0,1,1,0,1,1,0,0,1,1,1,0
17257,,,FelixtheTurtle,6,1,7,6,1,7,0.166667,0.06898,0,0,0,0
17258,,,AngieNBCLA,0,1,1,0,1,1,0,0,1,1,1,0
17259,,,CelestiaLilly,0,1,1,0,1,1,0,0,1,1,1,0
17260,,,EML22,0,2,2,0,2,2,0,0,1,1,1,0
17261,,,Failingatthis,1,1,2,2,2,4,0,0.006687,0,0,0,0
17262,,,TomHam11,1,1,2,1,1,2,0,0.006687,0,0,0,0
17263,,,tweyant,3,1,4,3,1,4,0.333333,0.020061,0,0,0,0
17264,,,xijiao,0,1,1,0,1,1,0,0,1,1,1,0
17265,,,suzettesmith,2,1,3,2,1,3,0.5,0.013374,0,0,0,0
17266,,,jolingkent,1,1,2,1,1,2,0,0.006687,0,0,0,0
17267,,,marlenarose9,1,1,2,1,1,2,0,0.006687,0,0,0,0
17268,,,CarlyLM13,2,1,3,2,1,3,0.5,0.013374,0,0,0,0
17269,,,StyloDad,0,1,1,0,1,1,0,0,1,1,1,0
17270,,,hi_im_cassie,1,1,2,1,1,2,0,0.006687,0,0,0,0
17271,,,alexamoore_,5,1,6,5,1,6,0.2,0.033436,0,0,0,0
17272,,,iamsuniesevn,0,1,1,0,1,1,0,0,1,1,1,0
17273,,,jazzrat2000,0,1,1,0,1,1,0,0,1,1,1,0
17274,,,Eric18utah,1,1,2,1,1,2,0,0.006687,0,0,0,0
17275,,,waterywhore,1,1,2,1,1,2,0,0.006687,0,0,0,0
17276,,,christhereboot,1,1,2,1,1,2,0,0.006687,0,0,0,0
17277,,,irlkatebishop,2,1,3,2,1,3,0.5,0.013374,0,0,0,0
17278,,,galaderons,1,1,2,1,1,2,0,0.006687,0,0,0,0
17279,,,hypensbangteez,1,1,2,1,1,2,0,0.006687,0,0,0,0
17280,,,HolmesPSU,3,1,4,3,1,4,0.333333,0.020061,0,0,0,0
17281,,,joetrader6,0,1,1,0,1,1,0,0,1,1,1,0
17282,,,BrittanyReimer2,2,1,3,2,1,3,0.5,0.013374,0,0,0,0
17283,,,Yukichi93514537,0,1,1,0,1,1,0,0,1,1,1,0
17284,,,jouous,0,1,1,0,1,1,0,0,1,1,1,0
17285,,,MommaPowerr,0,1,1,0,1,1,0,0,1,1,1,0
17286,,,kimchi_warui,0,1,1,0,1,1,0,0,1,1,1,0
17287,,,BillyHoward423,12,1,13,14,2,16,0.083333,0.109103,0,0,0,0
17288,,,nevermO54,2,1,3,2,1,3,0.5,0.013374,0,0,0,0
17289,,,reevesj2014,0,1,1,0,1,1,0,0,1,1,1,0
17290,,,AasimirSeraph,2,1,3,2,1,3,0.5,0.013374,0,0,0,0
17291,,,sandymccandles4,0,1,1,0,1,1,0,0,1,1,1,0
17292,,,mediocremorgan,3,1,4,3,1,4,0.333333,0.020061,0,0,0,0
17293,,,naidagn,0,2,2,0,2,2,0,0,2,0.625,0.7,0
17294,,,mattkoz,1,1,2,1,1,2,0,0.006687,0,0,0,0
17295,,,subinbff,2,1,3,2,1,3,0.5,0.013374,0,0,0,0
17296,,,lynnecolcombe2,0,1,1,0,1,1,0,0,1,1,1,0
17297,,,sopdet,1,1,2,1,1,2,0,0.006687,0,0,0,0
17298,,,bossassrn,1,1,2,1,1,2,0,0.006687,0,0,0,0
17299,,,SM00Z,4,1,5,4,1,5,0.25,0.026749,0,0,0,0
17300,,,SN00PYC0RE,0,1,1,0,1,1,0,0,1,1,1,0
17301,,,lazybon20269115,0,1,1,0,1,1,0,0,1,1,1,0
17302,,,AshDee04,3,1,4,3,1,4,0.333333,0.020061,0,0,0,0
17303,,,LadyMeerket,0,1,1,0,1,1,0,0,1,1,1,0
17304,,,koniro4lo,0,1,1,0,1,1,0,0,1,1,1,0
17305,,,cassjackson_22,2,1,3,2,1,3,0.5,0.013374,0,0,0,0
17306,,,former_jr,2,1,3,2,1,3,0.5,0.013374,0,0,0,0
17307,,,hazukicc,0,1,1,0,1,1,0,0,1,1,1,0
17308,,,margo1942,1,1,2,1,1,2,0,0.006687,0,0,0,0
17309,,,TheCursiveJ,2,1,3,2,1,3,0.5,0.013374,0,0,0,0
17310,,,EVIESDRAGON,0,1,1,0,1,1,0,0,1,1,1,0
17311,,,Watchinga,1,1,2,1,1,2,0,0.006687,0,0,0,0
17312,,,_jra5,1,1,2,1,1,2,0,0.006687,0,0,0,0
17313,,,seokurablossoms,0,1,1,0,1,1,0,0,1,1,1,0
17314,,,sqx_believer,0,1,1,0,1,1,0,0,1,1,1,0
17315,,,yuzushoma1,0,1,1,0,1,1,0,0,1,1,1,0
17316,,,djny02,0,1,1,0,1,1,0,0,1,1,1,0
17317,,,PatrickOplease,0,1,1,0,1,1,0,0,1,1,1,0
17318,,,KeyOfCikavac,0,1,1,0,1,1,0,0,1,1,1,0
17319,,,songayju,0,1,1,0,1,1,0,0,1,1,1,0
17320,,,bobbyxbanks,1,1,2,1,1,2,0,0.006687,0,0,0,0
17321,,,DMart_9,2,1,3,2,1,3,0.5,0.013374,0,0,0,0
17322,,,debo315,0,1,1,0,1,1,0,0,1,1,1,0
17323,,,breakin_downYow,0,2,2,0,2,2,0,0,1,1,1,0
17324,,,vinzkth,0,1,1,0,1,1,0,0,1,1,1,0
17325,,,rainbowpeach30,0,1,1,0,1,1,0,0,1,1,1,0
17326,,,penski23,0,1,1,0,1,1,0,0,1,1,1,0
17327,,,mytimekoo,0,1,1,0,1,1,0,0,1,1,1,0
17328,,,eirahoang246,0,1,1,0,1,1,0,0,1,1,1,0
17329,,,bydearJK,0,1,1,0,1,1,0,0,1,1,1,0
17330,,,asmmaur7,0,1,1,0,1,1,0,0,1,1,1,0
17331,,,etherealinen,0,1,1,0,1,1,0,0,1,1,1,0
17332,,,GCupcake17,1,1,2,1,1,2,0,0.006687,0,0,0,0
17333,,,letterbombs,3,1,4,3,1,4,0.333333,0.020061,0,0,0,0
17334,,,sohali2012,1,1,2,1,1,2,0,0.006687,0,0,0,0
17335,,,itsainsley6,1,1,2,1,1,2,0,0.006687,0,0,0,0
17336,,,dizzygrl05,4,1,5,4,1,5,0.25,0.026749,0,0,0,0
17337,,,ArlineNet,0,1,1,0,1,1,0,0,1,1,1,0
17338,,,vivi_yvette,0,1,1,0,1,1,0,0,1,1,1,0
17339,,,yukkoncon,0,1,1,0,1,1,0,0,1,1,1,0
17340,,,fakelexapro,16,1,17,17,1,18,0.0625,0.167288,0,0,0,0
17341,,,yolandamn15,0,1,1,0,1,1,0,0,1,1,1,0
17342,,,baektoru,0,1,1,0,1,1,0,0,1,1,1,0
17343,,,NNIKJ_,0,1,1,0,1,1,0,0,1,1,1,0
17344,,,LynettaHalat,0,1,1,0,1,1,0,0,1,1,1,0
17345,,,toxic__skulls,0,1,1,0,1,1,0,0,1,1,1,0
17346,,,ElizabethGee2D2,0,1,1,0,1,1,0,0,1,1,1,0
17347,,,babybluemask,0,1,1,0,1,1,0,0,1,1,1,0
17348,,,aphros67,0,1,1,0,1,1,0,0,1,1,1,0
17349,,,uranuswt,0,1,1,0,1,1,0,0,1,1,1,0
17350,,,kheer28,0,1,1,0,1,1,0,0,1,1,1,0
17351,,,c060t494,3,1,4,3,1,4,0.333333,0.048919,0,0,0,0
17352,,,hldstdy,1,1,2,1,1,2,0,0.006687,0,0,0,0
17353,,,ThrowN_TheTowel,9,1,10,9,1,10,0.111111,0.143381,0,0,0,0
17354,,,oni3543,0,1,1,0,1,1,0,0,1,1,1,0
17355,,,tententuyutuyu,0,1,1,0,1,1,0,0,1,1,1,0
17356,,,Yuqigg,0,1,1,0,1,1,0,0,1,1,1,0
17357,,,polysoundman,0,1,1,0,1,1,0,0,1,1,1,0
17358,,,YE0N0IR,0,1,1,0,1,1,0,0,1,1,1,0
17359,,,naileabilly,0,1,1,0,1,1,0,0,1,1,1,0
17360,,,vsunny14,0,1,1,0,1,1,0,0,1,1,1,0
17361,,,cjo42a,0,1,1,0,1,1,0,0,2,0.571429,0.625,0
17362,,,shawneebadger,1,1,2,1,1,2,0,0.006687,0,0,0,0
17363,,,therea1mcc0y,1,1,2,1,1,2,0,0.006687,0,0,0,0
17364,,,chicawis,0,1,1,0,1,1,0,0,3,0.481481,0.512821,0
17365,,,hoootenanny,0,1,1,0,1,1,0,0,3,0.481481,0.512821,0
17366,,,ventimademegae,0,1,1,0,1,1,0,0,3,0.481481,0.512821,0
17367,,,hobi_kore,0,1,1,0,1,1,0,0,3,0.481481,0.512821,0
17368,,,oppamana,0,1,1,0,1,1,0,0,3,0.481481,0.512821,0
17369,,,joeyannax,0,1,1,0,1,1,0,0,3,0.481481,0.512821,0
17370,,,masakointer,2,1,3,2,1,3,0.5,0.013374,0,0,0,0
17371,,,LootTheHounds,0,1,1,0,1,1,0,0,1,1,1,0
17372,,,razecals,0,1,1,0,1,1,0,0,1,1,1,0
17373,,,_sunzawa,1,1,2,1,1,2,0,0.006687,0,0,0,0
17374,,,loriegabidel,1,1,2,1,1,2,0,0.006687,0,0,0,0
17375,,,WonhosSideTiddy,0,1,1,0,1,1,0,0,1,1,1,0
17376,,,yeonjjunineun,0,1,1,0,1,1,0,0,1,1,1,0
17377,,,homoerratic,0,1,1,0,1,1,0,0,1,1,1,0
17378,,,RebelliousMag,0,1,1,0,1,1,0,0,1,1,1,0
17379,,,BASELINE182,0,1,1,0,1,1,0,0,1,1,1,0
17380,,,milk_powderr,0,1,1,0,1,1,0,0,1,1,1,0
17381,,,pinkbassist,0,1,1,0,1,1,0,0,1,1,1,0
17382,,,Bra_Gerald,7,1,8,7,1,8,0.142857,0.065815,0,0,0,0
17383,,,korino27855638,0,1,1,0,1,1,0,0,1,1,1,0
17384,,,pwoon48783,0,1,1,0,1,1,0,0,1,1,1,0
17385,,,hobispritebuddy,0,1,1,0,1,1,0,0,1,1,1,0
17386,,,lizlemonness,0,1,1,0,1,1,0,0,1,1,1,0
17387,,,howatto_cake,0,1,1,0,1,1,0,0,1,1,1,0
17388,,,LLcoolJCY,1,1,2,1,1,2,0,0.006687,0,0,0,0
17389,,,bohndrake,1,1,2,1,1,2,0,0.006687,0,0,0,0
17390,,,fluoritegf,1,1,2,1,1,2,0,0.006687,0,0,0,0
17391,,,mdabski,4,1,5,4,1,5,0.25,0.026749,0,0,0,0
17392,,,calcara_tina,0,1,1,0,1,1,0,0,1,1,1,0
17393,,,tenchiyyuzu,0,1,1,0,1,1,0,0,1,1,1,0
17394,,,amy_hundley,1,1,2,1,1,2,0,0.006687,0,0,0,0
17395,,,brittanyyyh_,3,1,4,3,1,4,0.333333,0.020061,0,0,0,0
17396,,,Bryan36519307,0,1,1,0,1,1,0,0,1,1,1,0
17397,,,Stefmara,5,1,6,5,1,6,0.2,0.033436,0,0,0,0
17398,,,JuanDamian2012,0,1,1,0,1,1,0,0,1,1,1,0
17399,,,yukipoko114,0,1,1,0,1,1,0,0,1,1,1,0
17400,,,cdorso,6,1,7,6,1,7,0.166667,0.040123,0,0,0,0
17401,,,Scj8WSniWlkC0V5,0,1,1,0,1,1,0,0,1,1,1,0
17402,,,thisis4uhoney,0,1,1,0,1,1,0,0,1,1,1,0
17403,,,kimyunggie,0,1,1,0,1,1,0,0,1,1,1,0
17404,,,bianca__neve,0,1,1,0,1,1,0,0,1,1,1,0
17405,,,pucksnpurls,6,1,7,6,1,7,0.166667,0.040123,0,0,0,0
17406,,,600selRin,0,1,1,0,1,1,0,0,1,1,1,0
17407,,,Yz1207wings,0,1,1,0,1,1,0,0,1,1,1,0
17408,,,i09510,0,1,1,0,1,1,0,0,1,1,1,0
17409,,,umbrellhoes,0,1,1,0,1,1,0,0,1,1,1,0
17410,,,zeroruIes,6,1,7,6,1,7,0.166667,0.040123,0,0,0,0
17411,,,zackmomma,0,1,1,0,1,1,0,0,1,1,1,0
17412,,,Needy_Messed_Up,0,1,1,0,1,1,0,0,1,1,1,0
17413,,,asahimitadas,0,1,1,0,1,1,0,0,1,1,1,0
17414,,,TBone51S,0,1,1,0,1,1,0,0,1,1,1,0
17415,,,ynwaryam,0,1,1,0,1,1,0,0,1,1,1,0
17416,,,stephengriswold,8,1,9,8,1,9,0.125,0.06398,0,0,0,0
17417,,,jeonpayesha,0,1,1,0,1,1,0,0,1,1,1,0
17418,,,Aqua_sarasvati,0,1,1,0,1,1,0,0,1,1,1,0
17419,,,jhnnykyun,0,1,1,0,1,1,0,0,1,1,1,0
17420,,,ferKatsss,0,1,1,0,1,1,0,0,1,1,1,0
17421,,,TANNlESKOO,0,1,1,0,1,1,0,0,1,1,1,0
17422,,,1_nob,0,1,1,0,1,1,0,0,1,1,1,0
17423,,,Lala63217481,0,1,1,0,1,1,0,0,1,1,1,0
17424,,,ujiverse_fairy,0,1,1,0,1,1,0,0,1,1,1,0
17425,,,Levciel12,0,1,1,0,1,1,0,0,2,0.666667,0.75,0
17426,,,shilpams1,0,1,1,0,1,1,0,0,2,0.666667,0.75,0
17427,,,CherylBatchelo3,2,1,3,2,1,3,0.5,0.013374,0,0,0,0
17428,,,Janna1104day,0,1,1,0,1,1,0,0,1,1,1,0
17429,,,JessicaKenney_,1,1,2,1,1,2,0,0.006687,0,0,0,0
17430,,,doughnut_Nath,8,1,9,8,1,9,0.125,0.070968,0,0,0,0
17431,,,strawberrytatae,0,1,1,0,1,1,0,0,1,1,1,0
17432,,,terusbf,0,1,1,0,1,1,0,0,1,1,1,0
17433,,,collinsfeKAMG,0,1,1,0,1,1,0,0,1,1,1,0
17434,,,kiriseok,0,1,1,0,1,1,0,0,1,1,1,0
17435,,,Decervelage,0,1,1,0,1,1,0,0,1,1,1,0
17436,,,akarin_217,0,1,1,0,1,1,0,0,1,1,1,0
17437,,,DougJohnson,1,1,2,1,1,2,0,0.006687,0,0,0,0
17438,,,AkilaWhite,2,1,3,2,1,3,0.5,0.013374,0,0,0,0
17439,,,ladynoir,5,1,6,5,1,6,0.2,0.033436,0,0,0,0
17440,,,nanaxelexe,0,1,1,0,1,1,0,0,1,1,1,0
17441,,,WadeJiangHe,0,1,1,0,1,1,0,0,1,1,1,0
17442,,,FoxSports_1280,4,1,5,4,1,5,0.25,0.026749,0,0,0,0
17443,,,honeyskeleton,0,1,1,0,1,1,0,0,1,1,1,0
17444,,,yeonjurs,0,1,1,0,1,1,0,0,1,1,1,0
17445,,,notisaparker,0,1,1,0,1,1,0,0,1,1,1,0
17446,,,putonahat,0,1,1,0,1,1,0,0,1,1,1,0
17447,,,BLlNKRISE,5,1,6,5,1,6,0.2,0.033436,0,0,0,0
17448,,,iCaNtBrEaThSTOP,0,1,1,0,1,1,0,0,1,1,1,0
17449,,,jbindeck_b,0,1,1,0,1,1,0,0,1,1,1,0
17450,,,Minichyna01,0,1,1,0,1,1,0,0,1,1,1,0
17451,,,KookSupremacyy,0,1,1,0,1,1,0,0,1,1,1,0
17452,,,Yoya_jaay,0,1,1,0,1,1,0,0,1,1,1,0
17453,,,THV11,4,1,5,4,1,5,0.25,0.026749,0,0,0,0
17454,,,yoongbwi,0,1,1,0,1,1,0,0,1,1,1,0
17455,,,Mediev4ls,1,1,2,1,1,2,0,0.006687,0,0,0,0
17456,,,dragontarts,2,1,3,2,1,3,0.5,0.013374,0,0,0,0
17457,,,HEEJAYSPECS,0,1,1,0,1,1,0,0,1,1,1,0
17458,,,_sincerely_nia,2,1,3,2,1,3,0.5,0.069282,0,0,0,0
17459,,,120956326holic,3,1,4,3,1,4,0.333333,0.020061,0,0,0,0
17460,,,alehg8tor,0,1,1,0,1,1,0,0,1,1,1,0
17461,,,hoemomorphism,2,1,3,2,1,3,0.5,0.013374,0,0,0,0
17462,,,nitoujoutou,0,1,1,0,1,1,0,0,1,1,1,0
17463,,,brigadewatcher,1,1,2,1,1,2,0,0.006687,0,0,0,0
17464,,,estherprk,3,1,4,3,1,4,0.333333,0.020061,0,0,0,0
17465,,,VictoriousBard,7,1,8,7,1,8,0.142857,0.049537,0,0,0,0
17466,,,Adelene09442768,0,1,1,0,1,1,0,0,1,1,1,0
17467,,,jamiebellark,0,1,1,0,1,1,0,0,1,1,1,0
17468,,,oglilniggawol,0,1,1,0,1,1,0,0,1,1,1,0
17469,,,_bloodlines,0,1,1,0,1,1,0,0,1,1,1,0
17470,,,airyuun,0,1,1,0,1,1,0,0,1,1,1,0
17471,,,SteveNehf,19,1,20,19,1,20,0.052632,0.127056,0,0,0,0
17472,,,catmanthony,0,1,1,0,1,1,0,0,1,1,1,0
17473,,,i93myygs,0,1,1,0,1,1,0,0,1,1,1,0
17474,,,ranita_nuri,0,1,1,0,1,1,0,0,1,1,1,0
17475,,,hiiancd,0,1,1,0,1,1,0,0,1,1,1,0
17476,,,camerosvc,0,1,1,0,1,1,0,0,1,1,1,0
17477,,,judy_carlyle,0,1,1,0,1,1,0,0,1,1,1,0
17478,,,iB4NDY,0,1,1,0,1,1,0,0,1,1,1,0
17479,,,StriebRoman,0,1,1,0,1,1,0,0,1,1,1,0
17480,,,SteveFMilwaukee,0,1,1,0,1,1,0,0,1,1,1,0
17481,,,JamesTate121,0,1,1,0,1,1,0,0,1,1,1,0
17482,,,riseofthebrave1,0,1,1,0,1,1,0,0,1,1,1,0
17483,,,btseiu,0,1,1,0,1,1,0,0,1,1,1,0
17484,,,Kazu_Lawliet,0,1,1,0,1,1,0,0,1,1,1,0
17485,,,Porter_Anderson,1,1,2,1,1,2,0,0.006687,0,0,0,0
17486,,,galiIeogaliIei,6,1,7,6,1,7,0.166667,0.057594,0,0,0,0
17487,,,jessieopie,0,1,1,0,1,1,0,0,1,1,1,0
17488,,,FUBARPATTY,0,2,2,0,2,2,0,0,1,1,1,0
17489,,,pastelgothsolo,0,1,1,0,1,1,0,0,1,1,1,0
17490,,,LechitaBanana,0,1,1,0,1,1,0,0,1,1,1,0
17491,,,pixelmelter,0,1,1,0,1,1,0,0,2,0.571429,0.625,0
17492,,,jawja100,0,1,1,0,1,1,0,0,1,1,1,0
17493,,,abparrish083,0,1,1,0,1,1,0,0,1,1,1,0
17494,,,Victor_Yang17,0,1,1,0,1,1,0,0,1,1,1,0
17495,,,byunmink,0,1,1,0,1,1,0,0,1,1,1,0
17496,,,rainvvie,0,1,1,0,1,1,0,0,1,1,1,0
17497,,,FotiniOfficial,0,1,1,0,1,1,0,0,1,1,1,0
17498,,,world_news_ja,6,0,6,6,0,6,0,0.034668,0,0,0,0
17499,,,angiapn,2,0,2,2,0,2,0,0.00792,0,0,0,0
17500,,,Pequitass15,6,0,6,7,0,7,0,0.029214,0,0,0,0
17501,,,locutorya,3,0,3,3,0,3,0,0.01188,0,0,0,0
17502,,,kmhiyyih,9,0,9,9,0,9,0,0.044403,0,0,0,0
17503,,,mashupNY,5,0,5,5,0,5,0,0.030062,0,0,0,0
17504,,,MissDibs1,1,0,1,1,0,1,0,0.00396,0,0,0,0
17505,,,FRANMILY1,2,0,2,2,0,2,0,0.018829,0,0,0,0
17506,,,anitlalala,3,0,3,3,0,3,0,0.01188,0,0,0,0
17507,,,jaeminsano,1,0,1,1,0,1,0,0.00396,0,0,0,0
17508,,,jfilwyh,1,0,1,1,0,1,0,0.00396,0,0,0,0
17509,,,c6lossalt,1,0,1,1,0,1,0,0.00396,0,0,0,0
17510,,,ahoradaestella,1,0,1,1,0,1,0,0.00396,0,0,0,0
17511,,,notideportiva,5,0,5,5,0,5,0,0.0198,0,0,0,0
17512,,,stibbmaster,1,0,1,1,0,1,0,0.00396,0,0,0,0
17513,,,hisanao51,7,0,7,7,0,7,0,0.033174,0,0,0,0
17514,,,deportescnn,2,0,2,2,0,2,0,0.00792,0,0,0,0
17515,,,sroc113,1,0,1,1,0,1,0,0.00396,0,0,0,0
17516,,,hanyuandearth,1,0,1,1,0,1,0,0.00396,0,0,0,0
17517,,,Joyntcher,9,0,9,9,0,9,0,0.063679,0,0,0,0
17518,,,safarinight,9,0,9,9,0,9,0,0.082002,0,0,0,0
17519,,,nosoymajito,2,0,2,2,0,2,0,0.00792,0,0,0,0
17520,,,nanaosally_770,1,0,1,1,0,1,0,0.00396,0,0,0,0
17521,,,ogalinogalin,2,0,2,2,0,2,0,0.00792,0,0,0,0
17522,,,tshashin,5,0,5,5,0,5,0,0.022527,0,0,0,0
17523,,,YuzuruLatino,2,0,2,2,0,2,0,0.00792,0,0,0,0
17524,,,jurnaldevi,3,0,3,3,0,3,0,0.01188,0,0,0,0
17525,,,drewuntil,1,0,1,1,0,1,0,0.00396,0,0,0,0
17526,,,pearmelen,10,0,10,10,0,10,0,0.053235,0,0,0,0
17527,,,MarcaClaro,3,0,3,3,0,3,0,0.01188,0,0,0,0
17528,,,Areelb1,9,0,9,10,0,10,0,0.057051,0,0,0,0
17529,,,ale_soto_80,3,0,3,3,0,3,0,0.01188,0,0,0,0
17530,,,MET4LKYUN,2,0,2,2,0,2,0,0.00792,0,0,0,0
17531,,,esmariaaap,2,0,2,2,0,2,0,0.00792,0,0,0,0
17532,,,anodis,5,0,5,5,0,5,0,0.0198,0,0,0,0
17533,,,styIeclerc,1,0,1,1,0,1,0,0.012142,0,0,0,0
17534,,,moriyadoug,2,0,2,2,0,2,0,0.00792,0,0,0,0
17535,,,juegosolimpicos,4,0,4,4,0,4,0,0.01584,0,0,0,0
17536,,,woniexd,1,0,1,1,0,1,0,0.006687,0,0,0,0
17537,,,4ASLANJADE,2,0,2,2,0,2,0,0.00792,0,0,0,0
17538,,,tomiokazai,1,0,1,1,0,1,0,0.00396,0,0,0,0
17539,,,sutonfree,6,0,6,6,0,6,0,0.02376,0,0,0,0
17540,,,wtfmariaclara,2,0,2,2,0,2,0,0.00792,0,0,0,0
17541,,,pstamase,3,0,3,3,0,3,0,0.01188,0,0,0,0
17542,,,cassandraullaaa,1,0,1,1,0,1,0,0.00396,0,0,0,0
17543,,,Exposin09822121,1,0,1,1,0,1,0,0.00396,0,0,0,0
17544,,,GestapolicePoo,1,0,1,1,0,1,0,0.00396,0,0,0,0
17545,,,MaxHartung74,1,0,1,1,0,1,0,0.00396,0,0,0,0
17546,,,AlexisKarr7,3,0,3,3,0,3,0,0.014607,0,0,0,0
17547,,,Treasure0827,6,0,6,6,0,6,0,0.02376,0,0,0,0
17548,,,sicachuuuu,5,0,5,5,0,5,0,0.025254,0,0,0,0
17549,,,ibunnyzen,1,0,1,1,0,1,0,0.00396,0,0,0,0
17550,,,eduardomolon,3,0,3,3,0,3,0,0.018121,0,0,0,0
17551,,,alaravirus,3,0,3,3,0,3,0,0.01188,0,0,0,0
17552,,,IgorDomq,20,0,20,23,0,23,0,0.089144,0,0,0,0
17553,,,ssunshineforme,3,0,3,3,0,3,0,0.020061,0,0,0,0
17554,,,joykuroneko,17,0,17,17,0,17,0,0.086409,0,0,0,0
17555,,,eikotoda,6,0,6,6,0,6,0,0.02376,0,0,0,0
17556,,,gilroy_stanley,7,0,7,7,0,7,0,0.02772,0,0,0,0
17557,,,camiIIon,5,0,5,5,0,5,0,0.0198,0,0,0,0
17558,,,KarenWenLin,1,0,1,1,0,1,0,0.00396,0,0,0,0
17559,,,afpbb_spo,9,0,9,10,0,10,0,0.062911,0,0,0,0
17560,,,Ot7sCalico,11,0,11,11,0,11,0,0.043559,0,0,0,0
17561,,,UOJrjwKnQ26Lonj,5,0,5,5,0,5,0,0.0198,0,0,0,0
17562,,,dddc001,5,0,5,5,0,5,0,0.022527,0,0,0,0
17563,,,isklove2ver,1,0,1,1,0,1,0,0.00396,0,0,0,0
17564,,,Baktir,2,0,2,2,0,2,0,0.00792,0,0,0,0
17565,,,Ali_Jonas207,2,0,2,2,0,2,0,0.00792,0,0,0,0
17566,,,sateIIiteradio,4,0,4,4,0,4,0,0.01584,0,0,0,0
17567,,,mena_loverupees,12,0,12,13,0,13,0,0.054508,0,0,0,0
17568,,,yellowfairyy,5,0,5,5,0,5,0,0.0198,0,0,0,0
17569,,,wonuqirl,1,0,1,1,0,1,0,0.00396,0,0,0,0
17570,,,Marco1Raul,2,0,2,2,0,2,0,0.010647,0,0,0,0
17571,,,pandaljq,1,0,1,1,0,1,0,0.00396,0,0,0,0
17572,,,zrttxz,2,0,2,2,0,2,0,0.00792,0,0,0,0
17573,,,cxniluv,3,0,3,3,0,3,0,0.01188,0,0,0,0
17574,,,joshispa,3,0,3,3,0,3,0,0.01188,0,0,0,0
17575,,,5AWAMURA,6,0,6,7,0,7,0,0.02376,0,0,0,0
17576,,,Iuviestobio,2,0,2,2,0,2,0,0.00792,0,0,0,0
17577,,,Normaekerwin,2,0,2,2,0,2,0,0.010647,0,0,0,0
17578,,,kinamediase,4,0,4,4,0,4,0,0.026749,0,0,0,0
17579,,,DuarteMarcelo72,2,0,2,2,0,2,0,0.00792,0,0,0,0
17580,,,jacksonweho,1,0,1,1,0,1,0,0.00396,0,0,0,0
17581,,,gracegdays,3,0,3,3,0,3,0,0.039152,0,0,0,0
17582,,,sentidotrend,1,0,1,1,0,1,0,0.00396,0,0,0,0
17583,,,pinkbarbiecars,2,0,2,2,0,2,0,0.00792,0,0,0,0
17584,,,dalkaeul,10,0,10,10,0,10,0,0.039599,0,0,0,0
17585,,,KTSF26,4,0,4,6,0,6,0,0.01584,0,0,0,0
17586,,,andre170300,1,0,1,1,0,1,0,0.00396,0,0,0,0
17587,,,Kaaren_Juarez,1,0,1,1,0,1,0,0.00396,0,0,0,0
17588,,,BadbitchHanni,2,0,2,2,0,2,0,0.00792,0,0,0,0
17589,,,Edna_Montes,1,0,1,1,0,1,0,0.00396,0,0,0,0
17590,,,NEWS_JAPAN_S,2,0,2,2,0,2,0,0.00792,0,0,0,0
17591,,,justblindlove,1,0,1,1,0,1,0,0.00396,0,0,0,0
17592,,,Judyzzzz,1,0,1,1,0,1,0,0.009414,0,0,0,0
17593,,,lotus_shian,6,0,6,7,0,7,0,0.026487,0,0,0,0
17594,,,atodeboyz,2,0,2,2,0,2,0,0.016242,0,0,0,0
17595,,,Chenzilla1,12,0,12,12,0,12,0,0.047519,0,0,0,0
17596,,,SportsCrunch_US,3,0,3,3,0,3,0,0.055089,0,0,0,0
17597,,,bluempink,1,0,1,1,0,1,0,0.00396,0,0,0,0
17598,,,ZonaPriangan,1,0,1,1,0,1,0,0.00396,0,0,0,0
17599,,,sydblur,3,0,3,3,0,3,0,0.01188,0,0,0,0
17600,,,blaflorez,2,0,2,2,0,2,0,0.00792,0,0,0,0
17601,,,trtsporyildiz,2,0,2,2,0,2,0,0.00792,0,0,0,0
17602,,,jeffy202020,1,0,1,1,0,1,0,0.00396,0,0,0,0
17603,,,YHanyuBr,1,0,1,1,0,1,0,0.00396,0,0,0,0
17604,,,PaintTimeee,2,0,2,2,0,2,0,0.00792,0,0,0,0
17605,,,EvanHaChau7,4,0,4,4,0,4,0,0.01584,0,0,0,0
17606,,,Kentomiyauraaa,6,0,6,7,0,7,0,0.02376,0,0,0,0
17607,,,joostvormeer,3,0,3,3,0,3,0,0.01188,0,0,0,0
17608,,,VARLlNEAU,13,0,13,13,0,13,0,0.051479,0,0,0,0
17609,,,satomitw,1,0,1,1,0,1,0,0.00396,0,0,0,0
17610,,,RealtyPnw,11,0,11,11,0,11,0,0.043559,0,0,0,0
17611,,,_mz0taro,1,0,1,1,0,1,0,0.00396,0,0,0,0
17612,,,xoxoprincedie,3,0,3,3,0,3,0,0.01188,0,0,0,0
17613,,,meloxyas,2,0,2,2,0,2,0,0.00792,0,0,0,0
17614,,,sportovninoviny,6,0,6,6,0,6,0,0.02584,0,0,0,0
17615,,,MichaelWillmot7,8,0,8,8,0,8,0,0.03376,0,0,0,0
17616,,,TiffanyBxG,5,0,5,6,0,6,0,0.0198,0,0,0,0
17617,,,kwjoalin,1,0,1,1,0,1,0,0.00396,0,0,0,0
17618,,,PurpleGirlCloth,3,0,3,4,0,4,0,0.020061,0,0,0,0
17619,,,alillie70,2,0,2,2,0,2,0,0.00792,0,0,0,0
17620,,,panolan2,1,0,1,1,0,1,0,0.00396,0,0,0,0
17621,,,wybme,4,0,4,4,0,4,0,0.01584,0,0,0,0
17622,,,yuri030916,20,0,20,20,0,20,0,0.090108,0,0,0,0
17623,,,ellejapan,2,0,2,2,0,2,0,0.00792,0,0,0,0
17624,,,sanfran_972,2,0,2,2,0,2,0,0.00792,0,0,0,0
17625,,,Giselle15199822,4,0,4,4,0,4,0,0.01584,0,0,0,0
17626,,,whitebellsweet,1,0,1,1,0,1,0,0.00396,0,0,0,0
17627,,,schouffeur,1,0,1,1,0,1,0,0.00396,0,0,0,0
17628,,,loey_v,7,0,7,7,0,7,0,0.077551,0,0,0,0
17629,,,Moneibaxz,7,0,7,7,0,7,0,0.049537,0,0,0,0
17630,,,KrCloud_,3,0,3,5,0,5,0,0.01188,0,0,0,0
17631,,,moksapeggy,8,0,8,8,0,8,0,0.03168,0,0,0,0
17632,,,warlockkbg,1,0,1,1,0,1,0,0.00396,0,0,0,0
17633,,,AbrilSuppi,3,0,3,3,0,3,0,0.01188,0,0,0,0
17634,,,ChooLucia,1,0,1,1,0,1,0,0.00396,0,0,0,0
17635,,,Max_a_secas,7,0,7,7,0,7,0,0.02772,0,0,0,0
17636,,,bxgsolari,1,0,1,1,0,1,0,0.00396,0,0,0,0
17637,,,Mentimoen,7,0,7,7,0,7,0,0.02772,0,0,0,0
17638,,,interludelett,2,0,2,2,0,2,0,0.00792,0,0,0,0
17639,,,IoveguiIty,3,0,3,3,0,3,0,0.01396,0,0,0,0
17640,,,MerloFr,5,0,5,5,0,5,0,0.030709,0,0,0,0
17641,,,BenKingofQueenB,1,0,1,1,0,1,0,0.00396,0,0,0,0
17642,,,lawyer4laws,2,0,2,2,0,2,0,0.010647,0,0,0,0
17643,,,PepperInVegas,3,0,3,3,0,3,0,0.014607,0,0,0,0
17644,,,chaybulans,2,0,2,2,0,2,0,0.00792,0,0,0,0
17645,,,AdaAgui2820,7,0,7,7,0,7,0,0.02772,0,0,0,0
17646,,,srryilovu,1,0,1,1,0,1,0,0.00396,0,0,0,0
17647,,,yujaegod,7,0,7,7,0,7,0,0.02772,0,0,0,0
17648,,,ambulsiva,4,0,4,4,0,4,0,0.021294,0,0,0,0
17649,,,akinoriyura27,2,0,2,2,0,2,0,0.00792,0,0,0,0
17650,,,RazorSteph,1,0,1,1,0,1,0,0.00396,0,0,0,0
17651,,,v_ekkert,8,0,8,8,0,8,0,0.03168,0,0,0,0
17652,,,caopiertai,4,0,4,4,0,4,0,0.01584,0,0,0,0
17653,,,dangduangjai,8,0,8,8,0,8,0,0.038668,0,0,0,0
17654,,,mikaeIust,10,0,10,10,0,10,0,0.039599,0,0,0,0
17655,,,respectowo,1,0,1,1,0,1,0,0.00396,0,0,0,0
17656,,,GQJAPAN,4,0,4,4,0,4,0,0.01584,0,0,0,0
17657,,,salah_backpack,1,0,1,1,0,1,0,0.00396,0,0,0,0
17658,,,pepper_37,5,0,5,6,0,6,0,0.023961,0,0,0,0
17659,,,big_ear_cat,2,0,2,2,0,2,0,0.00792,0,0,0,0
17660,,,ryoyukobayashi,1,0,1,1,0,1,0,0.00396,0,0,0,0
17661,,,guriswest,5,0,5,5,0,5,0,0.0198,0,0,0,0
17662,,,lovelyflurryy,3,0,3,3,0,3,0,0.01188,0,0,0,0
17663,,,riaesun,1,0,1,1,0,1,0,0.00396,0,0,0,0
17664,,,yujisidio,16,0,16,16,0,16,0,0.066086,0,0,0,0
17665,,,VerlasseIolati,2,0,2,2,0,2,0,0.00792,0,0,0,0
17666,,,caleeiiii,8,0,8,8,0,8,0,0.109149,0,0,0,0
17667,,,LILGUYISBACK,1,0,1,1,0,1,0,0.00396,0,0,0,0
17668,,,tanylmh,1,0,1,1,0,1,0,0.00396,0,0,0,0
17669,,,eyits_el,4,0,4,4,0,4,0,0.018567,0,0,0,0
17670,,,kodzukeh,2,0,2,2,0,2,0,0.00792,0,0,0,0
17671,,,TheJayKrishnan,1,0,1,1,0,1,0,0.00396,0,0,0,0
17672,,,NuryVittachi,1,0,1,1,0,1,0,0.00396,0,0,0,0
17673,,,Evelyn_Jux,10,0,10,11,0,11,0,0.055963,0,0,0,0
17674,,,for__ami,3,0,3,3,0,3,0,0.01188,0,0,0,0
17675,,,Pottergirl12345,1,0,1,1,0,1,0,0.00396,0,0,0,0
17676,,,ValorRed1,7,0,7,7,0,7,0,0.02772,0,0,0,0
17677,,,jaehyunbeaner,11,0,11,12,0,12,0,0.043559,0,0,0,0
17678,,,dphxmg,1,0,1,1,0,1,0,0.00396,0,0,0,0
17679,,,kimse0king,1,0,1,1,0,1,0,0.00396,0,0,0,0
17680,,,CandyKeun,3,0,3,3,0,3,0,0.01188,0,0,0,0
17681,,,taelovelly,17,0,17,17,0,17,0,0.067319,0,0,0,0
17682,,,shiwudugf,7,0,7,7,0,7,0,0.02772,0,0,0,0
17683,,,tuliprose0611ys,7,0,7,7,0,7,0,0.02772,0,0,0,0
17684,,,YoshinoriOhara,1,0,1,1,0,1,0,0.00396,0,0,0,0
17685,,,pyontangs,2,0,2,2,0,2,0,0.00792,0,0,0,0
17686,,,eulenspiegel3,1,0,1,1,0,1,0,0.00396,0,0,0,0
17687,,,rainewisp,2,0,2,2,0,2,0,0.00792,0,0,0,0
17688,,,kunschamito,5,0,5,5,0,5,0,0.0198,0,0,0,0
17689,,,hanseilais,1,0,1,1,0,1,0,0.00396,0,0,0,0
17690,,,mr_anderssono,1,0,1,1,0,1,0,0.00396,0,0,0,0
17691,,,P6AX3Er3HqoQynY,1,0,1,1,0,1,0,0.020323,0,0,0,0
17692,,,anabellamy_,1,0,1,1,0,1,0,0.00396,0,0,0,0
17693,,,Seoulnorm,1,0,1,1,0,1,0,0.00396,0,0,0,0
17694,,,fjskyade,4,0,4,4,0,4,0,0.01584,0,0,0,0
17695,,,oneofunverses,8,0,8,8,0,8,0,0.048043,0,0,0,0
17696,,,gorikagorikago,1,0,1,1,0,1,0,0.00396,0,0,0,0
17697,,,scsailor2010,5,0,5,5,0,5,0,0.0198,0,0,0,0
17698,,,timhsiehiplaw,1,0,1,1,0,1,0,0.00396,0,0,0,0
17699,,,SaintBabiijjong,7,0,7,7,0,7,0,0.02772,0,0,0,0
17700,,,hearts4miya,1,0,1,1,0,1,0,0.00396,0,0,0,0
17701,,,coreyboro234,5,0,5,7,0,7,0,0.027981,0,0,0,0
17702,,,yibopeach_,1,0,1,1,0,1,0,0.012282,0,0,0,0
17703,,,blackwingbear,4,0,4,4,0,4,0,0.026749,0,0,0,0
17704,,,sunnyuzip,4,0,4,4,0,4,0,0.01584,0,0,0,0
17705,,,mingjuch,11,0,11,11,0,11,0,0.043559,0,0,0,0
17706,,,rabbitxian,2,0,2,3,0,3,0,0.00792,0,0,0,0
17707,,,pinksical,4,0,4,4,0,4,0,0.01584,0,0,0,0
17708,,,miriklss,15,0,15,16,0,16,0,0.102608,0,0,0,0
17709,,,Oma_Hamou,2,0,2,3,0,3,0,0.00792,0,0,0,0
17710,,,fc2books,2,0,2,2,0,2,0,0.051129,0,0,0,0
17711,,,zemdlej,1,0,1,1,0,1,0,0.00396,0,0,0,0
17712,,,girlbqss,4,0,4,4,0,4,0,0.029476,0,0,0,0
17713,,,dla_detej,5,0,5,6,0,6,0,0.028122,0,0,0,0
17714,,,jdaniel0710,3,0,3,3,0,3,0,0.01188,0,0,0,0
17715,,,eIfpj,1,0,1,1,0,1,0,0.00396,0,0,0,0
17716,,,s2hyuck,1,0,1,1,0,1,0,0.00396,0,0,0,0
17717,,,dboynaughty,5,0,5,5,0,5,0,0.0198,0,0,0,0
17718,,,plutaoemchanel,6,0,6,6,0,6,0,0.02376,0,0,0,0
17719,,,elpais_america,3,0,3,3,0,3,0,0.01188,0,0,0,0
17720,,,Diosaqui007,1,0,1,1,0,1,0,0.00396,0,0,0,0
17721,,,Ila185,11,0,11,11,0,11,0,0.043559,0,0,0,0
17722,,,TamThucVN,1,0,1,1,0,1,0,0.00396,0,0,0,0
17723,,,AMCnowB,1,0,1,1,0,1,0,0.00396,0,0,0,0
17724,,,carolinetiger,1,0,1,1,0,1,0,0.00396,0,0,0,0
17725,,,neutralbad,5,0,5,6,0,6,0,0.0198,0,0,0,0
17726,,,bkbp_hk,2,0,2,2,0,2,0,0.00792,0,0,0,0
17727,,,tsengputterman,3,0,3,3,0,3,0,0.01188,0,0,0,0
17728,,,sleepy_yoshi,2,0,2,2,0,2,0,0.00792,0,0,0,0
17729,,,RfaCantonese,11,0,11,11,0,11,0,0.043559,0,0,0,0
17730,,,4liinocat,1,0,1,1,0,1,0,0.00396,0,0,0,0
17731,,,tyunningbelos,10,0,10,10,0,10,0,0.039599,0,0,0,0
17732,,,SaraMartagon,1,0,1,1,0,1,0,0.00396,0,0,0,0
17733,,,nonbinaryF22,3,0,3,3,0,3,0,0.01188,0,0,0,0
17734,,,plutash,1,0,1,1,0,1,0,0.00396,0,0,0,0
17735,,,litlgrey,5,0,5,5,0,5,0,0.0198,0,0,0,0
17736,,,juyeonkaeya,9,0,9,11,0,11,0,0.049276,0,0,0,0
17737,,,itsmariezinha,4,0,4,4,0,4,0,0.032203,0,0,0,0
17738,,,muereeva,4,0,4,4,0,4,0,0.01584,0,0,0,0
17739,,,romasales_,3,0,3,3,0,3,0,0.01188,0,0,0,0
17740,,,AnthonyCurrySr,2,0,2,2,0,2,0,0.00792,0,0,0,0
17741,,,stubbornleaf,4,0,4,4,0,4,0,0.01584,0,0,0,0
17742,,,sophie_serbini,1,0,1,1,0,1,0,0.00396,0,0,0,0
17743,,,yutaencieI,2,0,2,2,0,2,0,0.00792,0,0,0,0
17744,,,LFidhelbooktube,8,0,8,9,0,9,0,0.038668,0,0,0,0
17745,,,MasahiroMiura,1,0,1,1,0,1,0,0.00396,0,0,0,0
17746,,,LatitudGay,3,0,3,3,0,3,0,0.01188,0,0,0,0
17747,,,Tifa385,1,0,1,1,0,1,0,0.00396,0,0,0,0
17748,,,obdoxious,3,0,3,3,0,3,0,0.01188,0,0,0,0
17749,,,oiseokjin,1,0,1,1,0,1,0,0.00396,0,0,0,0
17750,,,caterinack,3,0,3,3,0,3,0,0.01188,0,0,0,0
17751,,,KanaparkS,4,0,4,4,0,4,0,0.01584,0,0,0,0
17752,,,wei_lindaweixb,3,0,3,5,0,5,0,0.01188,0,0,0,0
17753,,,moonxrivers,1,0,1,1,0,1,0,0.00396,0,0,0,0
17754,,,Felix_Ray_,3,0,3,3,0,3,0,0.01188,0,0,0,0
17755,,,moyiteamo,8,0,8,18,0,18,0,0.039861,0,0,0,0
17756,,,Fiona82592899,3,0,3,3,0,3,0,0.01188,0,0,0,0
17757,,,hardialaulakh,2,0,2,2,0,2,0,0.00792,0,0,0,0
17758,,,laseRMLM,1,0,1,1,0,1,0,0.00396,0,0,0,0
17759,,,BuomHang,1,0,1,1,0,1,0,0.00396,0,0,0,0
17760,,,delifiseknoahh,3,0,3,3,0,3,0,0.01188,0,0,0,0
17761,,,rainrainrain27,4,0,4,4,0,4,0,0.01584,0,0,0,0
17762,,,tandesiara,4,0,4,4,0,4,0,0.01584,0,0,0,0
17763,,,ddkk9988,2,0,2,2,0,2,0,0.014161,0,0,0,0
17764,,,MilwaukeeFrank,1,0,1,1,0,1,0,0.00396,0,0,0,0
17765,,,Watashiwanazara,8,0,8,8,0,8,0,0.03168,0,0,0,0
17766,,,ginneko_aj,2,0,2,2,0,2,0,0.012081,0,0,0,0
17767,,,deokbbokki,1,0,1,7,0,7,0,0.00396,0,0,0,0
17768,,,MarkSmi88472647,1,0,1,1,0,1,0,0.00396,0,0,0,0
17769,,,hien_ihaku,3,0,3,3,0,3,0,0.01188,0,0,0,0
17770,,,lAML0W,3,0,3,4,0,4,0,0.018868,0,0,0,0
17771,,,toxictohigh,8,0,8,8,0,8,0,0.03376,0,0,0,0
17772,,,JianliSui,5,0,5,5,0,5,0,0.0198,0,0,0,0
17773,,,9thanchen,3,0,3,3,0,3,0,0.01188,0,0,0,0
17774,,,mervemiler,4,0,4,4,0,4,0,0.01584,0,0,0,0
17775,,,lifebenzhao,2,0,2,2,0,2,0,0.00792,0,0,0,0
17776,,,ONIDUKA96300,7,0,7,7,0,7,0,0.033961,0,0,0,0
17777,,,angelwonie,2,0,2,2,0,2,0,0.00792,0,0,0,0
17778,,,BashorunGha,12,0,12,12,0,12,0,0.047519,0,0,0,0
17779,,,podium_EE,3,0,3,3,0,3,0,0.01188,0,0,0,0
17780,,,elbernabeucom,13,0,13,13,0,13,0,0.116353,0,0,0,0
17781,,,RoyTindle,1,0,1,1,0,1,0,0.00396,0,0,0,0
17782,,,inu96101596,1,0,1,1,0,1,0,0.012142,0,0,0,0
17783,,,sonraso,4,0,4,4,0,4,0,0.01584,0,0,0,0
17784,,,TaehyunggBxG,4,0,4,4,0,4,0,0.01584,0,0,0,0
17785,,,yenafobica,3,0,3,3,0,3,0,0.01188,0,0,0,0
17786,,,skarra,4,0,4,4,0,4,0,0.01584,0,0,0,0
17787,,,Roadches,7,0,7,7,0,7,0,0.054992,0,0,0,0
17788,,,jikanhochiii,5,0,5,5,0,5,0,0.084673,0,0,0,0
17789,,,yfloating,5,0,5,5,0,5,0,0.026041,0,0,0,0
17790,,,ilDiO89nUGQfvTv,6,0,6,6,0,6,0,0.095369,0,0,0,0
17791,,,pirorin_rin,1,0,1,1,0,1,0,0.00396,0,0,0,0
17792,,,I_Am_The__Queen,2,0,2,3,0,3,0,0.072793,0,0,0,0
17793,,,hyvnestar,3,0,3,3,0,3,0,0.01188,0,0,0,0
17794,,,FrankFu75746281,3,0,3,3,0,3,0,0.018868,0,0,0,0
17795,,,mcantieri,10,0,10,12,0,12,0,0.069854,0,0,0,0
17796,,,unifi,6,0,6,6,0,6,0,0.02376,0,0,0,0
17797,,,AsiaNews_FR,2,0,2,2,0,2,0,0.00792,0,0,0,0
17798,,,fightcensorship,3,0,3,3,0,3,0,0.01188,0,0,0,0
17799,,,caraiovante,5,0,5,5,0,5,0,0.08459,0,0,0,0
17800,,,rubyjeikei,2,0,2,2,0,2,0,0.013374,0,0,0,0
17801,,,rahmifitrah25,7,0,7,7,0,7,0,0.038628,0,0,0,0
17802,,,envivo_Mx,9,0,9,9,0,9,0,0.03564,0,0,0,0
17803,,,NoticiasEnEspa2,1,0,1,1,0,1,0,0.00396,0,0,0,0
17804,,,hanmeumito,2,0,2,2,0,2,0,0.00792,0,0,0,0
17805,,,AlbertGumbo,6,0,6,6,0,6,0,0.034668,0,0,0,0
17806,,,Suikoboy,8,0,8,9,0,9,0,0.03168,0,0,0,0
17807,,,Eurosport_DE,6,0,6,6,0,6,0,0.089127,0,0,0,0
17808,,,hsjuang,1,0,1,1,0,1,0,0.00396,0,0,0,0
17809,,,kookherondale,2,0,2,3,0,3,0,0.00792,0,0,0,0
17810,,,piyococcochan2,2,0,2,2,0,2,0,0.00792,0,0,0,0
17811,,,lat_diff,3,0,3,3,0,3,0,0.01188,0,0,0,0
17812,,,softchuwn,1,0,1,1,0,1,0,0.00396,0,0,0,0
17813,,,vantesangeI,3,0,3,4,0,4,0,0.01188,0,0,0,0
17814,,,cauvailonnnn,4,0,4,4,0,4,0,0.01584,0,0,0,0
17815,,,darkbloodtears,2,0,2,2,0,2,0,0.00792,0,0,0,0
17816,,,VRNKJBJ,1,0,1,1,0,1,0,0.00396,0,0,0,0
17817,,,erospiI,3,0,3,3,0,3,0,0.01188,0,0,0,0
17818,,,ouranista,1,0,1,1,0,1,0,0.00396,0,0,0,0
17819,,,SlowZhu,2,0,2,2,0,2,0,0.00792,0,0,0,0
17820,,,izabeaaaru_,7,0,7,7,0,7,0,0.070929,0,0,0,0
17821,,,LendasOlimpicas,1,0,1,1,0,1,0,0.00396,0,0,0,0
17822,,,Connii_xd,3,0,3,3,0,3,0,0.017334,0,0,0,0
17823,,,Yoru_Ghost,2,0,2,2,0,2,0,0.00792,0,0,0,0
17824,,,uzmesinlerabi,1,0,1,1,0,1,0,0.00396,0,0,0,0
17825,,,_parf_,3,0,3,3,0,3,0,0.020061,0,0,0,0
17826,,,haseulgrf,1,0,1,1,0,1,0,0.00396,0,0,0,0
17827,,,keirain,8,0,8,8,0,8,0,0.03168,0,0,0,0
17828,,,TwoCents,1,0,1,1,0,1,0,0.00396,0,0,0,0
17829,,,VOATiengViet,1,0,1,1,0,1,0,0.00396,0,0,0,0
17830,,,newtsmoon,3,0,3,3,0,3,0,0.020061,0,0,0,0
17831,,,wiki_pv_ranking,4,0,4,4,0,4,0,0.01584,0,0,0,0
17832,,,sun__bae,1,0,1,1,0,1,0,0.00396,0,0,0,0
17833,,,Echo0082238734,2,0,2,2,0,2,0,0.00792,0,0,0,0
17834,,,SkyWalker0416,4,0,4,4,0,4,0,0.01584,0,0,0,0
17835,,,debizs,1,0,1,1,0,1,0,0.00396,0,0,0,0
17836,,,diegotervas,6,0,6,6,0,6,0,0.02376,0,0,0,0
17837,,,TheSenemGencer,8,0,8,9,0,9,0,0.03168,0,0,0,0
17838,,,umibestranger,7,0,7,7,0,7,0,0.02772,0,0,0,0
17839,,,voa_thai,1,0,1,1,0,1,0,0.020323,0,0,0,0
17840,,,rubywells99,2,0,2,2,0,2,0,0.00792,0,0,0,0
17841,,,reyrosales,2,0,2,2,0,2,0,0.00792,0,0,0,0
17842,,,patbestboy,1,0,1,1,0,1,0,0.00396,0,0,0,0
17843,,,Chuushaku,4,0,4,4,0,4,0,0.03493,0,0,0,0
17844,,,iremmiaa,1,0,1,1,0,1,0,0.00396,0,0,0,0
17845,,,recardo_horn,7,0,7,7,0,7,0,0.02772,0,0,0,0
17846,,,ZOLHYSN,2,0,2,2,0,2,0,0.00792,0,0,0,0
17847,,,LaJornadaMaya,8,0,8,9,0,9,0,0.074889,0,0,0,0
17848,,,FaniolaHarta,2,0,2,2,0,2,0,0.00792,0,0,0,0
17849,,,7indawqdd,1,0,1,1,0,1,0,0.00396,0,0,0,0
17850,,,gydnzz,2,0,2,2,0,2,0,0.00792,0,0,0,0
17851,,,oahuwriter,5,0,5,5,0,5,0,0.0198,0,0,0,0
17852,,,The3MagicGates,13,0,13,13,0,13,0,0.051479,0,0,0,0
17853,,,grupo_origen,5,0,5,5,0,5,0,0.0198,0,0,0,0
17854,,,tsblsporkulubu,7,0,7,7,0,7,0,0.035901,0,0,0,0
17855,,,recky_yy,5,0,5,5,0,5,0,0.0198,0,0,0,0
17856,,,Traveling_89,3,0,3,3,0,3,0,0.01188,0,0,0,0
17857,,,MusashiSmile,2,0,2,2,0,2,0,0.00792,0,0,0,0
17858,,,arqteturas,2,0,2,2,0,2,0,0.00792,0,0,0,0
17859,,,irgatlarinofkes,2,0,2,2,0,2,0,0.00792,0,0,0,0
17860,,,Miki_chan6,7,0,7,7,0,7,0,0.02772,0,0,0,0
17861,,,ner0p0rr0,1,0,1,1,0,1,0,0.00396,0,0,0,0
17862,,,lisaliu00,3,0,3,3,0,3,0,0.014607,0,0,0,0
17863,,,killforjaeger,14,0,14,14,0,14,0,0.055439,0,0,0,0
17864,,,seeundei,7,0,7,9,0,9,0,0.02772,0,0,0,0
17865,,,inusnk,1,0,1,1,0,1,0,0.00396,0,0,0,0
17866,,,lilac_jupiter,4,0,4,4,0,4,0,0.01584,0,0,0,0
17867,,,byebyeIwannadie,7,0,7,7,0,7,0,0.054992,0,0,0,0
17868,,,iryuhye,1,0,1,1,0,1,0,0.00396,0,0,0,0
17869,,,MONKlHOTEL,6,0,6,7,0,7,0,0.02376,0,0,0,0
17870,,,honeysblossom,2,0,2,2,0,2,0,0.00792,0,0,0,0
17871,,,imb_sasha,2,0,2,2,0,2,0,0.00792,0,0,0,0
17872,,,httpsbblue,6,0,6,6,0,6,0,0.051032,0,0,0,0
17873,,,jeffmetcalfe,3,0,3,3,0,3,0,0.022282,0,0,0,0
17874,,,junhwanvr,3,0,3,3,0,3,0,0.01188,0,0,0,0
17875,,,noticierovv,12,0,12,12,0,12,0,0.061155,0,0,0,0
17876,,,aguachicac,1,0,1,1,0,1,0,0.00396,0,0,0,0
17877,,,StatiFrancesco,4,0,4,4,0,4,0,0.01584,0,0,0,0
17878,,,twunkhinata,7,0,7,8,0,8,0,0.035901,0,0,0,0
17879,,,selfprti,5,0,5,6,0,6,0,0.022527,0,0,0,0
17880,,,mariianett1,4,0,4,4,0,4,0,0.01584,0,0,0,0
17881,,,Nobody0nEarth,9,0,9,9,0,9,0,0.03564,0,0,0,0
17882,,,leegashikata,1,0,1,1,0,1,0,0.009414,0,0,0,0
17883,,,MaxMill82458745,15,0,15,15,0,15,0,0.059399,0,0,0,0
17884,,,ChartzUp,1,0,1,1,0,1,0,0.00396,0,0,0,0
17885,,,sigomalita,12,0,12,12,0,12,0,0.050247,0,0,0,0
17886,,,tetespooh,8,0,8,9,0,9,0,0.042588,0,0,0,0
17887,,,gib_tater,2,0,2,2,0,2,0,0.00792,0,0,0,0
17888,,,HegartyKatie,1,0,1,1,0,1,0,0.00396,0,0,0,0
17889,,,NEOchickenwings,4,0,4,4,0,4,0,0.01584,0,0,0,0
17890,,,VaderLady70,1,0,1,1,0,1,0,0.00396,0,0,0,0
17891,,,prysotu,2,0,2,2,0,2,0,0.00792,0,0,0,0
17892,,,voleybolyedek,1,0,1,1,0,1,0,0.00396,0,0,0,0
17893,,,bjfylover,5,0,5,5,0,5,0,0.0198,0,0,0,0
17894,,,hitorimomito,1,0,1,1,0,1,0,0.00396,0,0,0,0
17895,,,yulisfer,1,0,1,1,0,1,0,0.00396,0,0,0,0
17896,,,_SamuraiBoy,1,0,1,1,0,1,0,0.00396,0,0,0,0
17897,,,kfz0424,3,0,3,3,0,3,0,0.020061,0,0,0,0
17898,,,tinnitus3x,1,0,1,1,0,1,0,0.00396,0,0,0,0
17899,,,Sophia36982957,4,0,4,4,0,4,0,0.044987,0,0,0,0
17900,,,am2_vz,14,0,14,14,0,14,0,0.077598,0,0,0,0
17901,,,2Cqjk64t4TJY7bt,7,0,7,7,0,7,0,0.02772,0,0,0,0
17902,,,AmbasciataUSA,1,0,1,1,0,1,0,0.00396,0,0,0,0
17903,,,sumimassn,13,0,13,14,0,14,0,0.067842,0,0,0,0
17904,,,cam_gordon,12,0,12,14,0,14,0,0.047519,0,0,0,0
17905,,,IsaacQin,4,0,4,4,0,4,0,0.01584,0,0,0,0
17906,,,LosCabosJournal,7,0,7,7,0,7,0,0.02772,0,0,0,0
17907,,,GlenndeBlois,2,0,2,2,0,2,0,0.00792,0,0,0,0
17908,,,0992_sskk,28,0,28,29,0,29,0,0.159542,0,0,0,0
17909,,,wadipinto213,2,0,2,2,0,2,0,0.00792,0,0,0,0
17910,,,dasmai1414,4,0,4,4,0,4,0,0.01584,0,0,0,0
17911,,,gamesetmatch31,1,0,1,1,0,1,0,0.00396,0,0,0,0
17912,,,_lwtmedicine,3,0,3,3,0,3,0,0.01188,0,0,0,0
17913,,,tomcat16888,8,0,8,8,0,8,0,0.048043,0,0,0,0
17914,,,Lifeswonder4,8,0,8,8,0,8,0,0.045316,0,0,0,0
17915,,,Ozlem61645742,2,0,2,2,0,2,0,0.00792,0,0,0,0
17916,,,yeolosophy,6,0,6,6,0,6,0,0.02376,0,0,0,0
17917,,,defyngi,5,0,5,5,0,5,0,0.0198,0,0,0,0
17918,,,aliceoutofwond3,3,0,3,3,0,3,0,0.01188,0,0,0,0
17919,,,Sakura_hirakuyo,2,0,2,2,0,2,0,0.00792,0,0,0,0
17920,,,monaquila,3,0,3,3,0,3,0,0.01188,0,0,0,0
17921,,,boFJxgdXUhNoFbH,2,0,2,2,0,2,0,0.00792,0,0,0,0
17922,,,evamngelion,2,0,2,2,0,2,0,0.00792,0,0,0,0
17923,,,lizzyisdown,21,0,21,26,0,26,0.002381,0.128016,0,0,0,0
17924,,,shotasung,7,0,7,7,0,7,0,0.02772,0,0,0,0
17925,,,GotsecondS,7,0,7,7,0,7,0,0.02772,0,0,0,0
17926,,,Volksstimme,4,0,4,4,0,4,0,0.01584,0,0,0,0
17927,,,noticiaaldia,3,0,3,3,0,3,0,0.01188,0,0,0,0
17928,,,jaywonsunshine,10,0,10,10,0,10,0,0.039599,0,0,0,0
17929,,,triplelutzjump,2,0,2,2,0,2,0,0.00792,0,0,0,0
17930,,,SIRIUSly_03,13,0,13,13,0,13,0,0.051479,0,0,0,0
17931,,,FuckitJimmy,25,0,25,26,0,26,0,0.10718,0,0,0,0
17932,,,mzwebde,10,0,10,10,0,10,0,0.039599,0,0,0,0
17933,,,NoticiasVeApp,4,0,4,4,0,4,0,0.01584,0,0,0,0
17934,,,ratram1,16,0,16,17,0,17,0,0.063359,0,0,0,0
17935,,,bajito__,2,0,2,2,0,2,0,0.073287,0,0,0,0
17936,,,HaveFunMakeFuss,2,0,2,2,0,2,0,0.024283,0,0,0,0
17937,,,Yibokyy,5,0,5,5,0,5,0,0.0198,0,0,0,0
17938,,,mamacitadekyu2,12,0,12,12,0,12,0,0.050247,0,0,0,0
17939,,,brainboxdaewon,5,0,5,5,0,5,0,0.025254,0,0,0,0
17940,,,rosebIues,3,0,3,3,0,3,0,0.01188,0,0,0,0
17941,,,kazuhwaa,1,0,1,1,0,1,0,0.00396,0,0,0,0
17942,,,voalao,5,0,5,5,0,5,0,0.0198,0,0,0,0
17943,,,eldiario_net,1,0,1,1,0,1,0,0.00396,0,0,0,0
17944,,,YUNGMARC2,1,0,1,1,0,1,0,0.00396,0,0,0,0
17945,,,hansangh424,5,0,5,5,0,5,0,0.0198,0,0,0,0
17946,,,naeviscllng,5,0,5,5,0,5,0,0.047072,0,0,0,0
17947,,,Esmerald_bear,1,0,1,1,0,1,0,0.00396,0,0,0,0
17948,,,itackrm,15,0,15,15,0,15,0,0.059399,0,0,0,0
17949,,,rebirthjade,8,0,8,8,0,8,0,0.03168,0,0,0,0
17950,,,RadioRock89,4,0,4,4,0,4,0,0.01584,0,0,0,0
17951,,,R11MB4UD,1,0,1,1,0,1,0,0.00396,0,0,0,0
17952,,,SUNSElTS,2,0,2,2,0,2,0,0.014908,0,0,0,0
17953,,,CBDCUREDISEASE,6,0,6,6,0,6,0,0.02376,0,0,0,0
17954,,,sk8er_shinjuku,2,0,2,2,0,2,0,0.00792,0,0,0,0
17955,,,Angelunism,1,0,1,1,0,1,0,0.00396,0,0,0,0
17956,,,VivasMechavivas,3,0,3,3,0,3,0,0.01188,0,0,0,0
17957,,,SZ_Sport,2,0,2,2,0,2,0,0.021556,0,0,0,0
17958,,,junobum,3,0,3,3,0,3,0,0.01188,0,0,0,0
17959,,,thelemonflower,13,0,13,13,0,13,0,0.057721,0,0,0,0
17960,,,Ahjotson,2,0,2,2,0,2,0,0.00792,0,0,0,0
17961,,,oatmilktiddies,20,0,20,20,0,20,0,0.079199,0,0,0,0
17962,,,VictimofP2,2,0,2,2,0,2,0,0.00792,0,0,0,0
17963,,,renayonur,1,0,1,1,0,1,0,0.00396,0,0,0,0
17964,,,Fiatopichan,3,0,3,3,0,3,0,0.01188,0,0,0,0
17965,,,sebtinbookwan,4,0,4,4,0,4,0,0.01584,0,0,0,0
17966,,,ScaredNevray,8,0,8,8,0,8,0,0.03168,0,0,0,0
17967,,,ErmHab,10,0,10,10,0,10,0,0.039599,0,0,0,0
17968,,,sportface2016,7,0,7,7,0,7,0,0.02772,0,0,0,0
17969,,,HyeTert,4,0,4,5,0,5,0,0.059475,0,0,0,0
17970,,,Enu_Karin_N326,4,0,4,4,0,4,0,0.01584,0,0,0,0
17971,,,MorenHaber,1,0,1,1,0,1,0,0.00396,0,0,0,0
17972,,,willalwaySTAY,6,0,6,6,0,6,0,0.02376,0,0,0,0
17973,,,andasln,2,0,2,2,0,2,0,0.00792,0,0,0,0
17974,,,konakalab,8,0,8,8,0,8,0,0.03168,0,0,0,0
17975,,,valdzone,4,0,4,4,0,4,0,0.018567,0,0,0,0
17976,,,tom58812877,21,0,21,21,0,21,0,0.121681,0,0,0,0
17977,,,realitelaa,3,0,3,3,0,3,0,0.01188,0,0,0,0
17978,,,carlostsune,5,0,5,5,0,5,0,0.041958,0,0,0,0
17979,,,airmoonx,3,0,3,4,0,4,0,0.01188,0,0,0,0
17980,,,orangujohn,2,0,2,2,0,2,0,0.00792,0,0,0,0
17981,,,ElNacionalWeb,11,0,11,11,0,11,0,0.049014,0,0,0,0
17982,,,mingoachelsea,5,0,5,5,0,5,0,0.0198,0,0,0,0
17983,,,_Edogawa_,1,0,1,1,0,1,0,0.00396,0,0,0,0
17984,,,blinkonys,5,0,5,5,0,5,0,0.104258,0,0,0,0
17985,,,camelliajinho,2,0,2,2,0,2,0,0.00792,0,0,0,0
17986,,,MakDPostmodern,1,0,1,1,0,1,0,0.00396,0,0,0,0
17987,,,RaiSport,6,0,6,6,0,6,0,0.04867,0,0,0,0
17988,,,kyungbug,1,0,1,1,0,1,0,0.00396,0,0,0,0
17989,,,Alston_Kwan,3,0,3,3,0,3,0,0.01188,0,0,0,0
17990,,,momobako17,7,0,7,8,0,8,0,0.041356,0,0,0,0
17991,,,fault12,8,0,8,9,0,9,0,0.03168,0,0,0,0
17992,,,Craig_Mc10,9,0,9,10,0,10,0,0.03564,0,0,0,0
17993,,,Yutaka__Morita,3,0,3,3,0,3,0,0.01188,0,0,0,0
17994,,,ruschyphyn,5,0,5,5,0,5,0,0.0198,0,0,0,0
17995,,,lenitetsuro,6,0,6,6,0,6,0,0.02376,0,0,0,0
17996,,,eat_love_sleep,4,0,4,4,0,4,0,0.01584,0,0,0,0
17997,,,na76fCtNyL5qBUq,4,0,4,5,0,5,0,0.01584,0,0,0,0
17998,,,antigonistic,13,0,13,13,0,13,0,0.051479,0,0,0,0
17999,,,julesforest,1,0,1,1,0,1,0,0.00396,0,0,0,0
18000,,,sonofvenus__,2,0,2,2,0,2,0,0.00792,0,0,0,0
18001,,,chasedtracks,3,0,3,3,0,3,0,0.01188,0,0,0,0
18002,,,y00shiiii,8,0,8,8,0,8,0,0.069354,0,0,0,0
18003,,,ronaldkvsu,1,0,1,1,0,1,0,0.00396,0,0,0,0
18004,,,mzysk,8,0,8,8,0,8,0.017857,0.099348,0,0,0,0
18005,,,GaryQ37208050,4,0,4,4,0,4,0,0.01584,0,0,0,0
18006,,,ahmetakin33,1,0,1,1,0,1,0,0.00396,0,0,0,0
18007,,,dariusrock,3,0,3,3,0,3,0,0.01188,0,0,0,0
18008,,,CassioInTheSky,5,0,5,5,0,5,0,0.0198,0,0,0,0
18009,,,JANAINACARMONA,6,0,6,6,0,6,0,0.02376,0,0,0,0
18010,,,leistudio9,4,0,4,4,0,4,0,0.018567,0,0,0,0
18011,,,Kulennn,2,0,2,2,0,2,0,0.00792,0,0,0,0
18012,,,yutaDMC,11,0,11,11,0,11,0,0.054468,0,0,0,0
18013,,,mythomaniaca,2,0,2,2,0,2,0,0.00792,0,0,0,0
18014,,,xemewer698,2,0,2,2,0,2,0,0.00792,0,0,0,0
18015,,,Car4ttHarl1ngg,3,0,3,3,0,3,0,0.01188,0,0,0,0
18016,,,markypink,1,0,1,1,0,1,0,0.00396,0,0,0,0
18017,,,seagrace6,5,0,5,5,0,5,0,0.0198,0,0,0,0
18018,,,y4nfeiys,9,0,9,9,0,9,0,0.03564,0,0,0,0
18019,,,Jason22587360,26,0,26,29,0,29,0,0.130231,0,0,0,0
18020,,,irenec,13,0,13,13,0,13,0,0.056934,0,0,0,0
18021,,,i5YUZU,15,0,15,15,0,15,0,0.066388,0,0,0,0
18022,,,7jasonbeckham,1,0,1,1,0,1,0,0.00396,0,0,0,0
18023,,,planetaencrisis,3,0,3,3,0,3,0,0.01188,0,0,0,0
18024,,,taeyuzuakgae,4,0,4,4,0,4,0,0.01584,0,0,0,0
18025,,,nagasimapiano,2,0,2,2,0,2,0,0.00792,0,0,0,0
18026,,,cadet___limbo,1,0,1,1,0,1,0,0.00396,0,0,0,0
18027,,,eternalIy7,5,0,5,5,0,5,0,0.0198,0,0,0,0
18028,,,BlueKeith_art,13,0,13,13,0,13,0,0.059801,0,0,0,0
18029,,,vittermin,1,0,1,1,0,1,0,0.00396,0,0,0,0
18030,,,eyloiz,2,0,2,2,0,2,0,0.020403,0,0,0,0
18031,,,JamesDeanNFT,9,0,9,9,0,9,0,0.03564,0,0,0,0
18032,,,sstrawberrymins,4,0,4,4,0,4,0,0.01584,0,0,0,0
18033,,,bonbon_lil,3,0,3,3,0,3,0,0.01188,0,0,0,0
18034,,,HighwayNicoll,1,0,1,1,0,1,0,0.00396,0,0,0,0
18035,,,msmdz,4,0,4,4,0,4,0,0.01584,0,0,0,0
18036,,,mlysantxs,7,0,7,8,0,8,0,0.02772,0,0,0,0
18037,,,minhoemowo,9,0,9,9,0,9,0,0.03564,0,0,0,0
18038,,,ifellsotired,8,0,8,8,0,8,0,0.03168,0,0,0,0
18039,,,Coffee666_,6,0,6,6,0,6,0,0.02376,0,0,0,0
18040,,,koo___mimi,14,0,14,15,0,15,0,0.055439,0,0,0,0
18041,,,baurbaru,4,0,4,4,0,4,0,0.028555,0,0,0,0
18042,,,hakubahiroka,8,0,8,8,0,8,0,0.03168,0,0,0,0
18043,,,cnhillwu,2,0,2,2,0,2,0,0.00792,0,0,0,0
18044,,,sherkive,1,0,1,1,0,1,0,0.00396,0,0,0,0
18045,,,TsukaOkubo,2,0,2,2,0,2,0,0.00792,0,0,0,0
18046,,,kaori_vo_jp,3,0,3,3,0,3,0,0.01188,0,0,0,0
18047,,,RedLineSport,1,0,1,1,0,1,0,0.00396,0,0,0,0
18048,,,xintoni,11,0,11,11,0,11,0,0.043559,0,0,0,0
18049,,,zhanluvs,5,0,5,5,0,5,0,0.026788,0,0,0,0
18050,,,w0__Odz,12,0,12,14,0,14,0,0.047519,0,0,0,0
18051,,,luosidd,5,0,5,5,0,5,0,0.0198,0,0,0,0
18052,,,frankiebread_,2,0,2,2,0,2,0,0.00792,0,0,0,0
18053,,,Gabriel06498908,1,0,1,1,0,1,0,0.00396,0,0,0,0
18054,,,jjuyito,3,0,3,3,0,3,0,0.01188,0,0,0,0
18055,,,PacosacaMb,3,0,3,3,0,3,0,0.01188,0,0,0,0
18056,,,berrychanberry,1,0,1,1,0,1,0,0.00396,0,0,0,0
18057,,,littleWhale96,5,0,5,5,0,5,0,0.0198,0,0,0,0
18058,,,rr__fake,5,0,5,5,0,5,0,0.0198,0,0,0,0
18059,,,sunqlu,3,0,3,3,0,3,0,0.01188,0,0,0,0
18060,,,Van0371,4,0,4,4,0,4,0,0.01584,0,0,0,0
18061,,,avicii_mwam,14,0,14,14,0,14,0,0.055439,0,0,0,0
18062,,,mc33laren,9,0,9,9,0,9,0,0.045761,0,0,0,0
18063,,,venicemala,4,0,4,4,0,4,0,0.01584,0,0,0,0
18064,,,clarincom,10,0,10,10,0,10,0,0.039599,0,0,0,0
18065,,,yuchoix,5,0,5,5,0,5,0,0.0198,0,0,0,0
18066,,,n4ughtygirI,2,0,2,2,0,2,0,0.01,0,0,0,0
18067,,,arichavon,18,0,18,18,0,18,0,0.071279,0,0,0,0
18068,,,GabyDeportes,5,0,5,5,0,5,0,0.0198,0,0,0,0
18069,,,6abrielaArtem,2,0,2,2,0,2,0,0.00792,0,0,0,0
18070,,,StigmabaseE,1,0,1,1,0,1,0,0.00396,0,0,0,0
18071,,,juneenang,1,0,1,1,0,1,0,0.00396,0,0,0,0
18072,,,radiostarbrasil,4,0,4,4,0,4,0,0.01584,0,0,0,0
18073,,,rocketgurlx,6,0,6,6,0,6,0,0.02376,0,0,0,0
18074,,,caalcomanias,11,0,11,11,0,11,0,0.046287,0,0,0,0
18075,,,fadadomar,1,0,1,1,0,1,0,0.00396,0,0,0,0
18076,,,JimmyJi65797762,1,0,1,1,0,1,0,0.00396,0,0,0,0
18077,,,KoNaBReeZe7815,3,0,3,3,0,3,0,0.016688,0,0,0,0
18078,,,polemomo,1,0,1,1,0,1,0,0.00396,0,0,0,0
18079,,,yukstar_japan,2,0,2,2,0,2,0,0.00792,0,0,0,0
18080,,,yuzucito,12,0,12,12,0,12,0,0.047519,0,0,0,0
18081,,,streamfavorite_,5,0,5,5,0,5,0,0.022527,0,0,0,0
18082,,,Stardarinlz,4,0,4,4,0,4,0,0.01584,0,0,0,0
18083,,,Pump_kinpi3,1,0,1,1,0,1,0,0.00396,0,0,0,0
18084,,,muppet_5,7,0,7,7,0,7,0,0.02772,0,0,0,0
18085,,,stellsjunior,2,0,2,2,0,2,0,0.00792,0,0,0,0
18086,,,PETERSIM018,1,0,1,1,0,1,0,0.00396,0,0,0,0
18087,,,rukiamita,5,0,5,5,0,5,0,0.025254,0,0,0,0
18088,,,Azuhi_5,6,0,6,6,0,6,0,0.02376,0,0,0,0
18089,,,BelieveInDaco,3,0,3,3,0,3,0,0.01188,0,0,0,0
18090,,,saruking13,8,0,8,9,0,9,0,0.03168,0,0,0,0
18091,,,ohmywhityrice,2,0,2,2,0,2,0,0.00792,0,0,0,0
18092,,,AmishaJaya,2,0,2,2,0,2,0,0.00792,0,0,0,0
18093,,,SergioTorresMa2,10,0,10,10,0,10,0,0.05477,0,0,0,0
18094,,,HuffPostJapan,1,0,1,1,0,1,0,0.00396,0,0,0,0
18095,,,shinsaku10,20,0,20,20,0,20,0,0.079199,0,0,0,0
18096,,,bngtanmiley,5,0,5,5,0,5,0,0.026788,0,0,0,0
18097,,,JudithF14564728,5,0,5,5,0,5,0,0.0198,0,0,0,0
18098,,,IsFlowerFloweer,2,0,2,2,0,2,0,0.010647,0,0,0,0
18099,,,Christina_1821,1,0,1,1,0,1,0,0.00396,0,0,0,0
18100,,,printseven_off,2,0,2,2,0,2,0,0.00792,0,0,0,0
18101,,,sionpm,13,0,13,13,0,13,0,0.051479,0,0,0,0
18102,,,Lulueppi2,2,0,2,2,0,2,0,0.00792,0,0,0,0
18103,,,awarren96,1,0,1,1,0,1,0,0.00396,0,0,0,0
18104,,,hanahana73S,1,0,1,1,0,1,0,0.00396,0,0,0,0
18105,,,G0TH0YAMI,3,0,3,3,0,3,0,0.01188,0,0,0,0
18106,,,sdpnoticias,3,0,3,3,0,3,0,0.01188,0,0,0,0
18107,,,kikiloen,2,0,2,2,0,2,0,0.00792,0,0,0,0
18108,,,Ivehave2Ivehave,9,0,9,9,0,9,0,0.03564,0,0,0,0
18109,,,dragonboyia,2,0,2,2,0,2,0,0.00792,0,0,0,0
18110,,,Not_Mahui,1,0,1,1,0,1,0,0.00396,0,0,0,0
18111,,,Miroslav_Agnis,3,0,3,3,0,3,0,0.01188,0,0,0,0
18112,,,Ginettedu37,3,0,3,3,0,3,0,0.01188,0,0,0,0
